rundate,this_period,last_period,airport_group,apt1_apt_name,apt2_apt_name,total_pax_tp,total_pax_scheduled_2001,total_pax_charter_2001,total_pax_2000,total_pax_scheduled_2000,total_pax_charter_2000,total_pax_percent_change
25/04/2002 12:53,2001,2000,London Area Airports,GATWICK,ABERDEEN,235825,235777,48,246009,246009,0,-4.139686108
25/04/2002 12:53,2001,2000,London Area Airports,GATWICK,BELFAST CITY,240891,240891,0,257079,257079,0,-6.296896935
25/04/2002 12:53,2001,2000,London Area Airports,GATWICK,BELFAST INTERNATIONAL,0,0,0,47,0,47,
25/04/2002 12:53,2001,2000,London Area Airports,GATWICK,BIRMINGHAM,155,0,155,0,0,0,
25/04/2002 12:53,2001,2000,London Area Airports,GATWICK,BOURNEMOUTH,8,0,8,62,0,62,-87.09677124
25/04/2002 12:53,2001,2000,London Area Airports,GATWICK,BRISTOL,14014,13979,35,13485,13480,5,3.922877312
25/04/2002 12:53,2001,2000,London Area Airports,GATWICK,BRIZE NORTON,9,0,9,0,0,0,
25/04/2002 12:53,2001,2000,London Area Airports,GATWICK,EDINBURGH,376614,376598,16,364442,364434,8,3.339900494
25/04/2002 12:53,2001,2000,London Area Airports,GATWICK,EXETER,24,24,0,28,28,0,-14.28571415
25/04/2002 12:53,2001,2000,London Area Airports,GATWICK,GATWICK,0,0,0,77,0,77,
25/04/2002 12:53,2001,2000,London Area Airports,GATWICK,GLASGOW,356450,356450,0,357909,357909,0,-0.407645524
25/04/2002 12:53,2001,2000,London Area Airports,GATWICK,GUERNSEY,307659,307659,0,315613,315428,185,-2.52017498
25/04/2002 12:53,2001,2000,London Area Airports,GATWICK,INVERNESS,150897,150883,14,156600,156598,2,-3.641762495
25/04/2002 12:53,2001,2000,London Area Airports,GATWICK,ISLE OF MAN,71,0,71,0,0,0,
25/04/2002 12:53,2001,2000,London Area Airports,GATWICK,JERSEY,509272,509129,143,398448,398153,295,27.81391716
25/04/2002 12:53,2001,2000,London Area Airports,GATWICK,KIRKWALL,0,0,0,100,0,100,
25/04/2002 12:53,2001,2000,London Area Airports,GATWICK,LEEDS BRADFORD,4480,4480,0,3,0,3,149233.3281
25/04/2002 12:53,2001,2000,London Area Airports,GATWICK,LIVERPOOL,27,0,27,30,0,30,-10
25/04/2002 12:53,2001,2000,London Area Airports,GATWICK,MANCHESTER,471446,470450,996,493224,492162,1062,-4.415438175
25/04/2002 12:53,2001,2000,London Area Airports,GATWICK,NEWCASTLE,199665,199637,28,198169,197988,181,0.754911184
25/04/2002 12:53,2001,2000,London Area Airports,GATWICK,NEWQUAY,59079,59079,0,61746,61746,0,-4.319308281
25/04/2002 12:53,2001,2000,London Area Airports,GATWICK,PLYMOUTH,52428,52428,0,48223,48223,0,8.719905853
25/04/2002 12:53,2001,2000,London Area Airports,GATWICK,PRESTWICK,0,0,0,39,0,39,
25/04/2002 12:53,2001,2000,London Area Airports,GATWICK,STANSTED,178,0,178,0,0,0,
25/04/2002 12:53,2001,2000,London Area Airports,GATWICK,TEESSIDE,23,0,23,0,0,0,
25/04/2002 12:53,2001,2000,London Area Airports,HEATHROW,ABERDEEN,476933,476933,0,516026,516026,0,-7.575780869
25/04/2002 12:53,2001,2000,London Area Airports,HEATHROW,BELFAST CITY,99096,99096,0,0,0,0,
25/04/2002 12:53,2001,2000,London Area Airports,HEATHROW,BELFAST INTERNATIONAL,876083,876083,0,1168470,1167831,639,-25.02306366
25/04/2002 12:53,2001,2000,London Area Airports,HEATHROW,BIRMINGHAM,0,0,0,100,0,100,
25/04/2002 12:53,2001,2000,London Area Airports,HEATHROW,BLACKPOOL,60,0,60,0,0,0,
25/04/2002 12:53,2001,2000,London Area Airports,HEATHROW,BOURNEMOUTH,0,0,0,192,0,192,
25/04/2002 12:53,2001,2000,London Area Airports,HEATHROW,EDINBURGH,1576686,1576586,100,1673587,1673517,70,-5.790018559
25/04/2002 12:53,2001,2000,London Area Airports,HEATHROW,EXETER,0,0,0,196,0,196,
25/04/2002 12:53,2001,2000,London Area Airports,HEATHROW,FILTON,0,0,0,100,0,100,
25/04/2002 12:53,2001,2000,London Area Airports,HEATHROW,GLASGOW,1388375,1388375,0,1527731,1527731,0,-9.121763229
25/04/2002 12:53,2001,2000,London Area Airports,HEATHROW,INVERNESS,33,0,33,98,0,98,-66.32653046
25/04/2002 12:53,2001,2000,London Area Airports,HEATHROW,ISLE OF MAN,112959,112959,0,118042,118042,0,-4.306094646
25/04/2002 12:53,2001,2000,London Area Airports,HEATHROW,JERSEY,676,576,100,230989,230945,44,-99.70734406
25/04/2002 12:53,2001,2000,London Area Airports,HEATHROW,KENT INTERNATIONAL,0,0,0,195,0,195,
25/04/2002 12:53,2001,2000,London Area Airports,HEATHROW,KINROSS,0,0,0,191,0,191,
25/04/2002 12:53,2001,2000,London Area Airports,HEATHROW,LEEDS BRADFORD,203931,203871,60,214715,214466,249,-5.022471428
25/04/2002 12:53,2001,2000,London Area Airports,HEATHROW,LONDONDERRY,158,0,158,0,0,0,
25/04/2002 12:53,2001,2000,London Area Airports,HEATHROW,MANCHESTER,1283733,1283733,0,1309732,1309632,100,-1.985062599
25/04/2002 12:53,2001,2000,London Area Airports,HEATHROW,NEWCASTLE,459660,459660,0,469341,469341,0,-2.062679291
25/04/2002 12:53,2001,2000,London Area Airports,HEATHROW,PRESTWICK,0,0,0,77,0,77,
25/04/2002 12:53,2001,2000,London Area Airports,HEATHROW,SHEFFIELD CITY,0,0,0,58,0,58,
25/04/2002 12:53,2001,2000,London Area Airports,HEATHROW,STANSTED,0,0,0,100,0,100,
25/04/2002 12:53,2001,2000,London Area Airports,HEATHROW,TEESSIDE,156079,156079,0,172517,172517,0,-9.528336525
25/04/2002 12:53,2001,2000,London Area Airports,HEATHROW,WATTISHAM,0,0,0,1,0,1,
25/04/2002 12:53,2001,2000,London Area Airports,HEATHROW,WICK,0,0,0,59,0,59,
25/04/2002 12:53,2001,2000,London Area Airports,LONDON CITY,ABERDEEN,42002,42002,0,8805,8805,0,377.0244141
25/04/2002 12:53,2001,2000,London Area Airports,LONDON CITY,BELFAST CITY,52182,52182,0,27015,27015,0,93.15935516
25/04/2002 12:53,2001,2000,London Area Airports,LONDON CITY,BELFAST INTERNATIONAL,26,26,0,0,0,0,
25/04/2002 12:53,2001,2000,London Area Airports,LONDON CITY,BIGGIN HILL,10,10,0,0,0,0,
25/04/2002 12:53,2001,2000,London Area Airports,LONDON CITY,BIRMINGHAM,32,0,32,41,0,41,-21.95121956
25/04/2002 12:53,2001,2000,London Area Airports,LONDON CITY,BOURNEMOUTH,24,0,24,0,0,0,
25/04/2002 12:53,2001,2000,London Area Airports,LONDON CITY,BRISTOL,28,0,28,0,0,0,
25/04/2002 12:53,2001,2000,London Area Airports,LONDON CITY,CARDIFF WALES,28,0,28,0,0,0,
25/04/2002 12:53,2001,2000,London Area Airports,LONDON CITY,DUNDEE,46757,46757,0,44234,44234,0,5.703757286
25/04/2002 12:53,2001,2000,London Area Airports,LONDON CITY,EDINBURGH,163261,163250,11,131917,131905,12,23.76039505
25/04/2002 12:53,2001,2000,London Area Airports,LONDON CITY,EXETER,49,0,49,0,0,0,
25/04/2002 12:53,2001,2000,London Area Airports,LONDON CITY,GLASGOW,32918,32918,0,32345,32345,0,1.771525741
25/04/2002 12:53,2001,2000,London Area Airports,LONDON CITY,GLOUCESTERSHIRE,27,0,27,0,0,0,
25/04/2002 12:53,2001,2000,London Area Airports,LONDON CITY,HUMBERSIDE,0,0,0,33,0,33,
25/04/2002 12:53,2001,2000,London Area Airports,LONDON CITY,INVERNESS,1115,1115,0,0,0,0,
25/04/2002 12:53,2001,2000,London Area Airports,LONDON CITY,ISLE OF MAN,29903,29851,52,10457,10408,49,185.9615631
25/04/2002 12:53,2001,2000,London Area Airports,LONDON CITY,JERSEY,88142,88142,0,33333,33283,50,164.4286499
25/04/2002 12:53,2001,2000,London Area Airports,LONDON CITY,LEEDS BRADFORD,35,0,35,13959,13959,0,-99.74926758
25/04/2002 12:53,2001,2000,London Area Airports,LONDON CITY,LIVERPOOL,113,0,113,0,0,0,
25/04/2002 12:53,2001,2000,London Area Airports,LONDON CITY,NEWQUAY,80,0,80,0,0,0,
25/04/2002 12:53,2001,2000,London Area Airports,LONDON CITY,NORWICH,0,0,0,7,0,7,
25/04/2002 12:53,2001,2000,London Area Airports,LONDON CITY,SHEFFIELD CITY,0,0,0,2072,2072,0,
25/04/2002 12:53,2001,2000,London Area Airports,LONDON CITY,SOUTHAMPTON,0,0,0,3,0,3,
25/04/2002 12:53,2001,2000,London Area Airports,LONDON CITY,STANSTED,0,0,0,1,0,1,
25/04/2002 12:53,2001,2000,London Area Airports,LONDON CITY,WICK,23,0,23,0,0,0,
25/04/2002 12:53,2001,2000,London Area Airports,LUTON,ABERDEEN,159301,159301,0,159743,159743,0,-0.276694447
25/04/2002 12:53,2001,2000,London Area Airports,LUTON,BELFAST INTERNATIONAL,377795,377677,118,318656,318656,0,18.55888557
25/04/2002 12:53,2001,2000,London Area Airports,LUTON,BIRMINGHAM,0,0,0,1,0,1,
25/04/2002 12:53,2001,2000,London Area Airports,LUTON,BLACKPOOL,27,0,27,0,0,0,
25/04/2002 12:53,2001,2000,London Area Airports,LUTON,BOURNEMOUTH,6,0,6,2,0,2,200
25/04/2002 12:53,2001,2000,London Area Airports,LUTON,CARDIFF WALES,381,0,381,0,0,0,
25/04/2002 12:53,2001,2000,London Area Airports,LUTON,EDINBURGH,486404,486287,117,395749,395427,322,22.90719604
25/04/2002 12:53,2001,2000,London Area Airports,LUTON,EXETER,191,155,36,0,0,0,
25/04/2002 12:53,2001,2000,London Area Airports,LUTON,GLASGOW,490658,489231,1427,437150,437143,7,12.24019241
25/04/2002 12:53,2001,2000,London Area Airports,LUTON,INVERNESS,112581,112581,0,108072,108072,0,4.172218323
25/04/2002 12:53,2001,2000,London Area Airports,LUTON,ISLE OF MAN,40909,40748,161,45786,45786,0,-10.65172768
25/04/2002 12:53,2001,2000,London Area Airports,LUTON,JERSEY,40263,40101,162,52105,51973,132,-22.7271862
25/04/2002 12:53,2001,2000,London Area Airports,LUTON,LEEDS BRADFORD,68,0,68,77,0,77,-11.68831158
25/04/2002 12:53,2001,2000,London Area Airports,LUTON,LEUCHARS,4,0,4,37,0,37,-89.1891861
25/04/2002 12:53,2001,2000,London Area Airports,LUTON,LIVERPOOL,48983,48647,336,200443,200369,74,-75.5626297
25/04/2002 12:53,2001,2000,London Area Airports,LUTON,MANCHESTER,1137,115,1022,7,0,7,16142.85742
25/04/2002 12:53,2001,2000,London Area Airports,LUTON,NEWCASTLE,171,0,171,97,0,97,76.28865814
25/04/2002 12:53,2001,2000,London Area Airports,LUTON,PRESTWICK,0,0,0,77,0,77,
25/04/2002 12:53,2001,2000,London Area Airports,LUTON,SOUTHAMPTON,0,0,0,2,0,2,
25/04/2002 12:53,2001,2000,London Area Airports,LUTON,STANSTED,28,0,28,1,0,1,2700
25/04/2002 12:53,2001,2000,London Area Airports,LUTON,TEESSIDE,38,0,38,50,0,50,-24
25/04/2002 12:53,2001,2000,London Area Airports,SOUTHEND,EXETER,0,0,0,124,0,124,
25/04/2002 12:53,2001,2000,London Area Airports,SOUTHEND,JERSEY,3073,0,3073,2515,0,2515,22.1868782
25/04/2002 12:53,2001,2000,London Area Airports,STANSTED,ABERDEEN,91,0,91,28,0,28,225
25/04/2002 12:53,2001,2000,London Area Airports,STANSTED,BELFAST CITY,53048,53048,0,162686,162686,0,-67.39240265
25/04/2002 12:53,2001,2000,London Area Airports,STANSTED,BELFAST INTERNATIONAL,253157,253157,0,34030,33884,146,643.9230347
25/04/2002 12:53,2001,2000,London Area Airports,STANSTED,BIRMINGHAM,23,0,23,67,0,67,-65.67163849
25/04/2002 12:53,2001,2000,London Area Airports,STANSTED,BLACKPOOL,331,0,331,0,0,0,
25/04/2002 12:53,2001,2000,London Area Airports,STANSTED,BRISTOL,189,189,0,0,0,0,
25/04/2002 12:53,2001,2000,London Area Airports,STANSTED,CARDIFF WALES,1311,0,1311,0,0,0,
25/04/2002 12:53,2001,2000,London Area Airports,STANSTED,EAST MIDLANDS,20,0,20,0,0,0,
25/04/2002 12:53,2001,2000,London Area Airports,STANSTED,EDINBURGH,487449,486916,533,450932,450832,100,8.098116875
25/04/2002 12:53,2001,2000,London Area Airports,STANSTED,GLASGOW,287301,286694,607,67707,67476,231,324.329834
25/04/2002 12:53,2001,2000,London Area Airports,STANSTED,GUERNSEY,50271,50271,0,47235,47235,0,6.427437305
25/04/2002 12:53,2001,2000,London Area Airports,STANSTED,INVERNESS,2562,0,2562,2583,0,2583,-0.81300813
25/04/2002 12:53,2001,2000,London Area Airports,STANSTED,ISLE OF MAN,56,0,56,843,0,843,-93.35705566
25/04/2002 12:53,2001,2000,London Area Airports,STANSTED,JERSEY,5584,0,5584,5567,0,5567,0.305370927
25/04/2002 12:53,2001,2000,London Area Airports,STANSTED,KIRKWALL,0,0,0,110,0,110,
25/04/2002 12:53,2001,2000,London Area Airports,STANSTED,LEEDS BRADFORD,77,0,77,0,0,0,
25/04/2002 12:53,2001,2000,London Area Airports,STANSTED,LEUCHARS,0,0,0,161,0,161,
25/04/2002 12:53,2001,2000,London Area Airports,STANSTED,LIVERPOOL,776,0,776,204,0,204,280.3921509
25/04/2002 12:53,2001,2000,London Area Airports,STANSTED,LONDONDERRY,131198,131198,0,124338,124338,0,5.517219067
25/04/2002 12:53,2001,2000,London Area Airports,STANSTED,MANCHESTER,45591,42517,3074,30410,30050,360,49.92107773
25/04/2002 12:53,2001,2000,London Area Airports,STANSTED,NEWCASTLE,71922,70648,1274,43480,42985,495,65.41398621
25/04/2002 12:53,2001,2000,London Area Airports,STANSTED,NEWQUAY,0,0,0,26,0,26,
25/04/2002 12:53,2001,2000,London Area Airports,STANSTED,PLYMOUTH,24,0,24,0,0,0,
25/04/2002 12:53,2001,2000,London Area Airports,STANSTED,PRESTWICK,627519,627519,0,440960,440960,0,42.3074646
25/04/2002 12:53,2001,2000,London Area Airports,STANSTED,STANSTED,209,0,209,52,0,52,301.9230652
25/04/2002 12:53,2001,2000,London Area Airports,STANSTED,TEESSIDE,279,0,279,122,0,122,128.6885223
25/04/2002 12:53,2001,2000,London Area Airports,STANSTED,WARTON,98,0,98,0,0,0,
25/04/2002 12:53,2001,2000,Other UK Airports,ABERDEEN,ABERDEEN,28,28,0,0,0,0,
25/04/2002 12:53,2001,2000,Other UK Airports,ABERDEEN,BELFAST CITY,1734,1734,0,0,0,0,
25/04/2002 12:53,2001,2000,Other UK Airports,ABERDEEN,BELFAST INTERNATIONAL,7335,7335,0,9016,9016,0,-18.64463234
25/04/2002 12:53,2001,2000,Other UK Airports,ABERDEEN,BIRMINGHAM,58513,58504,9,56809,56639,170,2.999524832
25/04/2002 12:53,2001,2000,Other UK Airports,ABERDEEN,BRISTOL,50026,50026,0,66505,66505,0,-24.77858734
25/04/2002 12:53,2001,2000,Other UK Airports,ABERDEEN,CARDIFF WALES,3823,3791,32,3183,3183,0,20.10681725
25/04/2002 12:53,2001,2000,Other UK Airports,ABERDEEN,EAST MIDLANDS,15849,15398,451,17972,17914,58,-11.81281948
25/04/2002 12:53,2001,2000,Other UK Airports,ABERDEEN,EDINBURGH,348,179,169,104,97,7,234.615387
25/04/2002 12:53,2001,2000,Other UK Airports,ABERDEEN,FARNBOROUGH,7,0,7,0,0,0,
25/04/2002 12:53,2001,2000,Other UK Airports,ABERDEEN,GLASGOW,4975,4890,85,5421,5419,2,-8.227264404
25/04/2002 12:53,2001,2000,Other UK Airports,ABERDEEN,HUMBERSIDE,28981,28981,0,20607,20607,0,40.63667679
25/04/2002 12:53,2001,2000,Other UK Airports,ABERDEEN,INVERNESS,74,0,74,0,0,0,
25/04/2002 12:53,2001,2000,Other UK Airports,ABERDEEN,JERSEY,1673,0,1673,2964,0,2964,-43.55600357
25/04/2002 12:53,2001,2000,Other UK Airports,ABERDEEN,KIRKWALL,36979,36979,0,35408,35408,0,4.436850548
25/04/2002 12:53,2001,2000,Other UK Airports,ABERDEEN,LEEDS BRADFORD,15384,15384,0,8209,8209,0,87.40406799
25/04/2002 12:53,2001,2000,Other UK Airports,ABERDEEN,MANCHESTER,152071,152030,41,128179,128179,0,18.63955879
25/04/2002 12:53,2001,2000,Other UK Airports,ABERDEEN,NEWCASTLE,46515,45986,529,8392,8392,0,454.2778931
25/04/2002 12:53,2001,2000,Other UK Airports,ABERDEEN,NORWICH,56456,56456,0,55693,55693,0,1.370010614
25/04/2002 12:53,2001,2000,Other UK Airports,ABERDEEN,PLYMOUTH,286,286,0,0,0,0,
25/04/2002 12:53,2001,2000,Other UK Airports,ABERDEEN,SCATSTA,133777,0,133777,132375,0,132375,1.05911243
25/04/2002 12:53,2001,2000,Other UK Airports,ABERDEEN,SOUTHAMPTON,26946,26946,0,36810,36810,0,-26.79706573
25/04/2002 12:53,2001,2000,Other UK Airports,ABERDEEN,STORNOWAY,48,0,48,0,0,0,
25/04/2002 12:53,2001,2000,Other UK Airports,ABERDEEN,STRATHALLAN,0,0,0,28,0,28,
25/04/2002 12:53,2001,2000,Other UK Airports,ABERDEEN,SUMBURGH,78421,74046,4375,74967,74220,747,4.607360363
25/04/2002 12:53,2001,2000,Other UK Airports,ABERDEEN,TEESSIDE,18338,18338,0,22615,22609,6,-18.91222572
25/04/2002 12:53,2001,2000,Other UK Airports,ABERDEEN,WICK,7986,7986,0,8376,8376,0,-4.656160355
25/04/2002 12:53,2001,2000,Other UK Airports,ALDERNEY,GUERNSEY,34061,34061,0,32809,32809,0,3.816025972
25/04/2002 12:53,2001,2000,Other UK Airports,ALDERNEY,JERSEY,9224,9224,0,9203,9203,0,0.228186458
25/04/2002 12:53,2001,2000,Other UK Airports,ALDERNEY,SOUTHAMPTON,28830,28830,0,28749,28749,0,0.281748921
25/04/2002 12:53,2001,2000,Other UK Airports,BARRA,BARRA,5,5,0,0,0,0,
25/04/2002 12:53,2001,2000,Other UK Airports,BARRA,BENBECULA,3021,3021,0,2509,2509,0,20.4065361
25/04/2002 12:53,2001,2000,Other UK Airports,BARRA,GLASGOW,5586,5586,0,4869,4869,0,14.72581673
25/04/2002 12:53,2001,2000,Other UK Airports,BELFAST CITY,BIRMINGHAM,164959,164959,0,188864,188864,0,-12.65725613
25/04/2002 12:53,2001,2000,Other UK Airports,BELFAST CITY,BLACKPOOL,9885,9829,56,28521,28521,0,-65.34132385
25/04/2002 12:53,2001,2000,Other UK Airports,BELFAST CITY,BRISTOL,59324,59324,0,63443,63394,49,-6.492442131
25/04/2002 12:53,2001,2000,Other UK Airports,BELFAST CITY,CARDIFF WALES,2236,2236,0,0,0,0,
25/04/2002 12:53,2001,2000,Other UK Airports,BELFAST CITY,DUNDEE,26,0,26,0,0,0,
25/04/2002 12:53,2001,2000,Other UK Airports,BELFAST CITY,EAST MIDLANDS,12300,12300,0,21,21,0,58471.42969
25/04/2002 12:53,2001,2000,Other UK Airports,BELFAST CITY,EDINBURGH,62951,62951,0,72405,72405,0,-13.05710888
25/04/2002 12:53,2001,2000,Other UK Airports,BELFAST CITY,EXETER,1950,1950,0,1094,1094,0,78.24497223
25/04/2002 12:53,2001,2000,Other UK Airports,BELFAST CITY,GLASGOW,83985,83591,394,94677,94677,0,-11.29313374
25/04/2002 12:53,2001,2000,Other UK Airports,BELFAST CITY,INVERNESS,68,0,68,0,0,0,
25/04/2002 12:53,2001,2000,Other UK Airports,BELFAST CITY,ISLE OF MAN,22632,22628,4,1258,1258,0,1699.046143
25/04/2002 12:53,2001,2000,Other UK Airports,BELFAST CITY,LEEDS BRADFORD,76455,76455,0,81620,81620,0,-6.328105927
25/04/2002 12:53,2001,2000,Other UK Airports,BELFAST CITY,LIVERPOOL,4554,4554,0,44589,44589,0,-89.78672028
25/04/2002 12:53,2001,2000,Other UK Airports,BELFAST CITY,MANCHESTER,106189,106189,0,117121,117121,0,-9.333936691
25/04/2002 12:53,2001,2000,Other UK Airports,BELFAST CITY,NEWCASTLE,102042,102015,27,94161,94161,0,8.369707108
25/04/2002 12:53,2001,2000,Other UK Airports,BELFAST CITY,PRESTWICK,96,0,96,750,750,0,-87.19999695
25/04/2002 12:53,2001,2000,Other UK Airports,BELFAST CITY,SHEFFIELD CITY,21750,21750,0,24916,24916,0,-12.7066946
25/04/2002 12:53,2001,2000,Other UK Airports,BELFAST CITY,SOUTHAMPTON,24853,24853,0,23482,23482,0,5.838514805
25/04/2002 12:53,2001,2000,Other UK Airports,BELFAST INTERNATIONAL,BIRMINGHAM,145130,145122,8,160003,159842,161,-9.295451164
25/04/2002 12:53,2001,2000,Other UK Airports,BELFAST INTERNATIONAL,BRISTOL,31401,31401,0,0,0,0,
25/04/2002 12:53,2001,2000,Other UK Airports,BELFAST INTERNATIONAL,CARDIFF WALES,12909,12711,198,15323,15134,189,-15.75409508
25/04/2002 12:53,2001,2000,Other UK Airports,BELFAST INTERNATIONAL,EAST MIDLANDS,61200,61200,0,68538,68478,60,-10.70646954
25/04/2002 12:53,2001,2000,Other UK Airports,BELFAST INTERNATIONAL,EDINBURGH,157119,156448,671,23045,22965,80,581.7921753
25/04/2002 12:53,2001,2000,Other UK Airports,BELFAST INTERNATIONAL,GLASGOW,163476,163073,403,38987,38752,235,319.3089905
25/04/2002 12:53,2001,2000,Other UK Airports,BELFAST INTERNATIONAL,JERSEY,11534,11534,0,12817,12817,0,-10.01014233
25/04/2002 12:53,2001,2000,Other UK Airports,BELFAST INTERNATIONAL,LIVERPOOL,446849,446849,0,259526,259526,0,72.17889404
25/04/2002 12:53,2001,2000,Other UK Airports,BELFAST INTERNATIONAL,MANCHESTER,63744,63744,0,95181,95177,4,-33.02865219
25/04/2002 12:53,2001,2000,Other UK Airports,BELFAST INTERNATIONAL,NEWCASTLE,0,0,0,10066,10019,47,
25/04/2002 12:53,2001,2000,Other UK Airports,BELFAST INTERNATIONAL,NEWQUAY,0,0,0,1,0,1,
25/04/2002 12:53,2001,2000,Other UK Airports,BELFAST INTERNATIONAL,SOUTH MARSTON,4,0,4,0,0,0,
25/04/2002 12:53,2001,2000,Other UK Airports,BELFAST INTERNATIONAL,TEESSIDE,0,0,0,52,52,0,
25/04/2002 12:53,2001,2000,Other UK Airports,BENBECULA,GLASGOW,21296,21296,0,21297,21297,0,-0.004695497
25/04/2002 12:53,2001,2000,Other UK Airports,BENBECULA,STORNOWAY,9684,9684,0,8989,8989,0,7.73167181
25/04/2002 12:53,2001,2000,Other UK Airports,BIGGIN HILL,BLACKPOOL,982,982,0,0,0,0,
25/04/2002 12:53,2001,2000,Other UK Airports,BIGGIN HILL,LIVERPOOL,29,0,29,0,0,0,
25/04/2002 12:53,2001,2000,Other UK Airports,BIGGIN HILL,NEWCASTLE,38,0,38,0,0,0,
25/04/2002 12:53,2001,2000,Other UK Airports,BIGGIN HILL,NEWQUAY,0,0,0,17,0,17,
25/04/2002 12:53,2001,2000,Other UK Airports,BIGGIN HILL,TEESSIDE,80,0,80,0,0,0,
25/04/2002 12:53,2001,2000,Other UK Airports,BIGGIN HILL,WICK,0,0,0,60,0,60,
25/04/2002 12:53,2001,2000,Other UK Airports,BIRMINGHAM,BIRMINGHAM,213,0,213,0,0,0,
25/04/2002 12:53,2001,2000,Other UK Airports,BIRMINGHAM,BRISTOL,63,0,63,37,0,37,70.2702713
25/04/2002 12:53,2001,2000,Other UK Airports,BIRMINGHAM,EDINBURGH,288505,287623,882,287465,287112,353,0.361783177
25/04/2002 12:53,2001,2000,Other UK Airports,BIRMINGHAM,EXETER,28088,28034,54,37543,37543,0,-25.18445587
25/04/2002 12:53,2001,2000,Other UK Airports,BIRMINGHAM,GLASGOW,277728,277639,89,285301,284395,906,-2.65438962
25/04/2002 12:53,2001,2000,Other UK Airports,BIRMINGHAM,GUERNSEY,37341,37341,0,34872,34872,0,7.080178738
25/04/2002 12:53,2001,2000,Other UK Airports,BIRMINGHAM,HAWARDEN,0,0,0,213,0,213,
25/04/2002 12:53,2001,2000,Other UK Airports,BIRMINGHAM,INVERNESS,67,0,67,0,0,0,
25/04/2002 12:53,2001,2000,Other UK Airports,BIRMINGHAM,ISLE OF MAN,47165,47165,0,44409,44409,0,6.205949306
25/04/2002 12:53,2001,2000,Other UK Airports,BIRMINGHAM,JERSEY,87526,78736,8790,85327,79891,5436,2.577144384
25/04/2002 12:53,2001,2000,Other UK Airports,BIRMINGHAM,KINLOSS,250,0,250,0,0,0,
25/04/2002 12:53,2001,2000,Other UK Airports,BIRMINGHAM,LEEDS BRADFORD,39,0,39,0,0,0,
25/04/2002 12:53,2001,2000,Other UK Airports,BIRMINGHAM,LEUCHARS,38,0,38,0,0,0,
25/04/2002 12:53,2001,2000,Other UK Airports,BIRMINGHAM,MANCHESTER,72,0,72,192,0,192,-62.5
25/04/2002 12:53,2001,2000,Other UK Airports,BIRMINGHAM,NEWCASTLE,32209,32209,0,30395,30395,0,5.96808672
25/04/2002 12:53,2001,2000,Other UK Airports,BIRMINGHAM,NORTHOLT,84,0,84,0,0,0,
25/04/2002 12:53,2001,2000,Other UK Airports,BIRMINGHAM,PRESTWICK,0,0,0,80,0,80,
25/04/2002 12:53,2001,2000,Other UK Airports,BIRMINGHAM,SOUTHAMPTON,39,0,39,0,0,0,
25/04/2002 12:53,2001,2000,Other UK Airports,BIRMINGHAM,WICK,0,0,0,108,0,108,
25/04/2002 12:53,2001,2000,Other UK Airports,BLACKBUSHE,JERSEY,0,0,0,3075,0,3075,
25/04/2002 12:53,2001,2000,Other UK Airports,BLACKPOOL,CARDIFF WALES,264,0,264,0,0,0,
25/04/2002 12:53,2001,2000,Other UK Airports,BLACKPOOL,EDINBURGH,30,0,30,0,0,0,
25/04/2002 12:53,2001,2000,Other UK Airports,BLACKPOOL,ISLE OF MAN,4319,4319,0,12466,12466,0,-65.35375977
25/04/2002 12:53,2001,2000,Other UK Airports,BLACKPOOL,JERSEY,2740,0,2740,3676,0,3676,-25.46245956
25/04/2002 12:53,2001,2000,Other UK Airports,BLACKPOOL,NORTHOLT,34,0,34,0,0,0,
25/04/2002 12:53,2001,2000,Other UK Airports,BLACKPOOL,SOUTH MARSTON,0,0,0,56,0,56,
25/04/2002 12:53,2001,2000,Other UK Airports,BOURNEMOUTH,BRISTOL,0,0,0,269,0,269,
25/04/2002 12:53,2001,2000,Other UK Airports,BOURNEMOUTH,DUNKESWELL,0,0,0,248,0,248,
25/04/2002 12:53,2001,2000,Other UK Airports,BOURNEMOUTH,EDINBURGH,334,0,334,2477,2021,456,-86.51594543
25/04/2002 12:53,2001,2000,Other UK Airports,BOURNEMOUTH,EXETER,47,0,47,0,0,0,
25/04/2002 12:53,2001,2000,Other UK Airports,BOURNEMOUTH,FILTON,0,0,0,100,0,100,
25/04/2002 12:53,2001,2000,Other UK Airports,BOURNEMOUTH,GLASGOW,0,0,0,4309,4080,229,
25/04/2002 12:53,2001,2000,Other UK Airports,BOURNEMOUTH,JERSEY,3988,0,3988,2843,0,2843,40.27435684
25/04/2002 12:53,2001,2000,Other UK Airports,BOURNEMOUTH,MANCHESTER,0,0,0,61,0,61,
25/04/2002 12:53,2001,2000,Other UK Airports,BOURNEMOUTH,PLYMOUTH,32,0,32,0,0,0,
25/04/2002 12:53,2001,2000,Other UK Airports,BOURNEMOUTH,PRESTWICK,0,0,0,1,0,1,
25/04/2002 12:53,2001,2000,Other UK Airports,BOURNEMOUTH,SOUTHAMPTON,0,0,0,65,0,65,
25/04/2002 12:53,2001,2000,Other UK Airports,BRISTOL,BRISTOL,191,0,191,0,0,0,
25/04/2002 12:53,2001,2000,Other UK Airports,BRISTOL,CARDIFF WALES,405,10,395,245,0,245,65.30612183
25/04/2002 12:53,2001,2000,Other UK Airports,BRISTOL,DUNDEE,51,0,51,0,0,0,
25/04/2002 12:53,2001,2000,Other UK Airports,BRISTOL,EAST MIDLANDS,219,0,219,47,0,47,365.9574585
25/04/2002 12:53,2001,2000,Other UK Airports,BRISTOL,EDINBURGH,160618,160571,47,110930,110930,0,44.79220963
25/04/2002 12:53,2001,2000,Other UK Airports,BRISTOL,ENNISKILLEN,52,0,52,0,0,0,
25/04/2002 12:53,2001,2000,Other UK Airports,BRISTOL,EXETER,12,12,0,0,0,0,
25/04/2002 12:53,2001,2000,Other UK Airports,BRISTOL,GLASGOW,143571,143571,0,104620,104610,10,37.23093033
25/04/2002 12:53,2001,2000,Other UK Airports,BRISTOL,GUERNSEY,10692,10692,0,11837,11837,0,-9.673059464
25/04/2002 12:53,2001,2000,Other UK Airports,BRISTOL,ISLE OF MAN,12196,12196,0,564,424,140,2062.411377
25/04/2002 12:53,2001,2000,Other UK Airports,BRISTOL,ISLES OF SCILLY (ST.MARYS),2987,2987,0,2699,2699,0,10.67061901
25/04/2002 12:53,2001,2000,Other UK Airports,BRISTOL,JERSEY,16091,15990,101,12291,12291,0,30.91693115
25/04/2002 12:53,2001,2000,Other UK Airports,BRISTOL,LEEDS BRADFORD,0,0,0,242,0,242,
25/04/2002 12:53,2001,2000,Other UK Airports,BRISTOL,MANCHESTER,2786,1922,864,71,71,0,3823.943604
25/04/2002 12:53,2001,2000,Other UK Airports,BRISTOL,NEWCASTLE,26038,26038,0,264,237,27,9762.878906
25/04/2002 12:53,2001,2000,Other UK Airports,BRISTOL,NEWQUAY,601,558,43,0,0,0,
25/04/2002 12:53,2001,2000,Other UK Airports,BRISTOL,NORTHOLT,20,0,20,0,0,0,
25/04/2002 12:53,2001,2000,Other UK Airports,BRISTOL,PLYMOUTH,31101,31101,0,23760,23760,0,30.8964653
25/04/2002 12:53,2001,2000,Other UK Airports,BRISTOL,PRESTWICK,52,0,52,54,0,54,-3.703703642
25/04/2002 12:53,2001,2000,Other UK Airports,BRISTOL,SHEFFIELD CITY,50,0,50,0,0,0,
25/04/2002 12:53,2001,2000,Other UK Airports,BRIZE NORTON,COVENTRY,3,0,3,0,0,0,
25/04/2002 12:53,2001,2000,Other UK Airports,BRIZE NORTON,EDINBURGH,92,0,92,0,0,0,
25/04/2002 12:53,2001,2000,Other UK Airports,CAMBRIDGE,EDINBURGH,0,0,0,148,148,0,
25/04/2002 12:53,2001,2000,Other UK Airports,CAMBRIDGE,WICK,86,0,86,0,0,0,
25/04/2002 12:53,2001,2000,Other UK Airports,CAMPBELTOWN,GLASGOW,8003,8003,0,7069,7069,0,13.21261883
25/04/2002 12:53,2001,2000,Other UK Airports,CAMPBELTOWN,INVERNESS,0,0,0,44,0,44,
25/04/2002 12:53,2001,2000,Other UK Airports,CARDIFF WALES,EDINBURGH,32968,25829,7139,23259,23111,148,41.74298096
25/04/2002 12:53,2001,2000,Other UK Airports,CARDIFF WALES,GLASGOW,25279,25275,4,24388,24360,28,3.653436184
25/04/2002 12:53,2001,2000,Other UK Airports,CARDIFF WALES,GUERNSEY,2675,2675,0,2199,2199,0,21.64620209
25/04/2002 12:53,2001,2000,Other UK Airports,CARDIFF WALES,ISLE OF MAN,46,0,46,0,0,0,
25/04/2002 12:53,2001,2000,Other UK Airports,CARDIFF WALES,JERSEY,22187,20833,1354,19908,19908,0,11.44765949
25/04/2002 12:53,2001,2000,Other UK Airports,CARDIFF WALES,LIVERPOOL,1019,0,1019,0,0,0,
25/04/2002 12:53,2001,2000,Other UK Airports,CARDIFF WALES,MANCHESTER,2037,1532,505,68,0,68,2895.588135
25/04/2002 12:53,2001,2000,Other UK Airports,CARDIFF WALES,NEWCASTLE,6632,6632,0,1409,1409,0,370.688446
25/04/2002 12:53,2001,2000,Other UK Airports,CARDIFF WALES,NORTHOLT,100,0,100,0,0,0,
25/04/2002 12:53,2001,2000,Other UK Airports,CARDIFF WALES,NORWICH,100,0,100,0,0,0,
25/04/2002 12:53,2001,2000,Other UK Airports,COTTESMORE(RAF),INVERNESS,0,0,0,6,0,6,
25/04/2002 12:53,2001,2000,Other UK Airports,COVENTRY,EDINBURGH,50,0,50,5,0,5,900
25/04/2002 12:53,2001,2000,Other UK Airports,COVENTRY,LEEDS BRADFORD,1,0,1,0,0,0,
25/04/2002 12:53,2001,2000,Other UK Airports,COVENTRY,SOUTH MARSTON,0,0,0,1,0,1,
25/04/2002 12:53,2001,2000,Other UK Airports,DUNDEE,JERSEY,2047,0,2047,1990,0,1990,2.864321709
25/04/2002 12:53,2001,2000,Other UK Airports,DUNDEE,NORTHOLT,59,0,59,0,0,0,
25/04/2002 12:53,2001,2000,Other UK Airports,DUNDEE,NORWICH,81,0,81,0,0,0,
25/04/2002 12:53,2001,2000,Other UK Airports,EAST MIDLANDS,EDINBURGH,74283,73191,1092,80531,80531,0,-7.75850296
25/04/2002 12:53,2001,2000,Other UK Airports,EAST MIDLANDS,GLASGOW,93374,93374,0,95450,95450,0,-2.174960613
25/04/2002 12:53,2001,2000,Other UK Airports,EAST MIDLANDS,GUERNSEY,10260,10260,0,11321,11321,0,-9.371963501
25/04/2002 12:53,2001,2000,Other UK Airports,EAST MIDLANDS,JERSEY,63229,61004,2225,62223,60153,2070,1.616765499
25/04/2002 12:53,2001,2000,Other UK Airports,EDAY,KIRKWALL,451,451,0,280,280,0,61.07143021
25/04/2002 12:53,2001,2000,Other UK Airports,EDINBURGH,EXETER,2,0,2,0,0,0,
25/04/2002 12:53,2001,2000,Other UK Airports,EDINBURGH,FARNBOROUGH,25,0,25,19,0,19,31.57894707
25/04/2002 12:53,2001,2000,Other UK Airports,EDINBURGH,GLASGOW,31,0,31,2,0,2,1450
25/04/2002 12:53,2001,2000,Other UK Airports,EDINBURGH,GUERNSEY,1333,1333,0,2806,2806,0,-52.49465561
25/04/2002 12:53,2001,2000,Other UK Airports,EDINBURGH,INVERNESS,1523,1509,14,157,0,157,870.0637207
25/04/2002 12:53,2001,2000,Other UK Airports,EDINBURGH,ISLAY,0,0,0,33,0,33,
25/04/2002 12:53,2001,2000,Other UK Airports,EDINBURGH,JERSEY,9619,8774,845,12396,10563,1833,-22.40238762
25/04/2002 12:53,2001,2000,Other UK Airports,EDINBURGH,KIRKWALL,28959,28853,106,24995,24995,0,15.85917187
25/04/2002 12:53,2001,2000,Other UK Airports,EDINBURGH,LEEDS BRADFORD,34467,34457,10,28489,28489,0,20.98353767
25/04/2002 12:53,2001,2000,Other UK Airports,EDINBURGH,LIVERPOOL,0,0,0,44,0,44,
25/04/2002 12:53,2001,2000,Other UK Airports,EDINBURGH,MANCHESTER,178363,178092,271,165817,165782,35,7.566172123
25/04/2002 12:53,2001,2000,Other UK Airports,EDINBURGH,NEWCASTLE,142,0,142,0,0,0,
25/04/2002 12:53,2001,2000,Other UK Airports,EDINBURGH,NORTHOLT,39,0,39,34,0,34,14.70588207
25/04/2002 12:53,2001,2000,Other UK Airports,EDINBURGH,NORWICH,23968,23968,0,13491,13487,4,77.65917969
25/04/2002 12:53,2001,2000,Other UK Airports,EDINBURGH,PLYMOUTH,1887,1855,32,649,649,0,190.7550049
25/04/2002 12:53,2001,2000,Other UK Airports,EDINBURGH,PRESTWICK,7,0,7,0,0,0,
25/04/2002 12:53,2001,2000,Other UK Airports,EDINBURGH,SCATSTA,107,0,107,0,0,0,
25/04/2002 12:53,2001,2000,Other UK Airports,EDINBURGH,SOUTHAMPTON,75578,75578,0,75337,75337,0,0.319895923
25/04/2002 12:53,2001,2000,Other UK Airports,EDINBURGH,STORNOWAY,11066,11065,1,8428,8428,0,31.30042648
25/04/2002 12:53,2001,2000,Other UK Airports,EDINBURGH,SUMBURGH,16674,15914,760,13780,13780,0,21.00145149
25/04/2002 12:53,2001,2000,Other UK Airports,EDINBURGH,TEESSIDE,297,0,297,0,0,0,
25/04/2002 12:53,2001,2000,Other UK Airports,EDINBURGH,WICK,135,103,32,0,0,0,
25/04/2002 12:53,2001,2000,Other UK Airports,ENNISKILLEN,JERSEY,481,0,481,482,0,482,-0.207468882
25/04/2002 12:53,2001,2000,Other UK Airports,EXETER,GUERNSEY,24917,24917,0,22640,22640,0,10.05742073
25/04/2002 12:53,2001,2000,Other UK Airports,EXETER,ISLES OF SCILLY (ST.MARYS),4201,4201,0,4602,4602,0,-8.71360302
25/04/2002 12:53,2001,2000,Other UK Airports,EXETER,JERSEY,39915,39915,0,41433,41433,0,-3.663746357
25/04/2002 12:53,2001,2000,Other UK Airports,EXETER,MANCHESTER,6,6,0,3,0,3,100
25/04/2002 12:53,2001,2000,Other UK Airports,EXETER,NORTHOLT,108,0,108,0,0,0,
25/04/2002 12:53,2001,2000,Other UK Airports,EXETER,PRIVATE STRIPS/HELIPADS,10,0,10,0,0,0,
25/04/2002 12:53,2001,2000,Other UK Airports,EXETER,TEESSIDE,128,0,128,0,0,0,
25/04/2002 12:53,2001,2000,Other UK Airports,FAIR ISLE,LERWICK  (TINGWALL),1957,1957,0,1591,1591,0,23.00440025
25/04/2002 12:53,2001,2000,Other UK Airports,FAIR ISLE,SUMBURGH,144,144,0,137,137,0,5.109488964
25/04/2002 12:53,2001,2000,Other UK Airports,FARNBOROUGH,GLASGOW,7,0,7,0,0,0,
25/04/2002 12:53,2001,2000,Other UK Airports,FARNBOROUGH,JERSEY,1,0,1,4,0,4,-75
25/04/2002 12:53,2001,2000,Other UK Airports,FARNBOROUGH,NORWICH,32,0,32,0,0,0,
25/04/2002 12:53,2001,2000,Other UK Airports,FARNBOROUGH,SOUTHAMPTON,29,0,29,0,0,0,
25/04/2002 12:53,2001,2000,Other UK Airports,FILTON,GLASGOW,83,0,83,0,0,0,
25/04/2002 12:53,2001,2000,Other UK Airports,FILTON,HAWARDEN,2751,0,2751,2490,0,2490,10.48192787
25/04/2002 12:53,2001,2000,Other UK Airports,FILTON,KENT INTERNATIONAL,122,0,122,0,0,0,
25/04/2002 12:53,2001,2000,Other UK Airports,FILTON,NEWCASTLE,93,0,93,0,0,0,
25/04/2002 12:53,2001,2000,Other UK Airports,GLASGOW,GLASGOW,0,0,0,24,0,24,
25/04/2002 12:53,2001,2000,Other UK Airports,GLASGOW,GUERNSEY,805,805,0,1929,1929,0,-58.2685318
25/04/2002 12:53,2001,2000,Other UK Airports,GLASGOW,HUMBERSIDE,0,0,0,111,0,111,
25/04/2002 12:53,2001,2000,Other UK Airports,GLASGOW,INVERNESS,20724,20618,106,12814,12814,0,61.72935867
25/04/2002 12:53,2001,2000,Other UK Airports,GLASGOW,ISLAY,19609,19609,0,18678,18678,0,4.984473705
25/04/2002 12:53,2001,2000,Other UK Airports,GLASGOW,ISLE OF MAN,25816,25816,0,24401,24401,0,5.798942566
25/04/2002 12:53,2001,2000,Other UK Airports,GLASGOW,JERSEY,19796,19515,281,21275,21199,76,-6.951821327
25/04/2002 12:53,2001,2000,Other UK Airports,GLASGOW,KIRKWALL,6417,6266,151,1407,1407,0,356.0767517
25/04/2002 12:53,2001,2000,Other UK Airports,GLASGOW,LEEDS BRADFORD,36265,36260,5,31701,31701,0,14.39702225
25/04/2002 12:53,2001,2000,Other UK Airports,GLASGOW,LONDONDERRY,21397,21397,0,18131,18131,0,18.01334763
25/04/2002 12:53,2001,2000,Other UK Airports,GLASGOW,MANCHESTER,148101,147394,707,149307,149285,22,-0.807731748
25/04/2002 12:53,2001,2000,Other UK Airports,GLASGOW,NEWCASTLE,573,0,573,212,0,212,170.28302
25/04/2002 12:53,2001,2000,Other UK Airports,GLASGOW,NORTHOLT,4,0,4,0,0,0,
25/04/2002 12:53,2001,2000,Other UK Airports,GLASGOW,NORWICH,37,0,37,1885,1885,0,-98.03713226
25/04/2002 12:53,2001,2000,Other UK Airports,GLASGOW,PLYMOUTH,6434,6434,0,15102,15102,0,-57.39636993
25/04/2002 12:53,2001,2000,Other UK Airports,GLASGOW,SCATSTA,88,0,88,0,0,0,
25/04/2002 12:53,2001,2000,Other UK Airports,GLASGOW,SOUTHAMPTON,71183,70725,458,74412,74109,303,-4.339354038
25/04/2002 12:53,2001,2000,Other UK Airports,GLASGOW,STORNOWAY,47989,47932,57,49845,49845,0,-3.723542929
25/04/2002 12:53,2001,2000,Other UK Airports,GLASGOW,SUMBURGH,18164,16539,1625,28311,28311,0,-35.84119415
25/04/2002 12:53,2001,2000,Other UK Airports,GLASGOW,TIREE,5244,5244,0,4641,4641,0,12.9928894
25/04/2002 12:53,2001,2000,Other UK Airports,GLASGOW,WARTON,2,0,2,0,0,0,
25/04/2002 12:53,2001,2000,Other UK Airports,GLOUCESTERSHIRE,SOUTHAMPTON,32,0,32,0,0,0,
25/04/2002 12:53,2001,2000,Other UK Airports,GUERNSEY,ISLE OF MAN,566,0,566,0,0,0,
25/04/2002 12:53,2001,2000,Other UK Airports,GUERNSEY,JERSEY,160370,160370,0,158062,158062,0,1.460186481
25/04/2002 12:53,2001,2000,Other UK Airports,GUERNSEY,LEEDS BRADFORD,3226,3226,0,3639,3639,0,-11.34927177
25/04/2002 12:53,2001,2000,Other UK Airports,GUERNSEY,MANCHESTER,51802,51802,0,47117,45165,1952,9.943332672
25/04/2002 12:53,2001,2000,Other UK Airports,GUERNSEY,NEWCASTLE,917,917,0,0,0,0,
25/04/2002 12:53,2001,2000,Other UK Airports,GUERNSEY,NORWICH,800,800,0,0,0,0,
25/04/2002 12:53,2001,2000,Other UK Airports,GUERNSEY,PLYMOUTH,388,388,0,0,0,0,
25/04/2002 12:53,2001,2000,Other UK Airports,GUERNSEY,PRIVATE STRIPS/HELIPADS,10,0,10,6,0,6,66.66666412
25/04/2002 12:53,2001,2000,Other UK Airports,GUERNSEY,SOUTHAMPTON,122919,122919,0,133659,133659,0,-8.035373688
25/04/2002 12:53,2001,2000,Other UK Airports,HUMBERSIDE,JERSEY,3454,0,3454,3600,0,3600,-4.055555344
25/04/2002 12:53,2001,2000,Other UK Airports,HUMBERSIDE,LEUCHARS,117,0,117,0,0,0,
25/04/2002 12:53,2001,2000,Other UK Airports,HUMBERSIDE,MANCHESTER,177,0,177,0,0,0,
25/04/2002 12:53,2001,2000,Other UK Airports,HUMBERSIDE,NEWCASTLE,18,18,0,0,0,0,
25/04/2002 12:53,2001,2000,Other UK Airports,HUMBERSIDE,NORTHOLT,0,0,0,44,0,44,
25/04/2002 12:53,2001,2000,Other UK Airports,HUMBERSIDE,NORWICH,48,0,48,573,573,0,-91.62303925
25/04/2002 12:53,2001,2000,Other UK Airports,INVERNESS,ISLAY,0,0,0,33,0,33,
25/04/2002 12:53,2001,2000,Other UK Airports,INVERNESS,KIRKWALL,9764,9764,0,4822,4822,0,102.4885941
25/04/2002 12:53,2001,2000,Other UK Airports,INVERNESS,MANCHESTER,0,0,0,48,0,48,
25/04/2002 12:53,2001,2000,Other UK Airports,INVERNESS,NORTHOLT,130,0,130,0,0,0,
25/04/2002 12:53,2001,2000,Other UK Airports,INVERNESS,SOUTH MARSTON,54,0,54,0,0,0,
25/04/2002 12:53,2001,2000,Other UK Airports,INVERNESS,SOUTHAMPTON,0,0,0,32,0,32,
25/04/2002 12:53,2001,2000,Other UK Airports,INVERNESS,STORNOWAY,23818,23818,0,19860,19860,0,19.9295063
25/04/2002 12:53,2001,2000,Other UK Airports,INVERNESS,SUMBURGH,3894,3894,0,6724,6724,0,-42.08804321
25/04/2002 12:53,2001,2000,Other UK Airports,INVERNESS,TEESSIDE,46,0,46,0,0,0,
25/04/2002 12:53,2001,2000,Other UK Airports,INVERNESS,WARTON,32,0,32,0,0,0,
25/04/2002 12:53,2001,2000,Other UK Airports,INVERNESS,WICK,0,0,0,48,0,48,
25/04/2002 12:53,2001,2000,Other UK Airports,ISLE OF MAN,JERSEY,10918,10461,457,5708,5697,11,91.27540588
25/04/2002 12:53,2001,2000,Other UK Airports,ISLE OF MAN,LEEDS BRADFORD,11398,11398,0,11172,11172,0,2.02291441
25/04/2002 12:53,2001,2000,Other UK Airports,ISLE OF MAN,LIVERPOOL,198410,198388,22,215285,215128,157,-7.838446617
25/04/2002 12:53,2001,2000,Other UK Airports,ISLE OF MAN,LONDONDERRY,0,0,0,136,0,136,
25/04/2002 12:53,2001,2000,Other UK Airports,ISLE OF MAN,MANCHESTER,97332,97196,136,91261,91089,172,6.652348995
25/04/2002 12:53,2001,2000,Other UK Airports,ISLE OF MAN,NEWCASTLE,0,0,0,10,0,10,
25/04/2002 12:53,2001,2000,Other UK Airports,ISLE OF MAN,NORWICH,0,0,0,18,0,18,
25/04/2002 12:53,2001,2000,Other UK Airports,ISLE OF MAN,SOUTHAMPTON,3992,3992,0,4308,4308,0,-7.335190296
25/04/2002 12:53,2001,2000,Other UK Airports,ISLE OF MAN,SUMBURGH,180,0,180,0,0,0,
25/04/2002 12:53,2001,2000,Other UK Airports,ISLE OF MAN,WEST FREUGH,0,0,0,73,0,73,
25/04/2002 12:53,2001,2000,Other UK Airports,JERSEY,JERSEY,91,91,0,0,0,0,
25/04/2002 12:53,2001,2000,Other UK Airports,JERSEY,LEEDS BRADFORD,29993,28339,1654,24692,24684,8,21.46849251
25/04/2002 12:53,2001,2000,Other UK Airports,JERSEY,LIVERPOOL,6945,2831,4114,3145,3144,1,120.8267059
25/04/2002 12:53,2001,2000,Other UK Airports,JERSEY,LONDONDERRY,480,196,284,489,0,489,-1.840490818
25/04/2002 12:53,2001,2000,Other UK Airports,JERSEY,MANCHESTER,86698,73312,13386,96526,83272,13254,-10.1817131
25/04/2002 12:53,2001,2000,Other UK Airports,JERSEY,NEWCASTLE,10726,3248,7478,9627,2595,7032,11.41580963
25/04/2002 12:53,2001,2000,Other UK Airports,JERSEY,NORTHOLT,0,0,0,10,0,10,
25/04/2002 12:53,2001,2000,Other UK Airports,JERSEY,NORWICH,5664,899,4765,4234,0,4234,33.77420807
25/04/2002 12:53,2001,2000,Other UK Airports,JERSEY,PLYMOUTH,9444,9444,0,6266,6230,36,50.71816254
25/04/2002 12:53,2001,2000,Other UK Airports,JERSEY,PRESTWICK,1310,0,1310,1182,0,1182,10.82910347
25/04/2002 12:53,2001,2000,Other UK Airports,JERSEY,SHEFFIELD CITY,908,0,908,0,0,0,
25/04/2002 12:53,2001,2000,Other UK Airports,JERSEY,SOUTHAMPTON,153455,151877,1578,157784,153836,3948,-2.74362421
25/04/2002 12:53,2001,2000,Other UK Airports,JERSEY,TEESSIDE,7324,7324,0,6805,6638,167,7.626745224
25/04/2002 12:53,2001,2000,Other UK Airports,KIRKWALL,MANCHESTER,104,0,104,65,0,65,60
25/04/2002 12:53,2001,2000,Other UK Airports,KIRKWALL,NORTH RONALDSAY,3884,3884,0,3832,3832,0,1.356993794
25/04/2002 12:53,2001,2000,Other UK Airports,KIRKWALL,PAPA WESTRAY,2489,2489,0,2223,2223,0,11.96581173
25/04/2002 12:53,2001,2000,Other UK Airports,KIRKWALL,SANDAY,2076,2076,0,1816,1816,0,14.31718063
25/04/2002 12:53,2001,2000,Other UK Airports,KIRKWALL,STRONSAY,2430,2430,0,2144,2144,0,13.33955193
25/04/2002 12:53,2001,2000,Other UK Airports,KIRKWALL,SUMBURGH,7243,7243,0,6200,6200,0,16.82258034
25/04/2002 12:53,2001,2000,Other UK Airports,KIRKWALL,WESTRAY,2081,2081,0,2038,2038,0,2.10991168
25/04/2002 12:53,2001,2000,Other UK Airports,KIRKWALL,WICK,4511,4511,0,2447,2447,0,84.34818268
25/04/2002 12:53,2001,2000,Other UK Airports,LEEDS BRADFORD,LEEDS BRADFORD,130,0,130,0,0,0,
25/04/2002 12:53,2001,2000,Other UK Airports,LEEDS BRADFORD,MANCHESTER,20,0,20,1,0,1,1900
25/04/2002 12:53,2001,2000,Other UK Airports,LEEDS BRADFORD,NEWCASTLE,0,0,0,6,0,6,
25/04/2002 12:53,2001,2000,Other UK Airports,LEEDS BRADFORD,NORTHOLT,142,0,142,0,0,0,
25/04/2002 12:53,2001,2000,Other UK Airports,LEEDS BRADFORD,NORWICH,0,0,0,33,0,33,
25/04/2002 12:53,2001,2000,Other UK Airports,LEEDS BRADFORD,SHEFFIELD CITY,32,0,32,0,0,0,
25/04/2002 12:53,2001,2000,Other UK Airports,LEEDS BRADFORD,SOUTHAMPTON,24558,24521,37,21706,21706,0,13.13922405
25/04/2002 12:53,2001,2000,Other UK Airports,LERWICK  (TINGWALL),UNST,26,26,0,46,46,0,-43.47826004
25/04/2002 12:53,2001,2000,Other UK Airports,LIVERPOOL,NEWCASTLE,0,0,0,37,0,37,
25/04/2002 12:53,2001,2000,Other UK Airports,LIVERPOOL,NORTHOLT,42,0,42,0,0,0,
25/04/2002 12:53,2001,2000,Other UK Airports,LIVERPOOL,SANDOWN,28,0,28,0,0,0,
25/04/2002 12:53,2001,2000,Other UK Airports,LIVERPOOL,SOUTHAMPTON,65,0,65,0,0,0,
25/04/2002 12:53,2001,2000,Other UK Airports,LONDONDERRY,MANCHESTER,15952,15952,0,13644,13599,45,16.91586113
25/04/2002 12:53,2001,2000,Other UK Airports,LYDD,NORTHOLT,29,0,29,0,0,0,
25/04/2002 12:53,2001,2000,Other UK Airports,MANCHESTER,NEWCASTLE,45,0,45,0,0,0,
25/04/2002 12:53,2001,2000,Other UK Airports,MANCHESTER,NEWQUAY,0,0,0,32,0,32,
25/04/2002 12:53,2001,2000,Other UK Airports,MANCHESTER,NORTHOLT,75,0,75,0,0,0,
25/04/2002 12:53,2001,2000,Other UK Airports,MANCHESTER,NORWICH,14358,14358,0,10348,10290,58,38.75144958
25/04/2002 12:53,2001,2000,Other UK Airports,MANCHESTER,ODIHAM,0,0,0,80,0,80,
25/04/2002 12:53,2001,2000,Other UK Airports,MANCHESTER,SCATSTA,3,0,3,0,0,0,
25/04/2002 12:53,2001,2000,Other UK Airports,MANCHESTER,SOUTHAMPTON,64944,64837,107,62821,62380,441,3.379443169
25/04/2002 12:53,2001,2000,Other UK Airports,NEWCASTLE,NORTHOLT,90,0,90,0,0,0,
25/04/2002 12:53,2001,2000,Other UK Airports,NEWCASTLE,PLYMOUTH,2706,2706,0,0,0,0,
25/04/2002 12:53,2001,2000,Other UK Airports,NEWCASTLE,SOUTHAMPTON,33392,33251,141,28967,28847,120,15.27600384
25/04/2002 12:53,2001,2000,Other UK Airports,NEWCASTLE,WICK,2112,2112,0,7685,7685,0,-72.51789093
25/04/2002 12:53,2001,2000,Other UK Airports,NORTHOLT,SHEFFIELD CITY,32,0,32,0,0,0,
25/04/2002 12:53,2001,2000,Other UK Airports,NORTHOLT,SOUTHAMPTON,50,0,50,0,0,0,
25/04/2002 12:53,2001,2000,Other UK Airports,NORTHOLT,TEESSIDE,10,0,10,0,0,0,
25/04/2002 12:53,2001,2000,Other UK Airports,NORTHOLT,WICK,16,0,16,41,0,41,-60.97560883
25/04/2002 12:53,2001,2000,Other UK Airports,SCATSTA,SCATSTA,0,0,0,95,0,95,
25/04/2002 12:53,2001,2000,Other UK Airports,SCATSTA,SUMBURGH,54,0,54,244,0,244,-77.86885071
25/04/2002 12:53,2001,2000,Other UK Airports,SCATSTA,WICK,0,0,0,34,0,34,
25/04/2002 12:53,2001,2000,Other UK Airports,SHEFFIELD CITY,WARTON,23,0,23,0,0,0,
25/04/2002 12:53,2001,2000,Other UK Airports,SOUTH MARSTON,WICK,34,0,34,72,0,72,-52.77777863
25/04/2002 12:53,2001,2000,Other UK Airports,SOUTHAMPTON,TEESSIDE,48,0,48,0,0,0,
25/04/2002 12:53,2001,2000,Other UK Airports,SOUTHAMPTON,WADDINGTON,50,0,50,0,0,0,
25/04/2002 12:53,2001,2000,Other UK Airports,SOUTHAMPTON,WARTON,333,0,333,0,0,0,
25/04/2002 12:53,2001,2000,Other UK Airports,SUMBURGH,UNST,238,238,0,1305,1305,0,-81.76245117
25/04/2002 12:53,2001,2000,Other UK Airports,SUMBURGH,WICK,1723,1723,0,252,252,0,583.7301636
