rundate,this_period,last_period,grp_cd,grp_name,apt1_apt_name,apt2_apt_name,total_pax_tp,total_pax_shd_tp,total_pax_cht_tp,total_pax_lp,total_pax_shd_lp,total_pax_cht_lp,total_pax_pc
10/9/2008 10:47,1994,1993,A,London Area Airports,GATWICK,ABERDEEN,204448,204448,0,202289,202289,0,1.067284942
10/9/2008 10:47,1994,1993,A,London Area Airports,GATWICK,BELFAST CITY (GEORGE BEST),210809,210809,0,121007,121007,0,74.2122345
10/9/2008 10:47,1994,1993,A,London Area Airports,GATWICK,BELFAST INTERNATIONAL,316,0,316,1964,1692,272,-83.91038513
10/9/2008 10:47,1994,1993,A,London Area Airports,GATWICK,BIRMINGHAM,239,0,239,88,0,88,171.5909119
10/9/2008 10:47,1994,1993,A,London Area Airports,GATWICK,BOURNEMOUTH,77,0,77,15,0,15,413.3333435
10/9/2008 10:47,1994,1993,A,London Area Airports,GATWICK,CARDIFF WALES,16,0,16,220,0,220,-92.72727203
10/9/2008 10:47,1994,1993,A,London Area Airports,GATWICK,CITY OF DERRY (EGLINTON),0,0,0,223,0,223,
10/9/2008 10:47,1994,1993,A,London Area Airports,GATWICK,DURHAM TEES VALLEY,162,25,137,220,0,220,-26.36363602
10/9/2008 10:47,1994,1993,A,London Area Airports,GATWICK,EAST MIDLANDS INTERNATIONAL,194,0,194,2,0,2,9600
10/9/2008 10:47,1994,1993,A,London Area Airports,GATWICK,EDINBURGH,202955,202018,937,189871,189664,207,6.890994549
10/9/2008 10:47,1994,1993,A,London Area Airports,GATWICK,EXETER,2,0,2,0,0,0,
10/9/2008 10:47,1994,1993,A,London Area Airports,GATWICK,FILTON,5,0,5,0,0,0,
10/9/2008 10:47,1994,1993,A,London Area Airports,GATWICK,GLASGOW,190918,189809,1109,175984,175141,843,8.485999107
10/9/2008 10:47,1994,1993,A,London Area Airports,GATWICK,GUERNSEY,189573,189436,137,175218,175215,3,8.192651749
10/9/2008 10:47,1994,1993,A,London Area Airports,GATWICK,HEATHROW,3,0,3,0,0,0,
10/9/2008 10:47,1994,1993,A,London Area Airports,GATWICK,ISLE OF MAN,0,0,0,473,0,473,
10/9/2008 10:47,1994,1993,A,London Area Airports,GATWICK,JERSEY,276009,267581,8428,249195,244752,4443,10.76024818
10/9/2008 10:47,1994,1993,A,London Area Airports,GATWICK,LEEDS BRADFORD,22824,22628,196,2987,2949,38,664.111145
10/9/2008 10:47,1994,1993,A,London Area Airports,GATWICK,LIVERPOOL,125,0,125,29,0,29,331.0344849
10/9/2008 10:47,1994,1993,A,London Area Airports,GATWICK,LUTON,14,0,14,0,0,0,
10/9/2008 10:47,1994,1993,A,London Area Airports,GATWICK,LYDD,0,0,0,2,0,2,
10/9/2008 10:47,1994,1993,A,London Area Airports,GATWICK,MANCHESTER,254769,252733,2036,212946,212173,773,19.64019012
10/9/2008 10:47,1994,1993,A,London Area Airports,GATWICK,NEWCASTLE,74777,74541,236,64292,64156,136,16.30840492
10/9/2008 10:47,1994,1993,A,London Area Airports,GATWICK,STANSTED,0,0,0,6,0,6,
10/9/2008 10:47,1994,1993,A,London Area Airports,HEATHROW,ABERDEEN,481625,481625,0,469604,469553,51,2.55981636
10/9/2008 10:47,1994,1993,A,London Area Airports,HEATHROW,BELFAST CITY (GEORGE BEST),82089,82065,24,13763,13763,0,496.446991
10/9/2008 10:47,1994,1993,A,London Area Airports,HEATHROW,BELFAST INTERNATIONAL,1068643,1068469,174,1119614,1119551,63,-4.55255127
10/9/2008 10:47,1994,1993,A,London Area Airports,HEATHROW,BIRMINGHAM,600,0,600,70810,70335,475,-99.15266418
10/9/2008 10:47,1994,1993,A,London Area Airports,HEATHROW,BRISTOL,519,19,500,0,0,0,
10/9/2008 10:47,1994,1993,A,London Area Airports,HEATHROW,CAMBRIDGE,0,0,0,40,0,40,
10/9/2008 10:47,1994,1993,A,London Area Airports,HEATHROW,CARDIFF WALES,465,154,311,201,0,201,131.343277
10/9/2008 10:47,1994,1993,A,London Area Airports,HEATHROW,DURHAM TEES VALLEY,175811,175811,0,162322,162322,0,8.310026169
10/9/2008 10:47,1994,1993,A,London Area Airports,HEATHROW,EAST MIDLANDS INTERNATIONAL,660,261,399,259,59,200,154.8262482
10/9/2008 10:47,1994,1993,A,London Area Airports,HEATHROW,EDINBURGH,1478916,1478858,58,1375202,1375202,0,7.541728497
10/9/2008 10:47,1994,1993,A,London Area Airports,HEATHROW,FAIRFORD,400,0,400,0,0,0,
10/9/2008 10:47,1994,1993,A,London Area Airports,HEATHROW,FARNBOROUGH,98,0,98,0,0,0,
10/9/2008 10:47,1994,1993,A,London Area Airports,HEATHROW,GLASGOW,1429358,1428816,542,1328511,1328346,165,7.590979576
10/9/2008 10:47,1994,1993,A,London Area Airports,HEATHROW,GUERNSEY,90150,90150,0,79255,79255,0,13.74676704
10/9/2008 10:47,1994,1993,A,London Area Airports,HEATHROW,HUMBERSIDE,200,0,200,200,0,200,0
10/9/2008 10:47,1994,1993,A,London Area Airports,HEATHROW,INVERNESS,195540,195406,134,169435,169435,0,15.40708828
10/9/2008 10:47,1994,1993,A,London Area Airports,HEATHROW,ISLE OF MAN,116819,116819,0,109269,109231,38,6.909553528
10/9/2008 10:47,1994,1993,A,London Area Airports,HEATHROW,JERSEY,259267,258862,405,281371,280786,585,-7.855820179
10/9/2008 10:47,1994,1993,A,London Area Airports,HEATHROW,KENT INTERNATIONAL,347,0,347,400,0,400,-13.25
10/9/2008 10:47,1994,1993,A,London Area Airports,HEATHROW,LEEDS BRADFORD,191888,191489,399,178574,177875,699,7.455732822
10/9/2008 10:47,1994,1993,A,London Area Airports,HEATHROW,LEUCHARS,129,0,129,132,0,132,-2.272727251
10/9/2008 10:47,1994,1993,A,London Area Airports,HEATHROW,LIVERPOOL,240,0,240,237,0,237,1.265822768
10/9/2008 10:47,1994,1993,A,London Area Airports,HEATHROW,LUTON,200,0,200,0,0,0,
10/9/2008 10:47,1994,1993,A,London Area Airports,HEATHROW,MANCHESTER,1024608,1023269,1339,928374,927348,1026,10.36586571
10/9/2008 10:47,1994,1993,A,London Area Airports,HEATHROW,NEWCASTLE,423677,423677,0,389403,389403,0,8.801678658
10/9/2008 10:47,1994,1993,A,London Area Airports,HEATHROW,NEWQUAY,28082,27928,154,30304,30304,0,-7.332365513
10/9/2008 10:47,1994,1993,A,London Area Airports,HEATHROW,PLYMOUTH,54304,54304,0,44330,44310,20,22.49943542
10/9/2008 10:47,1994,1993,A,London Area Airports,HEATHROW,PRESTWICK,20,0,20,0,0,0,
10/9/2008 10:47,1994,1993,A,London Area Airports,HEATHROW,WICK,0,0,0,52,0,52,
10/9/2008 10:47,1994,1993,A,London Area Airports,LONDON CITY,CITY OF DERRY (EGLINTON),80,0,80,0,0,0,
10/9/2008 10:47,1994,1993,A,London Area Airports,LONDON CITY,HUMBERSIDE,703,703,0,0,0,0,
10/9/2008 10:47,1994,1993,A,London Area Airports,LONDON CITY,LIVERPOOL,12326,12326,0,33,0,33,37251.51563
10/9/2008 10:47,1994,1993,A,London Area Airports,LUTON,ABERDEEN,6,0,6,0,0,0,
10/9/2008 10:47,1994,1993,A,London Area Airports,LUTON,BELFAST CITY (GEORGE BEST),73022,73022,0,35737,35619,118,104.3316422
10/9/2008 10:47,1994,1993,A,London Area Airports,LUTON,BELFAST INTERNATIONAL,3677,3612,65,121833,121801,32,-96.98193359
10/9/2008 10:47,1994,1993,A,London Area Airports,LUTON,BRISTOL,8,0,8,0,0,0,
10/9/2008 10:47,1994,1993,A,London Area Airports,LUTON,CAMBRIDGE,0,0,0,2,0,2,
10/9/2008 10:47,1994,1993,A,London Area Airports,LUTON,EDINBURGH,449,0,449,0,0,0,
10/9/2008 10:47,1994,1993,A,London Area Airports,LUTON,GLASGOW,0,0,0,96,0,96,
10/9/2008 10:47,1994,1993,A,London Area Airports,LUTON,ISLE OF MAN,19751,19751,0,16337,16337,0,20.89735031
10/9/2008 10:47,1994,1993,A,London Area Airports,LUTON,JERSEY,11922,10775,1147,11681,10431,1250,2.063179493
10/9/2008 10:47,1994,1993,A,London Area Airports,LUTON,LIVERPOOL,0,0,0,1,0,1,
10/9/2008 10:47,1994,1993,A,London Area Airports,LUTON,LUTON,119,0,119,0,0,0,
10/9/2008 10:47,1994,1993,A,London Area Airports,LUTON,MANCHESTER,408,0,408,40,0,40,920
10/9/2008 10:47,1994,1993,A,London Area Airports,LUTON,NEWCASTLE,183,0,183,196,0,196,-6.632653236
10/9/2008 10:47,1994,1993,A,London Area Airports,LUTON,SOUTHAMPTON,0,0,0,4,0,4,
10/9/2008 10:47,1994,1993,A,London Area Airports,LUTON,STANSTED,0,0,0,129,0,129,
10/9/2008 10:47,1994,1993,A,London Area Airports,SOUTHEND,CRANFIELD,0,0,0,49,0,49,
10/9/2008 10:47,1994,1993,A,London Area Airports,SOUTHEND,DUXFORD,0,0,0,52,0,52,
10/9/2008 10:47,1994,1993,A,London Area Airports,SOUTHEND,JERSEY,495,0,495,9120,0,9120,-94.57236481
10/9/2008 10:47,1994,1993,A,London Area Airports,SOUTHEND,MANCHESTER,0,0,0,18,0,18,
10/9/2008 10:47,1994,1993,A,London Area Airports,SOUTHEND,NEWCASTLE,0,0,0,66,0,66,
10/9/2008 10:47,1994,1993,A,London Area Airports,STANSTED,ABERDEEN,73501,73257,244,72473,71711,762,1.418459296
10/9/2008 10:47,1994,1993,A,London Area Airports,STANSTED,BELFAST CITY (GEORGE BEST),59837,59837,0,0,0,0,
10/9/2008 10:47,1994,1993,A,London Area Airports,STANSTED,BELFAST INTERNATIONAL,56,0,56,5,0,5,1020
10/9/2008 10:47,1994,1993,A,London Area Airports,STANSTED,BIRMINGHAM,102,0,102,109,0,109,-6.422018528
10/9/2008 10:47,1994,1993,A,London Area Airports,STANSTED,BOURNEMOUTH,23,0,23,0,0,0,
10/9/2008 10:47,1994,1993,A,London Area Airports,STANSTED,CAMBRIDGE,0,0,0,14,0,14,
10/9/2008 10:47,1994,1993,A,London Area Airports,STANSTED,CARDIFF WALES,116,0,116,0,0,0,
10/9/2008 10:47,1994,1993,A,London Area Airports,STANSTED,DURHAM TEES VALLEY,1989,1989,0,63,0,63,3057.142822
10/9/2008 10:47,1994,1993,A,London Area Airports,STANSTED,EAST MIDLANDS INTERNATIONAL,0,0,0,25,0,25,
10/9/2008 10:47,1994,1993,A,London Area Airports,STANSTED,EDINBURGH,108633,108445,188,54099,54062,37,100.8040848
10/9/2008 10:47,1994,1993,A,London Area Airports,STANSTED,EXETER,19,0,19,0,0,0,
10/9/2008 10:47,1994,1993,A,London Area Airports,STANSTED,GLASGOW,107429,107429,0,115564,115564,0,-7.03938961
10/9/2008 10:47,1994,1993,A,London Area Airports,STANSTED,GUERNSEY,17710,17380,330,20030,19950,80,-11.58262634
10/9/2008 10:47,1994,1993,A,London Area Airports,STANSTED,HUMBERSIDE,715,715,0,74,0,74,866.2161865
10/9/2008 10:47,1994,1993,A,London Area Airports,STANSTED,ISLE OF MAN,89,0,89,269,0,269,-66.91449738
10/9/2008 10:47,1994,1993,A,London Area Airports,STANSTED,JERSEY,50570,49648,922,39648,37898,1750,27.54741669
10/9/2008 10:47,1994,1993,A,London Area Airports,STANSTED,LEEDS BRADFORD,0,0,0,48,0,48,
10/9/2008 10:47,1994,1993,A,London Area Airports,STANSTED,LIVERPOOL,0,0,0,138,0,138,
10/9/2008 10:47,1994,1993,A,London Area Airports,STANSTED,MANCHESTER,17294,17292,2,9828,9646,182,75.96662903
10/9/2008 10:47,1994,1993,A,London Area Airports,STANSTED,NEWCASTLE,32968,32968,0,22220,21664,556,48.37083817
10/9/2008 10:47,1994,1993,A,London Area Airports,STANSTED,PRESTWICK,24,0,24,0,0,0,
10/9/2008 10:47,1994,1993,A,London Area Airports,STANSTED,SOUTHAMPTON,1,0,1,137,84,53,-99.27007294
10/9/2008 10:47,1994,1993,A,London Area Airports,STANSTED,SUMBURGH,46,0,46,186,0,186,-75.26881409
10/9/2008 10:47,1994,1993,A,London Area Airports,STANSTED,WOODFORD,4,0,4,0,0,0,
10/9/2008 10:47,1994,1993,B,Other UK Airports,ABERDEEN,ABERDEEN,0,0,0,33,0,33,
10/9/2008 10:47,1994,1993,B,Other UK Airports,ABERDEEN,BELFAST CITY (GEORGE BEST),0,0,0,1094,1094,0,
10/9/2008 10:47,1994,1993,B,Other UK Airports,ABERDEEN,BELFAST INTERNATIONAL,9733,9733,0,2912,2912,0,234.2376404
10/9/2008 10:47,1994,1993,B,Other UK Airports,ABERDEEN,BENBECULA,0,0,0,12,0,12,
10/9/2008 10:47,1994,1993,B,Other UK Airports,ABERDEEN,BIRMINGHAM,44859,44859,0,42684,42567,117,5.0955863
10/9/2008 10:47,1994,1993,B,Other UK Airports,ABERDEEN,BRISTOL,21121,21121,0,9573,9573,0,120.6309433
10/9/2008 10:47,1994,1993,B,Other UK Airports,ABERDEEN,CARDIFF WALES,7280,7280,0,6216,6216,0,17.11711693
10/9/2008 10:47,1994,1993,B,Other UK Airports,ABERDEEN,DUNDEE,15,15,0,0,0,0,
10/9/2008 10:47,1994,1993,B,Other UK Airports,ABERDEEN,DURHAM TEES VALLEY,4367,4367,0,9193,9171,22,-52.49646378
10/9/2008 10:47,1994,1993,B,Other UK Airports,ABERDEEN,EAST MIDLANDS INTERNATIONAL,25325,25236,89,22490,21997,493,12.60560226
10/9/2008 10:47,1994,1993,B,Other UK Airports,ABERDEEN,EDINBURGH,778,770,8,294,273,21,164.6258545
10/9/2008 10:47,1994,1993,B,Other UK Airports,ABERDEEN,EXETER,0,0,0,23,0,23,
10/9/2008 10:47,1994,1993,B,Other UK Airports,ABERDEEN,FLOTTA,0,0,0,14,0,14,
10/9/2008 10:47,1994,1993,B,Other UK Airports,ABERDEEN,GLASGOW,22655,22611,44,34472,33913,559,-34.27999496
10/9/2008 10:47,1994,1993,B,Other UK Airports,ABERDEEN,HUMBERSIDE,41776,41776,0,38762,38762,0,7.7756567
10/9/2008 10:47,1994,1993,B,Other UK Airports,ABERDEEN,INVERNESS,2167,2021,146,852,795,57,154.3427277
10/9/2008 10:47,1994,1993,B,Other UK Airports,ABERDEEN,JERSEY,4499,0,4499,2910,0,2910,54.60481262
10/9/2008 10:47,1994,1993,B,Other UK Airports,ABERDEEN,KINLOSS,0,0,0,2,0,2,
10/9/2008 10:47,1994,1993,B,Other UK Airports,ABERDEEN,KIRKWALL,28593,28545,48,24676,24412,264,15.87372303
10/9/2008 10:47,1994,1993,B,Other UK Airports,ABERDEEN,LEEDS BRADFORD,3574,3574,0,50,0,50,7048
10/9/2008 10:47,1994,1993,B,Other UK Airports,ABERDEEN,LEUCHARS,0,0,0,2,0,2,
10/9/2008 10:47,1994,1993,B,Other UK Airports,ABERDEEN,MANCHESTER,78832,78832,0,76967,76923,44,2.423116446
10/9/2008 10:47,1994,1993,B,Other UK Airports,ABERDEEN,NEWCASTLE,26376,26374,2,35843,35685,158,-26.41240883
10/9/2008 10:47,1994,1993,B,Other UK Airports,ABERDEEN,NORWICH,42424,42408,16,51737,51698,39,-18.00065804
10/9/2008 10:47,1994,1993,B,Other UK Airports,ABERDEEN,PETERHEAD,0,0,0,28,0,28,
10/9/2008 10:47,1994,1993,B,Other UK Airports,ABERDEEN,PLYMOUTH,1956,1956,0,0,0,0,
10/9/2008 10:47,1994,1993,B,Other UK Airports,ABERDEEN,PRESTWICK,0,0,0,37,0,37,
10/9/2008 10:47,1994,1993,B,Other UK Airports,ABERDEEN,SCATSTA,0,0,0,13067,0,13067,
10/9/2008 10:47,1994,1993,B,Other UK Airports,ABERDEEN,SOUTHAMPTON,3161,3161,0,0,0,0,
10/9/2008 10:47,1994,1993,B,Other UK Airports,ABERDEEN,STORNOWAY,0,0,0,13,0,13,
10/9/2008 10:47,1994,1993,B,Other UK Airports,ABERDEEN,SUMBURGH,253789,94886,158903,237841,80619,157222,6.705319881
10/9/2008 10:47,1994,1993,B,Other UK Airports,ABERDEEN,UNST,42442,0,42442,73508,0,73508,-42.26206589
10/9/2008 10:47,1994,1993,B,Other UK Airports,ABERDEEN,WICK,13065,13065,0,13137,13074,63,-0.548070312
10/9/2008 10:47,1994,1993,B,Other UK Airports,ALDERNEY,GUERNSEY,36841,36841,0,33950,33950,0,8.515463829
10/9/2008 10:47,1994,1993,B,Other UK Airports,ALDERNEY,JERSEY,15212,15212,0,13621,13621,0,11.68049335
10/9/2008 10:47,1994,1993,B,Other UK Airports,ALDERNEY,SOUTHAMPTON,31641,31641,0,29055,29055,0,8.900361061
10/9/2008 10:47,1994,1993,B,Other UK Airports,BARRA,BENBECULA,1591,1591,0,0,0,0,
10/9/2008 10:47,1994,1993,B,Other UK Airports,BARRA,GLASGOW,1557,1557,0,8,8,0,19362.5
10/9/2008 10:47,1994,1993,B,Other UK Airports,BARRA,STORNOWAY,106,106,0,0,0,0,
10/9/2008 10:47,1994,1993,B,Other UK Airports,BARRA,TIREE,1964,1964,0,0,0,0,
10/9/2008 10:47,1994,1993,B,Other UK Airports,BELFAST CITY (GEORGE BEST),BIRMINGHAM,138279,138246,33,74711,74711,0,85.08519745
10/9/2008 10:47,1994,1993,B,Other UK Airports,BELFAST CITY (GEORGE BEST),BLACKPOOL,36490,36490,0,45121,45121,0,-19.12856483
10/9/2008 10:47,1994,1993,B,Other UK Airports,BELFAST CITY (GEORGE BEST),BRISTOL,37230,37230,0,35587,35587,0,4.616854668
10/9/2008 10:47,1994,1993,B,Other UK Airports,BELFAST CITY (GEORGE BEST),CARDIFF WALES,14725,14662,63,14850,14850,0,-0.84175086
10/9/2008 10:47,1994,1993,B,Other UK Airports,BELFAST CITY (GEORGE BEST),DURHAM TEES VALLEY,9046,9046,0,7142,7142,0,26.65919876
10/9/2008 10:47,1994,1993,B,Other UK Airports,BELFAST CITY (GEORGE BEST),EAST MIDLANDS INTERNATIONAL,48677,48677,0,7452,7295,157,553.2072144
10/9/2008 10:47,1994,1993,B,Other UK Airports,BELFAST CITY (GEORGE BEST),EDINBURGH,63120,63120,0,64416,64416,0,-2.011922598
10/9/2008 10:47,1994,1993,B,Other UK Airports,BELFAST CITY (GEORGE BEST),EXETER,14052,14052,0,8225,8225,0,70.84498596
10/9/2008 10:47,1994,1993,B,Other UK Airports,BELFAST CITY (GEORGE BEST),GLASGOW,71653,71653,0,66379,66379,0,7.94528389
10/9/2008 10:47,1994,1993,B,Other UK Airports,BELFAST CITY (GEORGE BEST),GUERNSEY,0,0,0,2613,2479,134,
10/9/2008 10:47,1994,1993,B,Other UK Airports,BELFAST CITY (GEORGE BEST),ISLE OF MAN,24732,24732,0,22376,22376,0,10.52913857
10/9/2008 10:47,1994,1993,B,Other UK Airports,BELFAST CITY (GEORGE BEST),JERSEY,10901,8479,2422,29046,29046,0,-62.46987534
10/9/2008 10:47,1994,1993,B,Other UK Airports,BELFAST CITY (GEORGE BEST),LEEDS BRADFORD,71598,71598,0,67184,67184,0,6.570016861
10/9/2008 10:47,1994,1993,B,Other UK Airports,BELFAST CITY (GEORGE BEST),LIVERPOOL,68662,68662,0,71559,71559,0,-4.048407555
10/9/2008 10:47,1994,1993,B,Other UK Airports,BELFAST CITY (GEORGE BEST),MANCHESTER,121626,121579,47,102131,102065,66,19.08823013
10/9/2008 10:47,1994,1993,B,Other UK Airports,BELFAST CITY (GEORGE BEST),NEWCASTLE,47807,47807,0,43209,43209,0,10.64130116
10/9/2008 10:47,1994,1993,B,Other UK Airports,BELFAST CITY (GEORGE BEST),SOUTHAMPTON,11308,11308,0,1295,1295,0,773.2046509
10/9/2008 10:47,1994,1993,B,Other UK Airports,BELFAST INTERNATIONAL,BIRMINGHAM,109608,109284,324,93351,93039,312,17.41491699
10/9/2008 10:47,1994,1993,B,Other UK Airports,BELFAST INTERNATIONAL,BLACKPOOL,0,0,0,15,15,0,
10/9/2008 10:47,1994,1993,B,Other UK Airports,BELFAST INTERNATIONAL,COVENTRY,1,0,1,4,0,4,-75
10/9/2008 10:47,1994,1993,B,Other UK Airports,BELFAST INTERNATIONAL,EAST MIDLANDS INTERNATIONAL,127,0,127,52936,52808,128,-99.76008606
10/9/2008 10:47,1994,1993,B,Other UK Airports,BELFAST INTERNATIONAL,EDINBURGH,0,0,0,90,0,90,
10/9/2008 10:47,1994,1993,B,Other UK Airports,BELFAST INTERNATIONAL,GLASGOW,65695,65695,0,61880,61753,127,6.165158272
10/9/2008 10:47,1994,1993,B,Other UK Airports,BELFAST INTERNATIONAL,GLOUCESTERSHIRE,0,0,0,54,0,54,
10/9/2008 10:47,1994,1993,B,Other UK Airports,BELFAST INTERNATIONAL,HUMBERSIDE,0,0,0,4737,4737,0,
10/9/2008 10:47,1994,1993,B,Other UK Airports,BELFAST INTERNATIONAL,JERSEY,19828,19480,348,21302,21003,299,-6.919538021
10/9/2008 10:47,1994,1993,B,Other UK Airports,BELFAST INTERNATIONAL,KENT INTERNATIONAL,118,0,118,0,0,0,
10/9/2008 10:47,1994,1993,B,Other UK Airports,BELFAST INTERNATIONAL,LEEDS BRADFORD,2351,2261,90,9228,9228,0,-74.52319336
10/9/2008 10:47,1994,1993,B,Other UK Airports,BELFAST INTERNATIONAL,LIVERPOOL,87,0,87,0,0,0,
10/9/2008 10:47,1994,1993,B,Other UK Airports,BELFAST INTERNATIONAL,MANCHESTER,122029,121850,179,127846,127738,108,-4.550005436
10/9/2008 10:47,1994,1993,B,Other UK Airports,BELFAST INTERNATIONAL,NEWCASTLE,66,0,66,951,951,0,-93.05993652
10/9/2008 10:47,1994,1993,B,Other UK Airports,BELFAST INTERNATIONAL,PRESTWICK,0,0,0,1,0,1,
10/9/2008 10:47,1994,1993,B,Other UK Airports,BEMBRIDGE,JERSEY,0,0,0,513,0,513,
10/9/2008 10:47,1994,1993,B,Other UK Airports,BENBECULA,GLASGOW,21804,21804,0,20604,20604,0,5.824111938
10/9/2008 10:47,1994,1993,B,Other UK Airports,BENBECULA,ST KILDA,0,0,0,397,0,397,
10/9/2008 10:47,1994,1993,B,Other UK Airports,BENBECULA,STORNOWAY,12609,12609,0,11294,11294,0,11.6433506
10/9/2008 10:47,1994,1993,B,Other UK Airports,BENSON,NEWCASTLE,0,0,0,43,0,43,
10/9/2008 10:47,1994,1993,B,Other UK Airports,BIRMINGHAM,BRISTOL,0,0,0,95,0,95,
10/9/2008 10:47,1994,1993,B,Other UK Airports,BIRMINGHAM,CARDIFF WALES,0,0,0,14,0,14,
10/9/2008 10:47,1994,1993,B,Other UK Airports,BIRMINGHAM,DUNDEE,0,0,0,31,0,31,
10/9/2008 10:47,1994,1993,B,Other UK Airports,BIRMINGHAM,EAST MIDLANDS INTERNATIONAL,551,120,431,300,72,228,83.66666412
10/9/2008 10:47,1994,1993,B,Other UK Airports,BIRMINGHAM,EDINBURGH,189856,189110,746,168004,167574,430,13.00683308
10/9/2008 10:47,1994,1993,B,Other UK Airports,BIRMINGHAM,EXETER,0,0,0,89,0,89,
10/9/2008 10:47,1994,1993,B,Other UK Airports,BIRMINGHAM,FILTON,0,0,0,3,0,3,
10/9/2008 10:47,1994,1993,B,Other UK Airports,BIRMINGHAM,GLASGOW,190103,189204,899,156325,155628,697,21.60754776
10/9/2008 10:47,1994,1993,B,Other UK Airports,BIRMINGHAM,GUERNSEY,28636,28636,0,12457,12036,421,129.8787842
10/9/2008 10:47,1994,1993,B,Other UK Airports,BIRMINGHAM,HUMBERSIDE,0,0,0,48,0,48,
10/9/2008 10:47,1994,1993,B,Other UK Airports,BIRMINGHAM,INVERNESS,76,0,76,57,0,57,33.33333206
10/9/2008 10:47,1994,1993,B,Other UK Airports,BIRMINGHAM,ISLE OF MAN,40551,40551,0,36817,36817,0,10.1420536
10/9/2008 10:47,1994,1993,B,Other UK Airports,BIRMINGHAM,JERSEY,69252,56826,12426,75526,62364,13162,-8.307072639
10/9/2008 10:47,1994,1993,B,Other UK Airports,BIRMINGHAM,KIRKWALL,10092,10092,0,521,521,0,1837.044189
10/9/2008 10:47,1994,1993,B,Other UK Airports,BIRMINGHAM,MANCHESTER,382,346,36,696,54,642,-45.11494064
10/9/2008 10:47,1994,1993,B,Other UK Airports,BIRMINGHAM,NEWCASTLE,19908,19908,0,17920,17666,254,11.09375
10/9/2008 10:47,1994,1993,B,Other UK Airports,BIRMINGHAM,NEWQUAY,0,0,0,41,0,41,
10/9/2008 10:47,1994,1993,B,Other UK Airports,BIRMINGHAM,PRESTWICK,146,0,146,60,0,60,143.3333282
10/9/2008 10:47,1994,1993,B,Other UK Airports,BIRMINGHAM,SOUTHAMPTON,0,0,0,7410,7383,27,
10/9/2008 10:47,1994,1993,B,Other UK Airports,BIRMINGHAM,WICK,33,33,0,0,0,0,
10/9/2008 10:47,1994,1993,B,Other UK Airports,BLACKPOOL,ISLE OF MAN,449,449,0,6979,6979,0,-93.56641388
10/9/2008 10:47,1994,1993,B,Other UK Airports,BLACKPOOL,JERSEY,3816,2251,1565,2505,2505,0,52.33533096
10/9/2008 10:47,1994,1993,B,Other UK Airports,BOOKER,JERSEY,0,0,0,13,0,13,
10/9/2008 10:47,1994,1993,B,Other UK Airports,BOURNEMOUTH,BRISTOL,183,0,183,1524,0,1524,-87.99212646
10/9/2008 10:47,1994,1993,B,Other UK Airports,BOURNEMOUTH,DURHAM TEES VALLEY,0,0,0,7,0,7,
10/9/2008 10:47,1994,1993,B,Other UK Airports,BOURNEMOUTH,EDINBURGH,137,0,137,0,0,0,
10/9/2008 10:47,1994,1993,B,Other UK Airports,BOURNEMOUTH,EXETER,280,0,280,165,0,165,69.69696808
10/9/2008 10:47,1994,1993,B,Other UK Airports,BOURNEMOUTH,GLASGOW,179,0,179,592,0,592,-69.76351166
10/9/2008 10:47,1994,1993,B,Other UK Airports,BOURNEMOUTH,GUERNSEY,1175,0,1175,238,3,235,393.6974792
10/9/2008 10:47,1994,1993,B,Other UK Airports,BOURNEMOUTH,HUMBERSIDE,4,4,0,0,0,0,
10/9/2008 10:47,1994,1993,B,Other UK Airports,BOURNEMOUTH,JERSEY,2046,279,1767,12385,10989,1396,-83.48001862
10/9/2008 10:47,1994,1993,B,Other UK Airports,BOURNEMOUTH,MANCHESTER,0,0,0,220,0,220,
10/9/2008 10:47,1994,1993,B,Other UK Airports,BRISTOL,BRISTOL,0,0,0,84,1,83,
10/9/2008 10:47,1994,1993,B,Other UK Airports,BRISTOL,DURHAM TEES VALLEY,78,0,78,43,0,43,81.3953476
10/9/2008 10:47,1994,1993,B,Other UK Airports,BRISTOL,EDINBURGH,42197,41700,497,36777,36777,0,14.73747158
10/9/2008 10:47,1994,1993,B,Other UK Airports,BRISTOL,EXETER,73,16,57,0,0,0,
10/9/2008 10:47,1994,1993,B,Other UK Airports,BRISTOL,FILTON,46,0,46,0,0,0,
10/9/2008 10:47,1994,1993,B,Other UK Airports,BRISTOL,GLASGOW,63000,62974,26,48556,48556,0,29.74709702
10/9/2008 10:47,1994,1993,B,Other UK Airports,BRISTOL,GUERNSEY,5108,4888,220,8349,8349,0,-38.81901932
10/9/2008 10:47,1994,1993,B,Other UK Airports,BRISTOL,ISLES OF SCILLY (ST.MARYS),13,13,0,0,0,0,
10/9/2008 10:47,1994,1993,B,Other UK Airports,BRISTOL,JERSEY,33838,29526,4312,25792,25524,268,31.19571877
10/9/2008 10:47,1994,1993,B,Other UK Airports,BRISTOL,MANCHESTER,24,0,24,31,0,31,-22.58064461
10/9/2008 10:47,1994,1993,B,Other UK Airports,BRISTOL,NEWCASTLE,1437,1402,35,4502,4373,129,-68.08085632
10/9/2008 10:47,1994,1993,B,Other UK Airports,BRISTOL,NORWICH,100,0,100,0,0,0,
10/9/2008 10:47,1994,1993,B,Other UK Airports,BRISTOL,PLYMOUTH,6934,6934,0,5487,5487,0,26.37142372
10/9/2008 10:47,1994,1993,B,Other UK Airports,BRIZE NORTON,EDINBURGH,124,0,124,0,0,0,
10/9/2008 10:47,1994,1993,B,Other UK Airports,BRIZE NORTON,LEEDS BRADFORD,87,0,87,0,0,0,
10/9/2008 10:47,1994,1993,B,Other UK Airports,CAMBRIDGE,ISLE OF MAN,0,0,0,47,0,47,
10/9/2008 10:47,1994,1993,B,Other UK Airports,CAMBRIDGE,JERSEY,3455,3455,0,3660,2955,705,-5.601092815
10/9/2008 10:47,1994,1993,B,Other UK Airports,CAMBRIDGE,MANCHESTER,7198,7198,0,7064,6965,99,1.896942258
10/9/2008 10:47,1994,1993,B,Other UK Airports,CAMBRIDGE,NEWCASTLE,37,2,35,91,0,91,-59.3406601
10/9/2008 10:47,1994,1993,B,Other UK Airports,CAMPBELTOWN,GLASGOW,136,136,0,0,0,0,
10/9/2008 10:47,1994,1993,B,Other UK Airports,CARDIFF WALES,EAST MIDLANDS INTERNATIONAL,21,0,21,0,0,0,
10/9/2008 10:47,1994,1993,B,Other UK Airports,CARDIFF WALES,EDINBURGH,5232,4555,677,6447,1084,5363,-18.84597397
10/9/2008 10:47,1994,1993,B,Other UK Airports,CARDIFF WALES,GLASGOW,18943,18909,34,17444,17083,361,8.593212128
10/9/2008 10:47,1994,1993,B,Other UK Airports,CARDIFF WALES,GUERNSEY,1126,1126,0,1079,1079,0,4.355885029
10/9/2008 10:47,1994,1993,B,Other UK Airports,CARDIFF WALES,ISLE OF MAN,2841,2841,0,2567,2567,0,10.67393875
10/9/2008 10:47,1994,1993,B,Other UK Airports,CARDIFF WALES,JERSEY,21270,20641,629,24883,22877,2006,-14.51995373
10/9/2008 10:47,1994,1993,B,Other UK Airports,CARDIFF WALES,LEEDS BRADFORD,199,199,0,0,0,0,
10/9/2008 10:47,1994,1993,B,Other UK Airports,CARDIFF WALES,LIVERPOOL,0,0,0,50,0,50,
10/9/2008 10:47,1994,1993,B,Other UK Airports,CARDIFF WALES,MANCHESTER,32,13,19,0,0,0,
10/9/2008 10:47,1994,1993,B,Other UK Airports,CARDIFF WALES,NEWCASTLE,45,0,45,30,0,30,50
10/9/2008 10:47,1994,1993,B,Other UK Airports,CARDIFF WALES,NORWICH,0,0,0,264,0,264,
10/9/2008 10:47,1994,1993,B,Other UK Airports,CARDIFF WALES,PRESTWICK,0,0,0,30,0,30,
10/9/2008 10:47,1994,1993,B,Other UK Airports,CARDIFF WALES,SOUTHAMPTON,63,63,0,0,0,0,
10/9/2008 10:47,1994,1993,B,Other UK Airports,CITY OF DERRY (EGLINTON),GLASGOW,14287,14287,0,13301,13249,52,7.412976265
10/9/2008 10:47,1994,1993,B,Other UK Airports,CITY OF DERRY (EGLINTON),ISLE OF MAN,172,0,172,0,0,0,
10/9/2008 10:47,1994,1993,B,Other UK Airports,CITY OF DERRY (EGLINTON),JERSEY,1073,0,1073,665,0,665,61.35338211
10/9/2008 10:47,1994,1993,B,Other UK Airports,CITY OF DERRY (EGLINTON),MANCHESTER,16409,16409,0,14608,14608,0,12.32886124
10/9/2008 10:47,1994,1993,B,Other UK Airports,CITY OF DERRY (EGLINTON),SUMBURGH,0,0,0,42,0,42,
10/9/2008 10:47,1994,1993,B,Other UK Airports,COMPTON ABASS,LIVERPOOL,0,0,0,18,0,18,
10/9/2008 10:47,1994,1993,B,Other UK Airports,COVENTRY,GLOUCESTERSHIRE,91,91,0,215,215,0,-57.6744194
10/9/2008 10:47,1994,1993,B,Other UK Airports,COVENTRY,GUERNSEY,3,3,0,0,0,0,
10/9/2008 10:47,1994,1993,B,Other UK Airports,COVENTRY,JERSEY,465,465,0,0,0,0,
10/9/2008 10:47,1994,1993,B,Other UK Airports,COVENTRY,NEWCASTLE,0,0,0,74,0,74,
10/9/2008 10:47,1994,1993,B,Other UK Airports,CUMBERNAULD,JERSEY,45,0,45,0,0,0,
10/9/2008 10:47,1994,1993,B,Other UK Airports,DONCASTER SHEFFIELD,LIVERPOOL,68,0,68,0,0,0,
10/9/2008 10:47,1994,1993,B,Other UK Airports,DUNDEE,INVERNESS,9,9,0,0,0,0,
10/9/2008 10:47,1994,1993,B,Other UK Airports,DUNDEE,MANCHESTER,1,1,0,0,0,0,
10/9/2008 10:47,1994,1993,B,Other UK Airports,DURHAM TEES VALLEY,EDINBURGH,38,0,38,0,0,0,
10/9/2008 10:47,1994,1993,B,Other UK Airports,DURHAM TEES VALLEY,EXETER,8,8,0,0,0,0,
10/9/2008 10:47,1994,1993,B,Other UK Airports,DURHAM TEES VALLEY,GLASGOW,99,0,99,0,0,0,
10/9/2008 10:47,1994,1993,B,Other UK Airports,DURHAM TEES VALLEY,HUMBERSIDE,627,627,0,263,263,0,138.4030457
10/9/2008 10:47,1994,1993,B,Other UK Airports,DURHAM TEES VALLEY,JERSEY,9990,8070,1920,10418,10418,0,-4.108273983
10/9/2008 10:47,1994,1993,B,Other UK Airports,DURHAM TEES VALLEY,LEEDS BRADFORD,69,0,69,0,0,0,
10/9/2008 10:47,1994,1993,B,Other UK Airports,DURHAM TEES VALLEY,MANCHESTER,78,18,60,7,0,7,1014.285706
10/9/2008 10:47,1994,1993,B,Other UK Airports,DURHAM TEES VALLEY,NEWCASTLE,30,30,0,0,0,0,
10/9/2008 10:47,1994,1993,B,Other UK Airports,DURHAM TEES VALLEY,NORWICH,1974,1973,1,2613,2213,400,-24.45464897
10/9/2008 10:47,1994,1993,B,Other UK Airports,DURHAM TEES VALLEY,PLYMOUTH,92,0,92,0,0,0,
10/9/2008 10:47,1994,1993,B,Other UK Airports,EAST MIDLANDS INTERNATIONAL,EDINBURGH,39659,39517,142,21876,18370,3506,81.29000092
10/9/2008 10:47,1994,1993,B,Other UK Airports,EAST MIDLANDS INTERNATIONAL,GLASGOW,84376,84254,122,79053,78857,196,6.733457088
10/9/2008 10:47,1994,1993,B,Other UK Airports,EAST MIDLANDS INTERNATIONAL,GUERNSEY,16847,16712,135,13313,13228,85,26.54548264
10/9/2008 10:47,1994,1993,B,Other UK Airports,EAST MIDLANDS INTERNATIONAL,JERSEY,54112,53359,753,54619,52968,1651,-0.928248405
10/9/2008 10:47,1994,1993,B,Other UK Airports,EAST MIDLANDS INTERNATIONAL,LEEDS BRADFORD,128,0,128,40,0,40,220
10/9/2008 10:47,1994,1993,B,Other UK Airports,EAST MIDLANDS INTERNATIONAL,MANCHESTER,19,0,19,58,0,58,-67.24137878
10/9/2008 10:47,1994,1993,B,Other UK Airports,EAST MIDLANDS INTERNATIONAL,NEWCASTLE,37,0,37,0,0,0,
10/9/2008 10:47,1994,1993,B,Other UK Airports,EAST MIDLANDS INTERNATIONAL,SUMBURGH,8928,8928,0,1263,1263,0,606.8883667
10/9/2008 10:47,1994,1993,B,Other UK Airports,EDAY,KIRKWALL,270,270,0,633,633,0,-57.34597015
10/9/2008 10:47,1994,1993,B,Other UK Airports,EDINBURGH,GLASGOW,234,234,0,579,579,0,-59.58549118
10/9/2008 10:47,1994,1993,B,Other UK Airports,EDINBURGH,GUERNSEY,2140,2048,92,2460,2460,0,-13.00813007
10/9/2008 10:47,1994,1993,B,Other UK Airports,EDINBURGH,HUMBERSIDE,2122,2122,0,1088,1088,0,95.03676605
10/9/2008 10:47,1994,1993,B,Other UK Airports,EDINBURGH,INVERNESS,211,40,171,2,2,0,10450
10/9/2008 10:47,1994,1993,B,Other UK Airports,EDINBURGH,ISLAY,0,0,0,36,0,36,
10/9/2008 10:47,1994,1993,B,Other UK Airports,EDINBURGH,ISLE OF MAN,24,24,0,85,0,85,-71.76470947
10/9/2008 10:47,1994,1993,B,Other UK Airports,EDINBURGH,JERSEY,10814,8062,2752,8247,3170,5077,31.12647057
10/9/2008 10:47,1994,1993,B,Other UK Airports,EDINBURGH,KENT INTERNATIONAL,66,0,66,0,0,0,
10/9/2008 10:47,1994,1993,B,Other UK Airports,EDINBURGH,KIRKWALL,6133,6011,122,10369,10369,0,-40.85254288
10/9/2008 10:47,1994,1993,B,Other UK Airports,EDINBURGH,LEEDS BRADFORD,18725,18725,0,17810,17810,0,5.137563229
10/9/2008 10:47,1994,1993,B,Other UK Airports,EDINBURGH,LIVERPOOL,23,0,23,0,0,0,
10/9/2008 10:47,1994,1993,B,Other UK Airports,EDINBURGH,MANCHESTER,100759,100634,125,88715,88641,74,13.57605839
10/9/2008 10:47,1994,1993,B,Other UK Airports,EDINBURGH,NEWCASTLE,73,73,0,79,0,79,-7.594936848
10/9/2008 10:47,1994,1993,B,Other UK Airports,EDINBURGH,NORWICH,15746,15705,41,16765,16765,0,-6.078138828
10/9/2008 10:47,1994,1993,B,Other UK Airports,EDINBURGH,PLYMOUTH,11937,11937,0,7041,7041,0,69.53557587
10/9/2008 10:47,1994,1993,B,Other UK Airports,EDINBURGH,SOUTHAMPTON,23002,22868,134,14352,14352,0,60.27034378
10/9/2008 10:47,1994,1993,B,Other UK Airports,EDINBURGH,SUMBURGH,10462,10462,0,9313,9313,0,12.33759308
10/9/2008 10:47,1994,1993,B,Other UK Airports,EDINBURGH,UNST,5736,5736,0,7381,7381,0,-22.28695297
10/9/2008 10:47,1994,1993,B,Other UK Airports,EDINBURGH,WICK,4646,4646,0,2190,2045,145,112.1461182
10/9/2008 10:47,1994,1993,B,Other UK Airports,EXETER,GLASGOW,0,0,0,144,0,144,
10/9/2008 10:47,1994,1993,B,Other UK Airports,EXETER,GUERNSEY,16504,16401,103,12221,12221,0,35.04623032
10/9/2008 10:47,1994,1993,B,Other UK Airports,EXETER,ISLES OF SCILLY (ST.MARYS),6836,6836,0,5604,5604,0,21.9842968
10/9/2008 10:47,1994,1993,B,Other UK Airports,EXETER,JERSEY,33241,33151,90,18992,18144,848,75.02632904
10/9/2008 10:47,1994,1993,B,Other UK Airports,EXETER,LIVERPOOL,0,0,0,2,0,2,
10/9/2008 10:47,1994,1993,B,Other UK Airports,EXETER,MANCHESTER,280,280,0,0,0,0,
10/9/2008 10:47,1994,1993,B,Other UK Airports,EXETER,NORTHOLT,0,0,0,38,0,38,
10/9/2008 10:47,1994,1993,B,Other UK Airports,EXETER,PLYMOUTH,25,25,0,0,0,0,
10/9/2008 10:47,1994,1993,B,Other UK Airports,FAIR ISLE,KIRKWALL,75,75,0,0,0,0,
10/9/2008 10:47,1994,1993,B,Other UK Airports,FAIR ISLE,LERWICK (TINGWALL),3,3,0,2,2,0,50
10/9/2008 10:47,1994,1993,B,Other UK Airports,FAIR ISLE,SUMBURGH,45,45,0,180,111,69,-75
10/9/2008 10:47,1994,1993,B,Other UK Airports,FILTON,JERSEY,24,0,24,88,0,88,-72.72727203
10/9/2008 10:47,1994,1993,B,Other UK Airports,FILTON,LIVERPOOL,93,0,93,35,0,35,165.7142792
10/9/2008 10:47,1994,1993,B,Other UK Airports,GLASGOW,GLOUCESTERSHIRE,0,0,0,23,23,0,
10/9/2008 10:47,1994,1993,B,Other UK Airports,GLASGOW,GUERNSEY,2662,2662,0,2342,2305,37,13.66353512
10/9/2008 10:47,1994,1993,B,Other UK Airports,GLASGOW,HUMBERSIDE,44,0,44,4265,4261,4,-98.96834564
10/9/2008 10:47,1994,1993,B,Other UK Airports,GLASGOW,INVERNESS,784,585,199,683,678,5,14.78770161
10/9/2008 10:47,1994,1993,B,Other UK Airports,GLASGOW,ISLAY,14470,14470,0,18250,18250,0,-20.71232796
10/9/2008 10:47,1994,1993,B,Other UK Airports,GLASGOW,ISLE OF MAN,19818,19818,0,17755,17755,0,11.61926174
10/9/2008 10:47,1994,1993,B,Other UK Airports,GLASGOW,JERSEY,31834,24141,7693,35080,29723,5357,-9.253135681
10/9/2008 10:47,1994,1993,B,Other UK Airports,GLASGOW,KINLOSS,0,0,0,28,0,28,
10/9/2008 10:47,1994,1993,B,Other UK Airports,GLASGOW,KIRKWALL,22477,22477,0,38193,38157,36,-41.14890289
10/9/2008 10:47,1994,1993,B,Other UK Airports,GLASGOW,LEEDS BRADFORD,28038,28038,0,22267,22265,2,25.91727638
10/9/2008 10:47,1994,1993,B,Other UK Airports,GLASGOW,LIVERPOOL,0,0,0,58,0,58,
10/9/2008 10:47,1994,1993,B,Other UK Airports,GLASGOW,MANCHESTER,109603,108702,901,99364,99076,288,10.30453682
10/9/2008 10:47,1994,1993,B,Other UK Airports,GLASGOW,NEWCASTLE,0,0,0,771,225,546,
10/9/2008 10:47,1994,1993,B,Other UK Airports,GLASGOW,NORWICH,0,0,0,134,0,134,
10/9/2008 10:47,1994,1993,B,Other UK Airports,GLASGOW,PLYMOUTH,0,0,0,7259,7259,0,
10/9/2008 10:47,1994,1993,B,Other UK Airports,GLASGOW,PRESTWICK,51,0,51,55,0,55,-7.272727489
10/9/2008 10:47,1994,1993,B,Other UK Airports,GLASGOW,SOUTHAMPTON,21599,21599,0,19009,19009,0,13.62512493
10/9/2008 10:47,1994,1993,B,Other UK Airports,GLASGOW,STORNOWAY,50586,50586,0,51325,51278,47,-1.439844131
10/9/2008 10:47,1994,1993,B,Other UK Airports,GLASGOW,SUMBURGH,11733,11733,0,6065,6015,50,93.45424652
10/9/2008 10:47,1994,1993,B,Other UK Airports,GLASGOW,TIREE,1241,1241,0,4166,4166,0,-70.21123505
10/9/2008 10:47,1994,1993,B,Other UK Airports,GLOUCESTERSHIRE,GUERNSEY,22,22,0,140,0,140,-84.2857132
10/9/2008 10:47,1994,1993,B,Other UK Airports,GLOUCESTERSHIRE,JERSEY,435,435,0,1585,0,1585,-72.5552063
10/9/2008 10:47,1994,1993,B,Other UK Airports,GLOUCESTERSHIRE,NEWCASTLE,0,0,0,67,0,67,
10/9/2008 10:47,1994,1993,B,Other UK Airports,GUERNSEY,HATFIELD,0,0,0,43,0,43,
10/9/2008 10:47,1994,1993,B,Other UK Airports,GUERNSEY,JERSEY,194019,193801,218,185557,184555,1002,4.560323715
10/9/2008 10:47,1994,1993,B,Other UK Airports,GUERNSEY,LEEDS BRADFORD,3523,3523,0,3552,3384,168,-0.816441417
10/9/2008 10:47,1994,1993,B,Other UK Airports,GUERNSEY,LIVERPOOL,90,0,90,0,0,0,
10/9/2008 10:47,1994,1993,B,Other UK Airports,GUERNSEY,MANCHESTER,30637,28804,1833,29143,29143,0,5.126445293
10/9/2008 10:47,1994,1993,B,Other UK Airports,GUERNSEY,MARHAM(KINGS LYNN),193,0,193,0,0,0,
10/9/2008 10:47,1994,1993,B,Other UK Airports,GUERNSEY,NEWCASTLE,3173,3173,0,0,0,0,
10/9/2008 10:47,1994,1993,B,Other UK Airports,GUERNSEY,NORWICH,2125,2125,0,1865,1865,0,13.94101906
10/9/2008 10:47,1994,1993,B,Other UK Airports,GUERNSEY,PLYMOUTH,4731,4655,76,357,357,0,1225.210083
10/9/2008 10:47,1994,1993,B,Other UK Airports,GUERNSEY,SOUTHAMPTON,103225,102194,1031,93999,92286,1713,9.814997673
10/9/2008 10:47,1994,1993,B,Other UK Airports,HAWARDEN,INVERNESS,98,0,98,0,0,0,
10/9/2008 10:47,1994,1993,B,Other UK Airports,HUMBERSIDE,JERSEY,5980,2088,3892,5981,1821,4160,-0.016719611
10/9/2008 10:47,1994,1993,B,Other UK Airports,HUMBERSIDE,KENT INTERNATIONAL,0,0,0,547,0,547,
10/9/2008 10:47,1994,1993,B,Other UK Airports,HUMBERSIDE,LEEDS BRADFORD,0,0,0,14,0,14,
10/9/2008 10:47,1994,1993,B,Other UK Airports,HUMBERSIDE,MANCHESTER,167,0,167,0,0,0,
10/9/2008 10:47,1994,1993,B,Other UK Airports,HUMBERSIDE,NEWCASTLE,0,0,0,84,0,84,
10/9/2008 10:47,1994,1993,B,Other UK Airports,HUMBERSIDE,NORWICH,684,684,0,1327,1327,0,-48.45516205
10/9/2008 10:47,1994,1993,B,Other UK Airports,HUMBERSIDE,SOUTHAMPTON,0,0,0,37,0,37,
10/9/2008 10:47,1994,1993,B,Other UK Airports,INVERNESS,JERSEY,1251,0,1251,0,0,0,
10/9/2008 10:47,1994,1993,B,Other UK Airports,INVERNESS,KIRKWALL,5411,5411,0,6384,6370,14,-15.2412281
10/9/2008 10:47,1994,1993,B,Other UK Airports,INVERNESS,MANCHESTER,10751,10751,0,4504,4504,0,138.6989288
10/9/2008 10:47,1994,1993,B,Other UK Airports,INVERNESS,PRESTWICK,24,0,24,0,0,0,
10/9/2008 10:47,1994,1993,B,Other UK Airports,INVERNESS,SOUTH MARSTON,16,0,16,0,0,0,
10/9/2008 10:47,1994,1993,B,Other UK Airports,INVERNESS,STORNOWAY,32034,32034,0,30079,30079,0,6.499551296
10/9/2008 10:47,1994,1993,B,Other UK Airports,INVERNESS,SUMBURGH,2674,2674,0,134,28,106,1895.522339
10/9/2008 10:47,1994,1993,B,Other UK Airports,INVERNESS,WICK,480,480,0,4,4,0,11900
10/9/2008 10:47,1994,1993,B,Other UK Airports,ISLAY,PRESTWICK,0,0,0,23,0,23,
10/9/2008 10:47,1994,1993,B,Other UK Airports,ISLE OF MAN,JERSEY,2316,2316,0,290,290,0,698.6206665
10/9/2008 10:47,1994,1993,B,Other UK Airports,ISLE OF MAN,LEEDS BRADFORD,9114,9106,8,2271,2127,144,301.3210144
10/9/2008 10:47,1994,1993,B,Other UK Airports,ISLE OF MAN,LIVERPOOL,131354,131338,16,135561,135482,79,-3.103399992
10/9/2008 10:47,1994,1993,B,Other UK Airports,ISLE OF MAN,MANCHESTER,79104,78847,257,75494,75222,272,4.781836987
10/9/2008 10:47,1994,1993,B,Other UK Airports,ISLE OF MAN,NEWCASTLE,1037,848,189,955,902,53,8.586387634
10/9/2008 10:47,1994,1993,B,Other UK Airports,ISLE OF MAN,NORTHOLT,0,0,0,102,0,102,
10/9/2008 10:47,1994,1993,B,Other UK Airports,ISLE OF MAN,SOUTHAMPTON,1928,1724,204,0,0,0,
10/9/2008 10:47,1994,1993,B,Other UK Airports,JERSEY,KENT INTERNATIONAL,0,0,0,1742,0,1742,
10/9/2008 10:47,1994,1993,B,Other UK Airports,JERSEY,LEEDS BRADFORD,18407,16820,1587,19109,19109,0,-3.673661709
10/9/2008 10:47,1994,1993,B,Other UK Airports,JERSEY,LIVERPOOL,7952,3046,4906,7357,3084,4273,8.087535858
10/9/2008 10:47,1994,1993,B,Other UK Airports,JERSEY,MANCHESTER,114560,91553,23007,123795,96453,27342,-7.459913731
10/9/2008 10:47,1994,1993,B,Other UK Airports,JERSEY,NEWCASTLE,25683,13235,12448,14898,5013,9885,72.39226532
10/9/2008 10:47,1994,1993,B,Other UK Airports,JERSEY,NORWICH,6999,6999,0,6983,6983,0,0.229127884
10/9/2008 10:47,1994,1993,B,Other UK Airports,JERSEY,PLYMOUTH,7812,7812,0,7334,5958,1376,6.517589092
10/9/2008 10:47,1994,1993,B,Other UK Airports,JERSEY,PRESTWICK,2187,0,2187,1097,0,1097,99.3618927
10/9/2008 10:47,1994,1993,B,Other UK Airports,JERSEY,SOUTHAMPTON,156189,149414,6775,144391,139263,5128,8.170869827
10/9/2008 10:47,1994,1993,B,Other UK Airports,KENT INTERNATIONAL,NEWCASTLE,4,0,4,0,0,0,
10/9/2008 10:47,1994,1993,B,Other UK Airports,KENT INTERNATIONAL,NORWICH,0,0,0,103,0,103,
10/9/2008 10:47,1994,1993,B,Other UK Airports,KIRKWALL,MANCHESTER,1715,1715,0,1195,1195,0,43.51464462
10/9/2008 10:47,1994,1993,B,Other UK Airports,KIRKWALL,NORTH RONALDSAY,3327,3327,0,3109,3109,0,7.011900902
10/9/2008 10:47,1994,1993,B,Other UK Airports,KIRKWALL,PAPA WESTRAY,3001,3001,0,3063,3063,0,-2.024159431
10/9/2008 10:47,1994,1993,B,Other UK Airports,KIRKWALL,SANDAY,2238,2238,0,2578,2578,0,-13.18851852
10/9/2008 10:47,1994,1993,B,Other UK Airports,KIRKWALL,STRONSAY,2781,2781,0,2802,2802,0,-0.749464691
10/9/2008 10:47,1994,1993,B,Other UK Airports,KIRKWALL,SUMBURGH,10259,10252,7,11487,11228,259,-10.69034576
10/9/2008 10:47,1994,1993,B,Other UK Airports,KIRKWALL,WESTRAY,2873,2873,0,3186,3186,0,-9.824231148
10/9/2008 10:47,1994,1993,B,Other UK Airports,KIRKWALL,WICK,9691,9691,0,8658,8608,50,11.93116188
10/9/2008 10:47,1994,1993,B,Other UK Airports,LEEDS BRADFORD,MANCHESTER,71,0,71,224,0,224,-68.30357361
10/9/2008 10:47,1994,1993,B,Other UK Airports,LEEDS BRADFORD,NEWCASTLE,398,0,398,146,9,137,172.6027374
10/9/2008 10:47,1994,1993,B,Other UK Airports,LEEDS BRADFORD,NORWICH,21,21,0,403,44,359,-94.78908539
10/9/2008 10:47,1994,1993,B,Other UK Airports,LEEDS BRADFORD,SOUTHAMPTON,2080,2080,0,0,0,0,
10/9/2008 10:47,1994,1993,B,Other UK Airports,LIVERPOOL,MANCHESTER,63,0,63,43,0,43,46.5116272
10/9/2008 10:47,1994,1993,B,Other UK Airports,LIVERPOOL,NEWCASTLE,0,0,0,62,0,62,
10/9/2008 10:47,1994,1993,B,Other UK Airports,LIVERPOOL,NORWICH,296,0,296,0,0,0,
10/9/2008 10:47,1994,1993,B,Other UK Airports,LIVERPOOL,SOUTHAMPTON,68,0,68,0,0,0,
10/9/2008 10:47,1994,1993,B,Other UK Airports,LLANBEDR,SUMBURGH,55,0,55,0,0,0,
10/9/2008 10:47,1994,1993,B,Other UK Airports,LYNEHAM,MANCHESTER,0,0,0,38,0,38,
10/9/2008 10:47,1994,1993,B,Other UK Airports,LYNEHAM,NEWCASTLE,0,0,0,311,0,311,
10/9/2008 10:47,1994,1993,B,Other UK Airports,MANCHESTER,NEWCASTLE,15791,15791,0,17640,17420,220,-10.48185921
10/9/2008 10:47,1994,1993,B,Other UK Airports,MANCHESTER,NEWQUAY,0,0,0,41,0,41,
10/9/2008 10:47,1994,1993,B,Other UK Airports,MANCHESTER,NORWICH,140,0,140,410,0,410,-65.85366058
10/9/2008 10:47,1994,1993,B,Other UK Airports,MANCHESTER,SOUTHAMPTON,23400,23307,93,15558,15558,0,50.40493774
10/9/2008 10:47,1994,1993,B,Other UK Airports,MANCHESTER,SUMBURGH,35277,35277,0,45061,45061,0,-21.71278954
10/9/2008 10:47,1994,1993,B,Other UK Airports,MANCHESTER,UNST,0,0,0,2028,2028,0,
10/9/2008 10:47,1994,1993,B,Other UK Airports,NEWCASTLE,NORWICH,87,0,87,103,0,103,-15.53398037
10/9/2008 10:47,1994,1993,B,Other UK Airports,NEWCASTLE,SOUTHAMPTON,2327,2327,0,161,0,161,1345.341675
10/9/2008 10:47,1994,1993,B,Other UK Airports,NEWCASTLE,SWANSEA,0,0,0,54,0,54,
10/9/2008 10:47,1994,1993,B,Other UK Airports,NEWCASTLE,WICK,1581,1581,0,15,0,15,10440
10/9/2008 10:47,1994,1993,B,Other UK Airports,NORWICH,ORONSAY,0,0,0,33,0,33,
10/9/2008 10:47,1994,1993,B,Other UK Airports,NORWICH,PLYMOUTH,92,0,92,0,0,0,
10/9/2008 10:47,1994,1993,B,Other UK Airports,NORWICH,SOUTHAMPTON,0,0,0,4,0,4,
10/9/2008 10:47,1994,1993,B,Other UK Airports,PRESTWICK,SOUTHAMPTON,0,0,0,34,0,34,
10/9/2008 10:47,1994,1993,B,Other UK Airports,SCATSTA,SCATSTA,0,0,0,25,0,25,
10/9/2008 10:47,1994,1993,B,Other UK Airports,SOUTHAMPTON,SUMBURGH,0,0,0,148,0,148,
10/9/2008 10:47,1994,1993,B,Other UK Airports,SOUTHAMPTON,WICK,0,0,0,1,1,0,
10/9/2008 10:47,1994,1993,B,Other UK Airports,SUMBURGH,SUMBURGH,171,0,171,0,0,0,
10/9/2008 10:47,1994,1993,B,Other UK Airports,SUMBURGH,UNST,1928,1912,16,2936,2072,864,-34.33242416
10/9/2008 10:47,1994,1993,B,Other UK Airports,SUMBURGH,WICK,1454,1454,0,0,0,0,
10/9/2008 10:47,1994,1993,B,Other UK Airports,UNST,WICK,809,809,0,0,0,0,
10/9/2008 10:47,1994,1993,B,Other UK Airports,WICK,WICK,0,0,0,23,0,23,
