rundate,this_period,last_period,grp_cd,grp_name,apt1_apt_name,apt2_apt_name,total_pax_tp,total_pax_shd_tp,total_pax_cht_tp,total_pax_lp,total_pax_shd_lp,total_pax_cht_lp,total_pax_pc
28/02/2012 15:55,2011,2010,A,London Area Airports,GATWICK,ABERDEEN,177765,177765,0,129948,129744,204,36.79702759
28/02/2012 15:55,2011,2010,A,London Area Airports,GATWICK,BELFAST CITY (GEORGE BEST),247907,247907,0,218943,218943,0,13.2290144
28/02/2012 15:55,2011,2010,A,London Area Airports,GATWICK,BELFAST INTERNATIONAL,341744,341744,0,296802,296466,336,15.14208126
28/02/2012 15:55,2011,2010,A,London Area Airports,GATWICK,BLACKPOOL,91,0,91,217,0,217,-58.06451797
28/02/2012 15:55,2011,2010,A,London Area Airports,GATWICK,CARDIFF WALES,35,0,35,0,0,0,
28/02/2012 15:55,2011,2010,A,London Area Airports,GATWICK,EAST MIDLANDS INTERNATIONAL,0,0,0,149,0,149,
28/02/2012 15:55,2011,2010,A,London Area Airports,GATWICK,EDINBURGH,669068,669068,0,604073,604001,72,10.7594614
28/02/2012 15:55,2011,2010,A,London Area Airports,GATWICK,GLASGOW,565787,565744,43,488774,488704,70,15.75636196
28/02/2012 15:55,2011,2010,A,London Area Airports,GATWICK,GUERNSEY,356368,356368,0,335937,335937,0,6.081795216
28/02/2012 15:55,2011,2010,A,London Area Airports,GATWICK,HUMBERSIDE,76,0,76,86,0,86,-11.6279068
28/02/2012 15:55,2011,2010,A,London Area Airports,GATWICK,INVERNESS,222737,222466,271,206837,206837,0,7.687212467
28/02/2012 15:55,2011,2010,A,London Area Airports,GATWICK,ISLE OF MAN,127097,127097,0,122159,122159,0,4.042272568
28/02/2012 15:55,2011,2010,A,London Area Airports,GATWICK,JERSEY,574113,574113,0,534303,534133,170,7.450828552
28/02/2012 15:55,2011,2010,A,London Area Airports,GATWICK,LEEDS BRADFORD,10001,10001,0,50617,50617,0,-80.24181366
28/02/2012 15:55,2011,2010,A,London Area Airports,GATWICK,LIVERPOOL (JOHN LENNON),208,0,208,40,0,40,420
28/02/2012 15:55,2011,2010,A,London Area Airports,GATWICK,MANCHESTER,232739,232263,476,246842,246522,320,-5.713371277
28/02/2012 15:55,2011,2010,A,London Area Airports,GATWICK,NEWCASTLE,95122,94969,153,97385,97345,40,-2.32376647
28/02/2012 15:55,2011,2010,A,London Area Airports,GATWICK,NEWQUAY,100902,100837,65,105968,105968,0,-4.780688286
28/02/2012 15:55,2011,2010,A,London Area Airports,GATWICK,NORWICH,37,0,37,0,0,0,
28/02/2012 15:55,2011,2010,A,London Area Airports,GATWICK,PLYMOUTH,2765,2765,0,55816,55816,0,-95.0462265
28/02/2012 15:55,2011,2010,A,London Area Airports,HEATHROW,ABERDEEN,652520,652520,0,617693,617693,0,5.638237953
28/02/2012 15:55,2011,2010,A,London Area Airports,HEATHROW,BELFAST CITY (GEORGE BEST),428611,428611,0,467826,467826,0,-8.382390022
28/02/2012 15:55,2011,2010,A,London Area Airports,HEATHROW,BELFAST INTERNATIONAL,289359,289359,0,284029,284029,0,1.876568913
28/02/2012 15:55,2011,2010,A,London Area Airports,HEATHROW,BIRMINGHAM,45,0,45,0,0,0,
28/02/2012 15:55,2011,2010,A,London Area Airports,HEATHROW,CARDIFF WALES,64,0,64,0,0,0,
28/02/2012 15:55,2011,2010,A,London Area Airports,HEATHROW,EDINBURGH,1271459,1271299,160,1244793,1244787,6,2.142203569
28/02/2012 15:55,2011,2010,A,London Area Airports,HEATHROW,GLASGOW,820949,820949,0,1003344,1003344,0,-18.17871094
28/02/2012 15:55,2011,2010,A,London Area Airports,HEATHROW,LEEDS BRADFORD,0,0,0,152,0,152,
28/02/2012 15:55,2011,2010,A,London Area Airports,HEATHROW,LIVERPOOL (JOHN LENNON),144,0,144,30,0,30,380
28/02/2012 15:55,2011,2010,A,London Area Airports,HEATHROW,MANCHESTER,766906,766718,188,799264,799264,0,-4.048474789
28/02/2012 15:55,2011,2010,A,London Area Airports,HEATHROW,MANSTON (KENT INT),150,150,0,0,0,0,
28/02/2012 15:55,2011,2010,A,London Area Airports,HEATHROW,NEWCASTLE,473614,473614,0,424251,424251,0,11.63532925
28/02/2012 15:55,2011,2010,A,London Area Airports,LONDON CITY,ABERDEEN,29,29,0,0,0,0,
28/02/2012 15:55,2011,2010,A,London Area Airports,LONDON CITY,DUNDEE,31632,31632,0,40480,40480,0,-21.85770798
28/02/2012 15:55,2011,2010,A,London Area Airports,LONDON CITY,EDINBURGH,344868,344868,0,334709,334661,48,3.035173893
28/02/2012 15:55,2011,2010,A,London Area Airports,LONDON CITY,GLASGOW,149434,149434,0,111050,111050,0,34.56460953
28/02/2012 15:55,2011,2010,A,London Area Airports,LONDON CITY,ISLE OF MAN,46010,46010,0,52224,52224,0,-11.89874363
28/02/2012 15:55,2011,2010,A,London Area Airports,LONDON CITY,JERSEY,15923,15923,0,10121,10121,0,57.32635117
28/02/2012 15:55,2011,2010,A,London Area Airports,LONDON CITY,MANCHESTER,0,0,0,90,0,90,
28/02/2012 15:55,2011,2010,A,London Area Airports,LONDON CITY,NEWCASTLE,0,0,0,42,0,42,
28/02/2012 15:55,2011,2010,A,London Area Airports,LONDON CITY,NEWQUAY,0,0,0,7864,7864,0,
28/02/2012 15:55,2011,2010,A,London Area Airports,LONDON CITY,PLYMOUTH,0,0,0,720,720,0,
28/02/2012 15:55,2011,2010,A,London Area Airports,LUTON,ABERDEEN,147688,147688,0,129018,128900,118,14.47084904
28/02/2012 15:55,2011,2010,A,London Area Airports,LUTON,BELFAST CITY (GEORGE BEST),80612,80612,0,170023,170023,0,-52.58758926
28/02/2012 15:55,2011,2010,A,London Area Airports,LUTON,BELFAST INTERNATIONAL,144451,143909,542,3257,3248,9,4335.09375
28/02/2012 15:55,2011,2010,A,London Area Airports,LUTON,BLACKPOOL,90,0,90,148,0,148,-39.18918991
28/02/2012 15:55,2011,2010,A,London Area Airports,LUTON,CARDIFF WALES,83,0,83,0,0,0,
28/02/2012 15:55,2011,2010,A,London Area Airports,LUTON,CITY OF DERRY (EGLINTON),0,0,0,8672,8672,0,
28/02/2012 15:55,2011,2010,A,London Area Airports,LUTON,DURHAM TEES VALLEY,28,0,28,28,0,28,0
28/02/2012 15:55,2011,2010,A,London Area Airports,LUTON,EDINBURGH,259408,259344,64,242100,242100,0,7.149111748
28/02/2012 15:55,2011,2010,A,London Area Airports,LUTON,EXETER,252,0,252,0,0,0,
28/02/2012 15:55,2011,2010,A,London Area Airports,LUTON,FARNBOROUGH,0,0,0,4,0,4,
28/02/2012 15:55,2011,2010,A,London Area Airports,LUTON,GLASGOW,274576,274486,90,247681,247662,19,10.85872555
28/02/2012 15:55,2011,2010,A,London Area Airports,LUTON,HUMBERSIDE,0,0,0,59,0,59,
28/02/2012 15:55,2011,2010,A,London Area Airports,LUTON,INVERNESS,99574,99444,130,90264,90264,0,10.31418991
28/02/2012 15:55,2011,2010,A,London Area Airports,LUTON,ISLE OF MAN,23927,23902,25,27067,27067,0,-11.60084248
28/02/2012 15:55,2011,2010,A,London Area Airports,LUTON,JERSEY,16648,16648,0,17181,17181,0,-3.102264166
28/02/2012 15:55,2011,2010,A,London Area Airports,LUTON,LIVERPOOL (JOHN LENNON),53,0,53,198,0,198,-73.23232269
28/02/2012 15:55,2011,2010,A,London Area Airports,LUTON,MANCHESTER,260,0,260,273,0,273,-4.761904716
28/02/2012 15:55,2011,2010,A,London Area Airports,LUTON,NEWCASTLE,167,0,167,93,0,93,79.56989288
28/02/2012 15:55,2011,2010,A,London Area Airports,LUTON,NEWQUAY,0,0,0,12,0,12,
28/02/2012 15:55,2011,2010,A,London Area Airports,LUTON,NORWICH,52,0,52,0,0,0,
28/02/2012 15:55,2011,2010,A,London Area Airports,LUTON,STANSTED,0,0,0,589,589,0,
28/02/2012 15:55,2011,2010,A,London Area Airports,LUTON,WICK,62,0,62,62,0,62,0
28/02/2012 15:55,2011,2010,A,London Area Airports,SOUTHEND,JERSEY,2863,2863,0,2492,2492,0,14.88764
28/02/2012 15:55,2011,2010,A,London Area Airports,STANSTED,ABERDEEN,49,0,49,0,0,0,
28/02/2012 15:55,2011,2010,A,London Area Airports,STANSTED,BELFAST CITY (GEORGE BEST),73123,73123,0,301637,301637,0,-75.75794983
28/02/2012 15:55,2011,2010,A,London Area Airports,STANSTED,BELFAST INTERNATIONAL,356523,356523,0,301069,301045,24,18.41903305
28/02/2012 15:55,2011,2010,A,London Area Airports,STANSTED,BIRMINGHAM,29,0,29,0,0,0,
28/02/2012 15:55,2011,2010,A,London Area Airports,STANSTED,BLACKPOOL,0,0,0,31,0,31,
28/02/2012 15:55,2011,2010,A,London Area Airports,STANSTED,BRISTOL,76,0,76,0,0,0,
28/02/2012 15:55,2011,2010,A,London Area Airports,STANSTED,CITY OF DERRY (EGLINTON),131160,131160,0,90107,90107,0,45.56027985
28/02/2012 15:55,2011,2010,A,London Area Airports,STANSTED,EDINBURGH,390372,390272,100,329874,329739,135,18.33972931
28/02/2012 15:55,2011,2010,A,London Area Airports,STANSTED,FARNBOROUGH,4,0,4,0,0,0,
28/02/2012 15:55,2011,2010,A,London Area Airports,STANSTED,GLASGOW,342785,342665,120,301758,301490,268,13.595994
28/02/2012 15:55,2011,2010,A,London Area Airports,STANSTED,GUERNSEY,30503,30503,0,22077,22077,0,38.16641617
28/02/2012 15:55,2011,2010,A,London Area Airports,STANSTED,INVERNESS,200,0,200,0,0,0,
28/02/2012 15:55,2011,2010,A,London Area Airports,STANSTED,JERSEY,8059,8059,0,27668,27668,0,-70.87248993
28/02/2012 15:55,2011,2010,A,London Area Airports,STANSTED,LIVERPOOL (JOHN LENNON),35,0,35,28,0,28,25
28/02/2012 15:55,2011,2010,A,London Area Airports,STANSTED,MANCHESTER,0,0,0,85,0,85,
28/02/2012 15:55,2011,2010,A,London Area Airports,STANSTED,NEWCASTLE,28014,28014,0,121134,121010,124,-76.87354279
28/02/2012 15:55,2011,2010,A,London Area Airports,STANSTED,PLYMOUTH,0,0,0,46,0,46,
28/02/2012 15:55,2011,2010,A,London Area Airports,STANSTED,PRESTWICK,88521,88521,0,224570,224570,0,-60.58200073
28/02/2012 15:55,2011,2010,B,Other Reporting Airports,ABERDEEN,BELFAST CITY (GEORGE BEST),18899,18899,0,18954,18954,0,-0.290176213
28/02/2012 15:55,2011,2010,B,Other Reporting Airports,ABERDEEN,BIRMINGHAM,83011,83011,0,89861,89861,0,-7.622884274
28/02/2012 15:55,2011,2010,B,Other Reporting Airports,ABERDEEN,BRISTOL,32810,32766,44,22668,22637,31,44.7414856
28/02/2012 15:55,2011,2010,B,Other Reporting Airports,ABERDEEN,CARDIFF WALES,10542,10542,0,477,477,0,2110.062988
28/02/2012 15:55,2011,2010,B,Other Reporting Airports,ABERDEEN,DONCASTER SHEFFIELD,57,0,57,0,0,0,
28/02/2012 15:55,2011,2010,B,Other Reporting Airports,ABERDEEN,DURHAM TEES VALLEY,31342,31342,0,29881,29881,0,4.88939476
28/02/2012 15:55,2011,2010,B,Other Reporting Airports,ABERDEEN,EAST MIDLANDS INTERNATIONAL,18901,18667,234,18097,18005,92,4.442725182
28/02/2012 15:55,2011,2010,B,Other Reporting Airports,ABERDEEN,EXETER,22429,22429,0,30102,30102,0,-25.48999977
28/02/2012 15:55,2011,2010,B,Other Reporting Airports,ABERDEEN,GLASGOW,241,0,241,0,0,0,
28/02/2012 15:55,2011,2010,B,Other Reporting Airports,ABERDEEN,HUMBERSIDE,30175,30175,0,27071,27053,18,11.46614456
28/02/2012 15:55,2011,2010,B,Other Reporting Airports,ABERDEEN,JERSEY,2122,2122,0,2219,2219,0,-4.371338367
28/02/2012 15:55,2011,2010,B,Other Reporting Airports,ABERDEEN,KIRKWALL,41512,41334,178,38555,38482,73,7.669562817
28/02/2012 15:55,2011,2010,B,Other Reporting Airports,ABERDEEN,LEEDS BRADFORD,531,531,0,8148,8116,32,-93.48306274
28/02/2012 15:55,2011,2010,B,Other Reporting Airports,ABERDEEN,LIVERPOOL (JOHN LENNON),86,0,86,21,21,0,309.5238037
28/02/2012 15:55,2011,2010,B,Other Reporting Airports,ABERDEEN,MANCHESTER,144547,141044,3503,93126,89981,3145,55.21658707
28/02/2012 15:55,2011,2010,B,Other Reporting Airports,ABERDEEN,NEWCASTLE,24801,24779,22,26446,26446,0,-6.220222473
28/02/2012 15:55,2011,2010,B,Other Reporting Airports,ABERDEEN,NEWQUAY,8,0,8,0,0,0,
28/02/2012 15:55,2011,2010,B,Other Reporting Airports,ABERDEEN,NORWICH,61701,61666,35,59964,59964,0,2.896738052
28/02/2012 15:55,2011,2010,B,Other Reporting Airports,ABERDEEN,OXFORD (KIDLINGTON),25,0,25,0,0,0,
28/02/2012 15:55,2011,2010,B,Other Reporting Airports,ABERDEEN,SCATSTA,154077,0,154077,151370,91,151279,1.788333178
28/02/2012 15:55,2011,2010,B,Other Reporting Airports,ABERDEEN,SOUTHAMPTON,22621,22621,0,27920,27920,0,-18.97922707
28/02/2012 15:55,2011,2010,B,Other Reporting Airports,ABERDEEN,STORNOWAY,5957,5957,0,6338,6338,0,-6.011360168
28/02/2012 15:55,2011,2010,B,Other Reporting Airports,ABERDEEN,SUMBURGH,69086,64602,4484,63542,60185,3357,8.724937439
28/02/2012 15:55,2011,2010,B,Other Reporting Airports,ABERDEEN,WICK,14798,14798,0,14722,14722,0,0.516234219
28/02/2012 15:55,2011,2010,B,Other Reporting Airports,ALDERNEY,GUERNSEY,42436,42436,0,42837,42837,0,-0.936106622
28/02/2012 15:55,2011,2010,B,Other Reporting Airports,ALDERNEY,JERSEY,0,0,0,28,28,0,
28/02/2012 15:55,2011,2010,B,Other Reporting Airports,ALDERNEY,SOUTHAMPTON,27112,27112,0,27161,27161,0,-0.180405736
28/02/2012 15:55,2011,2010,B,Other Reporting Airports,ANGLESEY (VALLEY),CARDIFF WALES,8830,8830,0,7816,7816,0,12.97338772
28/02/2012 15:55,2011,2010,B,Other Reporting Airports,ANGLESEY (VALLEY),GLASGOW,7,0,7,0,0,0,
28/02/2012 15:55,2011,2010,B,Other Reporting Airports,ANGLESEY (VALLEY),ISLE OF MAN,457,457,0,230,230,0,98.69565582
28/02/2012 15:55,2011,2010,B,Other Reporting Airports,BARRA,BENBECULA,2088,2088,0,1688,1688,0,23.69668198
28/02/2012 15:55,2011,2010,B,Other Reporting Airports,BARRA,GLASGOW,8406,8406,0,8555,8555,0,-1.741671562
28/02/2012 15:55,2011,2010,B,Other Reporting Airports,BELFAST CITY (GEORGE BEST),BIRMINGHAM,309364,309364,0,200497,200433,64,54.29856873
28/02/2012 15:55,2011,2010,B,Other Reporting Airports,BELFAST CITY (GEORGE BEST),BLACKPOOL,8755,8755,0,15232,15232,0,-42.52231979
28/02/2012 15:55,2011,2010,B,Other Reporting Airports,BELFAST CITY (GEORGE BEST),BRISTOL,42504,42504,0,120414,120336,78,-64.70178223
28/02/2012 15:55,2011,2010,B,Other Reporting Airports,BELFAST CITY (GEORGE BEST),CARDIFF WALES,60997,60915,82,41594,41594,0,46.64855576
28/02/2012 15:55,2011,2010,B,Other Reporting Airports,BELFAST CITY (GEORGE BEST),DONCASTER SHEFFIELD,15943,15943,0,20561,20561,0,-22.45999718
28/02/2012 15:55,2011,2010,B,Other Reporting Airports,BELFAST CITY (GEORGE BEST),DUNDEE,10071,10071,0,9639,9639,0,4.481792927
28/02/2012 15:55,2011,2010,B,Other Reporting Airports,BELFAST CITY (GEORGE BEST),EAST MIDLANDS INTERNATIONAL,188314,188132,182,180313,180313,0,4.437283993
28/02/2012 15:55,2011,2010,B,Other Reporting Airports,BELFAST CITY (GEORGE BEST),EDINBURGH,115330,115330,0,111517,111517,0,3.419209719
28/02/2012 15:55,2011,2010,B,Other Reporting Airports,BELFAST CITY (GEORGE BEST),EXETER,9822,9822,0,984,984,0,898.1707153
28/02/2012 15:55,2011,2010,B,Other Reporting Airports,BELFAST CITY (GEORGE BEST),GLASGOW,104517,104397,120,96630,96630,0,8.162061691
28/02/2012 15:55,2011,2010,B,Other Reporting Airports,BELFAST CITY (GEORGE BEST),GUERNSEY,781,781,0,600,600,0,30.16666603
28/02/2012 15:55,2011,2010,B,Other Reporting Airports,BELFAST CITY (GEORGE BEST),INVERNESS,21544,21544,0,16811,16811,0,28.15418434
28/02/2012 15:55,2011,2010,B,Other Reporting Airports,BELFAST CITY (GEORGE BEST),ISLE OF MAN,18745,18745,0,7082,7082,0,164.6851196
28/02/2012 15:55,2011,2010,B,Other Reporting Airports,BELFAST CITY (GEORGE BEST),JERSEY,1876,1876,0,1728,1728,0,8.564814568
28/02/2012 15:55,2011,2010,B,Other Reporting Airports,BELFAST CITY (GEORGE BEST),LEEDS BRADFORD,82294,82294,0,71791,71791,0,14.62996769
28/02/2012 15:55,2011,2010,B,Other Reporting Airports,BELFAST CITY (GEORGE BEST),LIVERPOOL (JOHN LENNON),73235,73235,0,194713,194713,0,-62.38823318
28/02/2012 15:55,2011,2010,B,Other Reporting Airports,BELFAST CITY (GEORGE BEST),MANCHESTER,311434,311434,0,226516,226476,40,37.48874283
28/02/2012 15:55,2011,2010,B,Other Reporting Airports,BELFAST CITY (GEORGE BEST),MANSTON (KENT INT),4541,4541,0,0,0,0,
28/02/2012 15:55,2011,2010,B,Other Reporting Airports,BELFAST CITY (GEORGE BEST),NEWCASTLE,41331,41331,0,44985,44985,0,-8.122707367
28/02/2012 15:55,2011,2010,B,Other Reporting Airports,BELFAST CITY (GEORGE BEST),OXFORD (KIDLINGTON),0,0,0,69,0,69,
28/02/2012 15:55,2011,2010,B,Other Reporting Airports,BELFAST CITY (GEORGE BEST),PRESTWICK,0,0,0,61228,61228,0,
28/02/2012 15:55,2011,2010,B,Other Reporting Airports,BELFAST CITY (GEORGE BEST),SOUTHAMPTON,86850,86850,0,80689,80689,0,7.635489464
28/02/2012 15:55,2011,2010,B,Other Reporting Airports,BELFAST CITY (GEORGE BEST),WICK,0,0,0,34,0,34,
28/02/2012 15:55,2011,2010,B,Other Reporting Airports,BELFAST INTERNATIONAL,BIRMINGHAM,0,0,0,101430,101430,0,
28/02/2012 15:55,2011,2010,B,Other Reporting Airports,BELFAST INTERNATIONAL,BLACKPOOL,21541,21541,0,24537,24537,0,-12.21013165
28/02/2012 15:55,2011,2010,B,Other Reporting Airports,BELFAST INTERNATIONAL,BRISTOL,179616,179616,0,150153,150153,0,19.62198639
28/02/2012 15:55,2011,2010,B,Other Reporting Airports,BELFAST INTERNATIONAL,CARDIFF WALES,226,0,226,7566,7388,178,-97.01295471
28/02/2012 15:55,2011,2010,B,Other Reporting Airports,BELFAST INTERNATIONAL,EAST MIDLANDS INTERNATIONAL,94,0,94,78738,78557,181,-99.88061523
28/02/2012 15:55,2011,2010,B,Other Reporting Airports,BELFAST INTERNATIONAL,EDINBURGH,236628,236498,130,219669,219669,0,7.720252037
28/02/2012 15:55,2011,2010,B,Other Reporting Airports,BELFAST INTERNATIONAL,GLASGOW,248253,248253,0,211573,211456,117,17.33680534
28/02/2012 15:55,2011,2010,B,Other Reporting Airports,BELFAST INTERNATIONAL,ISLE OF MAN,0,0,0,6291,6291,0,
28/02/2012 15:55,2011,2010,B,Other Reporting Airports,BELFAST INTERNATIONAL,JERSEY,9874,9874,0,9626,9626,0,2.576355696
28/02/2012 15:55,2011,2010,B,Other Reporting Airports,BELFAST INTERNATIONAL,LEEDS BRADFORD,82685,82685,0,82469,82469,0,0.261916608
28/02/2012 15:55,2011,2010,B,Other Reporting Airports,BELFAST INTERNATIONAL,LIVERPOOL (JOHN LENNON),422595,422595,0,329368,329368,0,28.30481339
28/02/2012 15:55,2011,2010,B,Other Reporting Airports,BELFAST INTERNATIONAL,MANCHESTER,21352,21131,221,95098,94025,1073,-77.54737091
28/02/2012 15:55,2011,2010,B,Other Reporting Airports,BELFAST INTERNATIONAL,NEWCASTLE,180490,180490,0,172655,172655,0,4.537951469
28/02/2012 15:55,2011,2010,B,Other Reporting Airports,BELFAST INTERNATIONAL,NEWQUAY,0,0,0,4781,4781,0,
28/02/2012 15:55,2011,2010,B,Other Reporting Airports,BENBECULA,GLASGOW,22614,22614,0,21902,21902,0,3.250844717
28/02/2012 15:55,2011,2010,B,Other Reporting Airports,BENBECULA,STORNOWAY,10270,10270,0,7068,7068,0,45.30277252
28/02/2012 15:55,2011,2010,B,Other Reporting Airports,BIGGIN HILL,BIRMINGHAM,0,0,0,86,0,86,
28/02/2012 15:55,2011,2010,B,Other Reporting Airports,BIGGIN HILL,OXFORD (KIDLINGTON),5,0,5,0,0,0,
28/02/2012 15:55,2011,2010,B,Other Reporting Airports,BIGGIN HILL,WICK,0,0,0,94,0,94,
28/02/2012 15:55,2011,2010,B,Other Reporting Airports,BIRMINGHAM,BRISTOL,0,0,0,161,0,161,
28/02/2012 15:55,2011,2010,B,Other Reporting Airports,BIRMINGHAM,CITY OF DERRY (EGLINTON),55489,55489,0,49543,49543,0,12.00169563
28/02/2012 15:55,2011,2010,B,Other Reporting Airports,BIRMINGHAM,DUNDEE,18215,18215,0,17582,17582,0,3.600272894
28/02/2012 15:55,2011,2010,B,Other Reporting Airports,BIRMINGHAM,EDINBURGH,288955,288955,0,288035,288035,0,0.319405615
28/02/2012 15:55,2011,2010,B,Other Reporting Airports,BIRMINGHAM,GLASGOW,211869,211782,87,212624,212624,0,-0.355086923
28/02/2012 15:55,2011,2010,B,Other Reporting Airports,BIRMINGHAM,GUERNSEY,31399,31371,28,32766,32671,95,-4.172007561
28/02/2012 15:55,2011,2010,B,Other Reporting Airports,BIRMINGHAM,INVERNESS,30318,30318,0,30427,30427,0,-0.358234465
28/02/2012 15:55,2011,2010,B,Other Reporting Airports,BIRMINGHAM,ISLE OF MAN,45678,45678,0,44514,44514,0,2.614907742
28/02/2012 15:55,2011,2010,B,Other Reporting Airports,BIRMINGHAM,JERSEY,51333,51333,0,52988,52988,0,-3.123348713
28/02/2012 15:55,2011,2010,B,Other Reporting Airports,BIRMINGHAM,KIRKWALL,84,0,84,0,0,0,
28/02/2012 15:55,2011,2010,B,Other Reporting Airports,BIRMINGHAM,NEWCASTLE,12720,12593,127,11831,11831,0,7.514157772
28/02/2012 15:55,2011,2010,B,Other Reporting Airports,BIRMINGHAM,WICK,0,0,0,102,0,102,
28/02/2012 15:55,2011,2010,B,Other Reporting Airports,BLACKPOOL,ISLE OF MAN,22137,22137,0,23795,23795,0,-6.967850208
28/02/2012 15:55,2011,2010,B,Other Reporting Airports,BLACKPOOL,JERSEY,7310,7310,0,7998,7998,0,-8.602150917
28/02/2012 15:55,2011,2010,B,Other Reporting Airports,BLACKPOOL,NEWCASTLE,0,0,0,37,0,37,
28/02/2012 15:55,2011,2010,B,Other Reporting Airports,BLACKPOOL,PLYMOUTH,0,0,0,30,0,30,
28/02/2012 15:55,2011,2010,B,Other Reporting Airports,BLACKPOOL,SOUTH MARSTON,86,0,86,140,0,140,-38.57143021
28/02/2012 15:55,2011,2010,B,Other Reporting Airports,BLACKPOOL,WARTON,2,0,2,0,0,0,
28/02/2012 15:55,2011,2010,B,Other Reporting Airports,BOURNEMOUTH,EDINBURGH,0,0,0,17710,17710,0,
28/02/2012 15:55,2011,2010,B,Other Reporting Airports,BOURNEMOUTH,ISLE OF MAN,0,0,0,246,0,246,
28/02/2012 15:55,2011,2010,B,Other Reporting Airports,BOURNEMOUTH,JERSEY,550,550,0,4407,3134,1273,-87.51985168
28/02/2012 15:55,2011,2010,B,Other Reporting Airports,BOURNEMOUTH,LIVERPOOL (JOHN LENNON),0,0,0,25,0,25,
28/02/2012 15:55,2011,2010,B,Other Reporting Airports,BOURNEMOUTH,MANCHESTER,26,0,26,8172,8172,0,-99.68183899
28/02/2012 15:55,2011,2010,B,Other Reporting Airports,BOURNEMOUTH,SOUTHAMPTON,85,85,0,0,0,0,
28/02/2012 15:55,2011,2010,B,Other Reporting Airports,BRISTOL,CARDIFF WALES,1,0,1,2,0,2,-50
28/02/2012 15:55,2011,2010,B,Other Reporting Airports,BRISTOL,EDINBURGH,286634,286634,0,227031,227031,0,26.25324249
28/02/2012 15:55,2011,2010,B,Other Reporting Airports,BRISTOL,GLASGOW,222161,222076,85,201189,201189,0,10.42402935
28/02/2012 15:55,2011,2010,B,Other Reporting Airports,BRISTOL,GUERNSEY,24005,24005,0,24327,24327,0,-1.323632121
28/02/2012 15:55,2011,2010,B,Other Reporting Airports,BRISTOL,HAWARDEN,37,0,37,137,0,137,-72.99269867
28/02/2012 15:55,2011,2010,B,Other Reporting Airports,BRISTOL,INVERNESS,75416,75416,0,69187,69187,0,9.003136635
28/02/2012 15:55,2011,2010,B,Other Reporting Airports,BRISTOL,ISLE OF MAN,8160,8160,0,8700,8700,0,-6.206896782
28/02/2012 15:55,2011,2010,B,Other Reporting Airports,BRISTOL,ISLES OF SCILLY (ST.MARYS),3215,3215,0,3024,3024,0,6.316137791
28/02/2012 15:55,2011,2010,B,Other Reporting Airports,BRISTOL,JERSEY,30389,30389,0,27120,27120,0,12.05383492
28/02/2012 15:55,2011,2010,B,Other Reporting Airports,BRISTOL,LEEDS BRADFORD,11178,11178,0,22415,22415,0,-50.13160706
28/02/2012 15:55,2011,2010,B,Other Reporting Airports,BRISTOL,MANCHESTER,4970,4970,0,17242,17242,0,-71.1750412
28/02/2012 15:55,2011,2010,B,Other Reporting Airports,BRISTOL,NEWCASTLE,168049,167743,306,165729,165729,0,1.39987576
28/02/2012 15:55,2011,2010,B,Other Reporting Airports,BRISTOL,NEWQUAY,4062,4062,0,14370,14370,0,-71.73277283
28/02/2012 15:55,2011,2010,B,Other Reporting Airports,BRISTOL,NORWICH,0,0,0,24,0,24,
28/02/2012 15:55,2011,2010,B,Other Reporting Airports,BRISTOL,PLYMOUTH,2589,2589,0,9717,9717,0,-73.35597229
28/02/2012 15:55,2011,2010,B,Other Reporting Airports,CAMBRIDGE,CARDIFF WALES,0,0,0,40,0,40,
28/02/2012 15:55,2011,2010,B,Other Reporting Airports,CAMBRIDGE,EDINBURGH,38,0,38,0,0,0,
28/02/2012 15:55,2011,2010,B,Other Reporting Airports,CAMBRIDGE,PRESTWICK,0,0,0,30,0,30,
28/02/2012 15:55,2011,2010,B,Other Reporting Airports,CAMPBELTOWN,GLASGOW,9192,9192,0,8682,8682,0,5.874222755
28/02/2012 15:55,2011,2010,B,Other Reporting Airports,CAMPBELTOWN,ISLAY,9,9,0,0,0,0,
28/02/2012 15:55,2011,2010,B,Other Reporting Airports,CARDIFF WALES,DURHAM TEES VALLEY,0,0,0,134,0,134,
28/02/2012 15:55,2011,2010,B,Other Reporting Airports,CARDIFF WALES,EDINBURGH,83573,82359,1214,111456,111192,264,-25.01704788
28/02/2012 15:55,2011,2010,B,Other Reporting Airports,CARDIFF WALES,FARNBOROUGH,33,0,33,0,0,0,
28/02/2012 15:55,2011,2010,B,Other Reporting Airports,CARDIFF WALES,GLASGOW,47222,47116,106,52400,52241,159,-9.881679535
28/02/2012 15:55,2011,2010,B,Other Reporting Airports,CARDIFF WALES,HUMBERSIDE,253,0,253,0,0,0,
28/02/2012 15:55,2011,2010,B,Other Reporting Airports,CARDIFF WALES,ISLE OF MAN,36,36,0,0,0,0,
28/02/2012 15:55,2011,2010,B,Other Reporting Airports,CARDIFF WALES,JERSEY,13421,13421,0,22164,22164,0,-39.44684982
28/02/2012 15:55,2011,2010,B,Other Reporting Airports,CARDIFF WALES,MANCHESTER,71,0,71,0,0,0,
28/02/2012 15:55,2011,2010,B,Other Reporting Airports,CARDIFF WALES,NEWCASTLE,15069,14853,216,21339,21297,42,-29.38282013
28/02/2012 15:55,2011,2010,B,Other Reporting Airports,CARDIFF WALES,NEWQUAY,708,699,9,37,0,37,1813.51355
28/02/2012 15:55,2011,2010,B,Other Reporting Airports,CARDIFF WALES,NORWICH,186,0,186,44,0,44,322.7272644
28/02/2012 15:55,2011,2010,B,Other Reporting Airports,CARDIFF WALES,PLYMOUTH,0,0,0,43,0,43,
28/02/2012 15:55,2011,2010,B,Other Reporting Airports,CITY OF DERRY (EGLINTON),LIVERPOOL (JOHN LENNON),86125,86125,0,71997,71997,0,19.62303925
28/02/2012 15:55,2011,2010,B,Other Reporting Airports,CITY OF DERRY (EGLINTON),MANCHESTER,8433,8433,0,0,0,0,
28/02/2012 15:55,2011,2010,B,Other Reporting Airports,CITY OF DERRY (EGLINTON),PRESTWICK,70632,70632,0,55031,55031,0,28.34947586
28/02/2012 15:55,2011,2010,B,Other Reporting Airports,DONCASTER SHEFFIELD,EDINBURGH,42,0,42,0,0,0,
28/02/2012 15:55,2011,2010,B,Other Reporting Airports,DONCASTER SHEFFIELD,JERSEY,12614,12614,0,16746,16746,0,-24.6745491
28/02/2012 15:55,2011,2010,B,Other Reporting Airports,DONCASTER SHEFFIELD,MANCHESTER,94,0,94,0,0,0,
28/02/2012 15:55,2011,2010,B,Other Reporting Airports,DONCASTER SHEFFIELD,PLYMOUTH,0,0,0,79,0,79,
28/02/2012 15:55,2011,2010,B,Other Reporting Airports,DUNDEE,HUMBERSIDE,0,0,0,94,0,94,
28/02/2012 15:55,2011,2010,B,Other Reporting Airports,DUNDEE,JERSEY,1813,340,1473,2343,2343,0,-22.62057114
28/02/2012 15:55,2011,2010,B,Other Reporting Airports,DUNDEE,LIVERPOOL (JOHN LENNON),7,7,0,0,0,0,
28/02/2012 15:55,2011,2010,B,Other Reporting Airports,DUNDEE,SCATSTA,36,0,36,45,0,45,-20
28/02/2012 15:55,2011,2010,B,Other Reporting Airports,DURHAM TEES VALLEY,FARNBOROUGH,108,0,108,0,0,0,
28/02/2012 15:55,2011,2010,B,Other Reporting Airports,DURHAM TEES VALLEY,GLASGOW,0,0,0,8,0,8,
28/02/2012 15:55,2011,2010,B,Other Reporting Airports,DURHAM TEES VALLEY,JERSEY,1674,1148,526,1892,1892,0,-11.52219868
28/02/2012 15:55,2011,2010,B,Other Reporting Airports,DURHAM TEES VALLEY,PLYMOUTH,54,0,54,0,0,0,
28/02/2012 15:55,2011,2010,B,Other Reporting Airports,DURHAM TEES VALLEY,SOUTHAMPTON,5028,5028,0,5237,5237,0,-3.990834475
28/02/2012 15:55,2011,2010,B,Other Reporting Airports,EAST MIDLANDS INTERNATIONAL,EDINBURGH,109782,109782,0,108700,108700,0,0.99540019
28/02/2012 15:55,2011,2010,B,Other Reporting Airports,EAST MIDLANDS INTERNATIONAL,GLASGOW,103434,103343,91,99740,99640,100,3.703629494
28/02/2012 15:55,2011,2010,B,Other Reporting Airports,EAST MIDLANDS INTERNATIONAL,GUERNSEY,28523,28456,67,26263,26263,0,8.605261803
28/02/2012 15:55,2011,2010,B,Other Reporting Airports,EAST MIDLANDS INTERNATIONAL,ISLE OF MAN,0,0,0,2152,2152,0,
28/02/2012 15:55,2011,2010,B,Other Reporting Airports,EAST MIDLANDS INTERNATIONAL,JERSEY,54639,54639,0,53020,53020,0,3.053564787
28/02/2012 15:55,2011,2010,B,Other Reporting Airports,EAST MIDLANDS INTERNATIONAL,NEWQUAY,6409,6191,218,7885,7885,0,-18.7190876
28/02/2012 15:55,2011,2010,B,Other Reporting Airports,EAST MIDLANDS INTERNATIONAL,NORWICH,10,0,10,0,0,0,
28/02/2012 15:55,2011,2010,B,Other Reporting Airports,EAST MIDLANDS INTERNATIONAL,PLYMOUTH,0,0,0,96,0,96,
28/02/2012 15:55,2011,2010,B,Other Reporting Airports,EDAY,KIRKWALL,451,451,0,371,371,0,21.56334305
28/02/2012 15:55,2011,2010,B,Other Reporting Airports,EDINBURGH,EXETER,51353,51353,0,53776,53776,0,-4.505727291
28/02/2012 15:55,2011,2010,B,Other Reporting Airports,EDINBURGH,FARNBOROUGH,50,0,50,34,0,34,47.05882263
28/02/2012 15:55,2011,2010,B,Other Reporting Airports,EDINBURGH,GLASGOW,47,47,0,0,0,0,
28/02/2012 15:55,2011,2010,B,Other Reporting Airports,EDINBURGH,GUERNSEY,0,0,0,1322,1322,0,
28/02/2012 15:55,2011,2010,B,Other Reporting Airports,EDINBURGH,HUMBERSIDE,0,0,0,19,0,19,
28/02/2012 15:55,2011,2010,B,Other Reporting Airports,EDINBURGH,INVERNESS,0,0,0,1016,1016,0,
28/02/2012 15:55,2011,2010,B,Other Reporting Airports,EDINBURGH,ISLE OF MAN,11607,11607,0,11422,11422,0,1.619681358
28/02/2012 15:55,2011,2010,B,Other Reporting Airports,EDINBURGH,JERSEY,14611,14611,0,17029,17029,0,-14.19930744
28/02/2012 15:55,2011,2010,B,Other Reporting Airports,EDINBURGH,KIRKWALL,36458,36458,0,35643,35643,0,2.286563873
28/02/2012 15:55,2011,2010,B,Other Reporting Airports,EDINBURGH,LEEDS BRADFORD,9825,9825,0,13011,13011,0,-24.48697281
28/02/2012 15:55,2011,2010,B,Other Reporting Airports,EDINBURGH,MANCHESTER,119615,119603,12,126653,126653,0,-5.556915283
28/02/2012 15:55,2011,2010,B,Other Reporting Airports,EDINBURGH,MANSTON (KENT INT),26529,26529,0,17555,17555,0,51.11933899
28/02/2012 15:55,2011,2010,B,Other Reporting Airports,EDINBURGH,NEWQUAY,13689,13689,0,13065,12969,96,4.776119232
28/02/2012 15:55,2011,2010,B,Other Reporting Airports,EDINBURGH,NORWICH,46412,46412,0,47846,47846,0,-2.99711585
28/02/2012 15:55,2011,2010,B,Other Reporting Airports,EDINBURGH,OXFORD (KIDLINGTON),0,0,0,33,0,33,
28/02/2012 15:55,2011,2010,B,Other Reporting Airports,EDINBURGH,PLYMOUTH,100,0,100,0,0,0,
28/02/2012 15:55,2011,2010,B,Other Reporting Airports,EDINBURGH,SOUTHAMPTON,203591,203591,0,193994,193994,0,4.947060108
28/02/2012 15:55,2011,2010,B,Other Reporting Airports,EDINBURGH,STORNOWAY,21739,21739,0,21862,21862,0,-0.562620044
28/02/2012 15:55,2011,2010,B,Other Reporting Airports,EDINBURGH,SUMBURGH,35610,35610,0,32447,32447,0,9.748205185
28/02/2012 15:55,2011,2010,B,Other Reporting Airports,EDINBURGH,WICK,9116,9116,0,7793,7793,0,16.97677422
28/02/2012 15:55,2011,2010,B,Other Reporting Airports,EXETER,GLASGOW,24409,24401,8,26469,26469,0,-7.782689095
28/02/2012 15:55,2011,2010,B,Other Reporting Airports,EXETER,GUERNSEY,23080,23080,0,22349,22349,0,3.27083993
28/02/2012 15:55,2011,2010,B,Other Reporting Airports,EXETER,ISLES OF SCILLY (ST.MARYS),2952,2952,0,3062,3062,0,-3.592423201
28/02/2012 15:55,2011,2010,B,Other Reporting Airports,EXETER,JERSEY,34904,34904,0,31814,31814,0,9.712704659
28/02/2012 15:55,2011,2010,B,Other Reporting Airports,EXETER,LEEDS BRADFORD,10489,10489,0,12445,12445,0,-15.71715546
28/02/2012 15:55,2011,2010,B,Other Reporting Airports,EXETER,LIVERPOOL (JOHN LENNON),45,0,45,0,0,0,
28/02/2012 15:55,2011,2010,B,Other Reporting Airports,EXETER,MANCHESTER,41681,41681,0,41414,41414,0,0.644709527
28/02/2012 15:55,2011,2010,B,Other Reporting Airports,EXETER,NEWCASTLE,24147,24147,0,27072,27072,0,-10.80452156
28/02/2012 15:55,2011,2010,B,Other Reporting Airports,EXETER,NORWICH,0,0,0,8102,8102,0,
28/02/2012 15:55,2011,2010,B,Other Reporting Airports,EXETER,SOUTHAMPTON,3,0,3,0,0,0,
28/02/2012 15:55,2011,2010,B,Other Reporting Airports,FAIR ISLE,LERWICK (TINGWALL),3210,3210,0,2783,2783,0,15.34315491
28/02/2012 15:55,2011,2010,B,Other Reporting Airports,FAIR ISLE,SUMBURGH,106,106,0,150,150,0,-29.33333397
28/02/2012 15:55,2011,2010,B,Other Reporting Airports,FARNBOROUGH,GLASGOW,60,0,60,19,0,19,215.7894745
28/02/2012 15:55,2011,2010,B,Other Reporting Airports,FARNBOROUGH,HUMBERSIDE,0,0,0,71,0,71,
28/02/2012 15:55,2011,2010,B,Other Reporting Airports,FARNBOROUGH,INVERNESS,30,0,30,0,0,0,
28/02/2012 15:55,2011,2010,B,Other Reporting Airports,FARNBOROUGH,LIVERPOOL (JOHN LENNON),178,0,178,152,0,152,17.10526276
28/02/2012 15:55,2011,2010,B,Other Reporting Airports,FARNBOROUGH,MANCHESTER,222,0,222,201,0,201,10.44776154
28/02/2012 15:55,2011,2010,B,Other Reporting Airports,FARNBOROUGH,NEWCASTLE,208,0,208,111,0,111,87.38739014
28/02/2012 15:55,2011,2010,B,Other Reporting Airports,FARNBOROUGH,NORWICH,37,0,37,0,0,0,
28/02/2012 15:55,2011,2010,B,Other Reporting Airports,FARNBOROUGH,WICK,67,0,67,0,0,0,
28/02/2012 15:55,2011,2010,B,Other Reporting Airports,FILTON,MANCHESTER,28,0,28,17,0,17,64.70587921
28/02/2012 15:55,2011,2010,B,Other Reporting Airports,FOULA,LERWICK (TINGWALL),1299,1299,0,1276,1276,0,1.802507877
28/02/2012 15:55,2011,2010,B,Other Reporting Airports,GLASGOW,HAWARDEN,36,0,36,0,0,0,
28/02/2012 15:55,2011,2010,B,Other Reporting Airports,GLASGOW,INVERNESS,32,32,0,0,0,0,
28/02/2012 15:55,2011,2010,B,Other Reporting Airports,GLASGOW,ISLAY,25454,25454,0,24808,24808,0,2.603998661
28/02/2012 15:55,2011,2010,B,Other Reporting Airports,GLASGOW,ISLE OF MAN,11037,11037,0,10987,10987,0,0.455083281
28/02/2012 15:55,2011,2010,B,Other Reporting Airports,GLASGOW,JERSEY,17027,17027,0,9226,9226,0,84.55451965
28/02/2012 15:55,2011,2010,B,Other Reporting Airports,GLASGOW,KIRKWALL,15275,15275,0,14872,14872,0,2.70979023
28/02/2012 15:55,2011,2010,B,Other Reporting Airports,GLASGOW,LEEDS BRADFORD,13161,13161,0,14613,14613,0,-9.936358452
28/02/2012 15:55,2011,2010,B,Other Reporting Airports,GLASGOW,LIVERPOOL (JOHN LENNON),90,0,90,42,0,42,114.2857132
28/02/2012 15:55,2011,2010,B,Other Reporting Airports,GLASGOW,MANCHESTER,49425,49423,2,68315,68050,265,-27.65132141
28/02/2012 15:55,2011,2010,B,Other Reporting Airports,GLASGOW,NEWQUAY,881,881,0,226,226,0,289.822998
28/02/2012 15:55,2011,2010,B,Other Reporting Airports,GLASGOW,PLYMOUTH,13559,13559,0,23300,23300,0,-41.80686569
28/02/2012 15:55,2011,2010,B,Other Reporting Airports,GLASGOW,SOUTHAMPTON,139553,139451,102,143384,143285,99,-2.671846151
28/02/2012 15:55,2011,2010,B,Other Reporting Airports,GLASGOW,STORNOWAY,55135,55135,0,51026,51026,0,8.052757263
28/02/2012 15:55,2011,2010,B,Other Reporting Airports,GLASGOW,SUMBURGH,17915,17915,0,16821,16821,0,6.50377512
28/02/2012 15:55,2011,2010,B,Other Reporting Airports,GLASGOW,TIREE,7767,7767,0,7171,7171,0,8.311253548
28/02/2012 15:55,2011,2010,B,Other Reporting Airports,GLOUCESTERSHIRE,ISLE OF MAN,14224,14224,0,13723,13723,0,3.650805235
28/02/2012 15:55,2011,2010,B,Other Reporting Airports,GLOUCESTERSHIRE,JERSEY,402,402,0,1924,1924,0,-79.1060257
28/02/2012 15:55,2011,2010,B,Other Reporting Airports,GLOUCESTERSHIRE,NEWCASTLE,0,0,0,68,0,68,
28/02/2012 15:55,2011,2010,B,Other Reporting Airports,GUERNSEY,ISLE OF MAN,1097,1097,0,3596,3596,0,-69.49388123
28/02/2012 15:55,2011,2010,B,Other Reporting Airports,GUERNSEY,JERSEY,149767,149756,11,143207,143199,8,4.58078146
28/02/2012 15:55,2011,2010,B,Other Reporting Airports,GUERNSEY,MANCHESTER,65909,65909,0,69530,69530,0,-5.207823753
28/02/2012 15:55,2011,2010,B,Other Reporting Airports,GUERNSEY,NEWCASTLE,0,0,0,1147,1147,0,
28/02/2012 15:55,2011,2010,B,Other Reporting Airports,GUERNSEY,NEWQUAY,1212,1212,0,0,0,0,
28/02/2012 15:55,2011,2010,B,Other Reporting Airports,GUERNSEY,NORWICH,1555,1555,0,1836,1836,0,-15.3050108
28/02/2012 15:55,2011,2010,B,Other Reporting Airports,GUERNSEY,PLYMOUTH,1406,1406,0,4240,4240,0,-66.8396225
28/02/2012 15:55,2011,2010,B,Other Reporting Airports,GUERNSEY,SOUTHAMPTON,133843,133801,42,133592,133592,0,0.187885508
28/02/2012 15:55,2011,2010,B,Other Reporting Airports,HUMBERSIDE,JERSEY,2151,2151,0,2257,2257,0,-4.696499825
28/02/2012 15:55,2011,2010,B,Other Reporting Airports,HUMBERSIDE,LEEDS BRADFORD,30,0,30,0,0,0,
28/02/2012 15:55,2011,2010,B,Other Reporting Airports,HUMBERSIDE,NORWICH,1170,1170,0,1661,1661,0,-29.56050491
28/02/2012 15:55,2011,2010,B,Other Reporting Airports,HUMBERSIDE,SOUTHAMPTON,58,0,58,0,0,0,
28/02/2012 15:55,2011,2010,B,Other Reporting Airports,INVERNESS,JERSEY,1843,1843,0,1331,1331,0,38.46731949
28/02/2012 15:55,2011,2010,B,Other Reporting Airports,INVERNESS,KIRKWALL,21700,21700,0,23056,23056,0,-5.881332397
28/02/2012 15:55,2011,2010,B,Other Reporting Airports,INVERNESS,MANCHESTER,49188,49188,0,46407,46407,0,5.992630482
28/02/2012 15:55,2011,2010,B,Other Reporting Airports,INVERNESS,MANSTON (KENT INT),29,0,29,0,0,0,
28/02/2012 15:55,2011,2010,B,Other Reporting Airports,INVERNESS,PRESTWICK,0,0,0,148,0,148,
28/02/2012 15:55,2011,2010,B,Other Reporting Airports,INVERNESS,SOUTHAMPTON,2127,2127,0,2387,2387,0,-10.89233303
28/02/2012 15:55,2011,2010,B,Other Reporting Airports,INVERNESS,STORNOWAY,36364,36364,0,29777,29777,0,22.12109947
28/02/2012 15:55,2011,2010,B,Other Reporting Airports,INVERNESS,SUMBURGH,1472,1472,0,17,17,0,8558.823242
28/02/2012 15:55,2011,2010,B,Other Reporting Airports,ISLAY,STORNOWAY,179,179,0,0,0,0,
28/02/2012 15:55,2011,2010,B,Other Reporting Airports,ISLE OF MAN,ISLE OF MAN,39,39,0,0,0,0,
28/02/2012 15:55,2011,2010,B,Other Reporting Airports,ISLE OF MAN,JERSEY,3946,3946,0,4436,4423,13,-11.04598713
28/02/2012 15:55,2011,2010,B,Other Reporting Airports,ISLE OF MAN,LEEDS BRADFORD,3336,3336,0,6474,6474,0,-48.47080612
28/02/2012 15:55,2011,2010,B,Other Reporting Airports,ISLE OF MAN,LIVERPOOL (JOHN LENNON),166669,166669,0,134489,134347,142,23.92760658
28/02/2012 15:55,2011,2010,B,Other Reporting Airports,ISLE OF MAN,MANCHESTER,123862,123862,0,125845,125845,0,-1.575747967
28/02/2012 15:55,2011,2010,B,Other Reporting Airports,ISLE OF MAN,NEWCASTLE,2818,2818,0,5918,5918,0,-52.38256073
28/02/2012 15:55,2011,2010,B,Other Reporting Airports,ISLE OF MAN,OXFORD (KIDLINGTON),0,0,0,33,0,33,
28/02/2012 15:55,2011,2010,B,Other Reporting Airports,ISLE OF MAN,SOUTHAMPTON,14435,14435,0,7508,7508,0,92.26158905
28/02/2012 15:55,2011,2010,B,Other Reporting Airports,ISLES OF SCILLY (ST.MARYS),NEWQUAY,16157,16157,0,14629,14629,0,10.44500637
28/02/2012 15:55,2011,2010,B,Other Reporting Airports,ISLES OF SCILLY (ST.MARYS),SOUTHAMPTON,2957,2957,0,3084,3084,0,-4.118028641
28/02/2012 15:55,2011,2010,B,Other Reporting Airports,JERSEY,LEEDS BRADFORD,18878,18878,0,17558,17558,0,7.517940521
28/02/2012 15:55,2011,2010,B,Other Reporting Airports,JERSEY,LIVERPOOL (JOHN LENNON),72080,72080,0,57314,57314,0,25.76333809
28/02/2012 15:55,2011,2010,B,Other Reporting Airports,JERSEY,MANCHESTER,79811,79811,0,86684,86684,0,-7.928798676
28/02/2012 15:55,2011,2010,B,Other Reporting Airports,JERSEY,MANSTON (KENT INT),1527,0,1527,1529,0,1529,-0.130804449
28/02/2012 15:55,2011,2010,B,Other Reporting Airports,JERSEY,NEWCASTLE,14179,14179,0,12708,12708,0,11.57538605
28/02/2012 15:55,2011,2010,B,Other Reporting Airports,JERSEY,NEWQUAY,473,419,54,0,0,0,
28/02/2012 15:55,2011,2010,B,Other Reporting Airports,JERSEY,NORWICH,4913,4913,0,8421,8421,0,-41.65776062
28/02/2012 15:55,2011,2010,B,Other Reporting Airports,JERSEY,OXFORD (KIDLINGTON),1489,0,1489,1261,0,1261,18.08088875
28/02/2012 15:55,2011,2010,B,Other Reporting Airports,JERSEY,PLYMOUTH,3865,3865,0,7111,7089,22,-45.64758682
28/02/2012 15:55,2011,2010,B,Other Reporting Airports,JERSEY,PRESTWICK,0,0,0,1356,618,738,
28/02/2012 15:55,2011,2010,B,Other Reporting Airports,JERSEY,SOUTHAMPTON,153248,153248,0,150127,150050,77,2.078906536
28/02/2012 15:55,2011,2010,B,Other Reporting Airports,KIRKWALL,NORTH RONALDSAY,6737,6737,0,6698,6698,0,0.58226335
28/02/2012 15:55,2011,2010,B,Other Reporting Airports,KIRKWALL,PAPA WESTRAY,4462,4462,0,4062,4062,0,9.847365379
28/02/2012 15:55,2011,2010,B,Other Reporting Airports,KIRKWALL,SANDAY,2659,2659,0,2517,2517,0,5.641636848
28/02/2012 15:55,2011,2010,B,Other Reporting Airports,KIRKWALL,STRONSAY,3055,3055,0,2847,2847,0,7.30593586
28/02/2012 15:55,2011,2010,B,Other Reporting Airports,KIRKWALL,SUMBURGH,9008,9008,0,8520,8520,0,5.727699757
28/02/2012 15:55,2011,2010,B,Other Reporting Airports,KIRKWALL,WESTRAY,3507,3507,0,3557,3557,0,-1.405678988
28/02/2012 15:55,2011,2010,B,Other Reporting Airports,LANDS END (ST JUST),NEWQUAY,0,0,0,39,0,39,
28/02/2012 15:55,2011,2010,B,Other Reporting Airports,LEEDS BRADFORD,MANCHESTER,84,84,0,0,0,0,
28/02/2012 15:55,2011,2010,B,Other Reporting Airports,LEEDS BRADFORD,NEWCASTLE,26,26,0,0,0,0,
28/02/2012 15:55,2011,2010,B,Other Reporting Airports,LEEDS BRADFORD,NEWQUAY,5519,5519,0,11244,11148,96,-50.91604233
28/02/2012 15:55,2011,2010,B,Other Reporting Airports,LEEDS BRADFORD,PLYMOUTH,10864,10864,0,9227,9083,144,17.74141121
28/02/2012 15:55,2011,2010,B,Other Reporting Airports,LEEDS BRADFORD,SOUTHAMPTON,66072,66043,29,70357,70261,96,-6.090367794
28/02/2012 15:55,2011,2010,B,Other Reporting Airports,LERWICK (TINGWALL),OUT SKERRIES,484,484,0,420,420,0,15.23809528
28/02/2012 15:55,2011,2010,B,Other Reporting Airports,LERWICK (TINGWALL),PAPA STOUR,127,127,0,115,115,0,10.43478298
28/02/2012 15:55,2011,2010,B,Other Reporting Airports,LIVERPOOL (JOHN LENNON),MANCHESTER,27,27,0,0,0,0,
28/02/2012 15:55,2011,2010,B,Other Reporting Airports,LIVERPOOL (JOHN LENNON),NEWCASTLE,191,0,191,0,0,0,
28/02/2012 15:55,2011,2010,B,Other Reporting Airports,LIVERPOOL (JOHN LENNON),NORWICH,123,0,123,72,0,72,70.83333588
28/02/2012 15:55,2011,2010,B,Other Reporting Airports,LIVERPOOL (JOHN LENNON),SOUTHAMPTON,3341,3341,0,8240,8240,0,-59.45388412
28/02/2012 15:55,2011,2010,B,Other Reporting Airports,MANCHESTER,MANSTON (KENT INT),1862,1762,100,3782,3782,0,-50.76678848
28/02/2012 15:55,2011,2010,B,Other Reporting Airports,MANCHESTER,NEWCASTLE,228,0,228,242,0,242,-5.785123825
28/02/2012 15:55,2011,2010,B,Other Reporting Airports,MANCHESTER,NEWQUAY,38111,38111,0,40990,40990,0,-7.023664474
28/02/2012 15:55,2011,2010,B,Other Reporting Airports,MANCHESTER,NORWICH,26480,26321,159,29668,29668,0,-10.74558449
28/02/2012 15:55,2011,2010,B,Other Reporting Airports,MANCHESTER,PLYMOUTH,7649,7649,0,19765,19765,0,-61.30027771
28/02/2012 15:55,2011,2010,B,Other Reporting Airports,MANCHESTER,SOUTHAMPTON,114227,114227,0,112290,111711,579,1.724997759
28/02/2012 15:55,2011,2010,B,Other Reporting Airports,MANCHESTER,STORNOWAY,154,0,154,0,0,0,
28/02/2012 15:55,2011,2010,B,Other Reporting Airports,MANSTON (KENT INT),OXFORD (KIDLINGTON),34,0,34,0,0,0,
28/02/2012 15:55,2011,2010,B,Other Reporting Airports,NEWCASTLE,NEWQUAY,841,841,0,0,0,0,
28/02/2012 15:55,2011,2010,B,Other Reporting Airports,NEWCASTLE,PLYMOUTH,227,227,0,15126,15041,85,-98.49927521
28/02/2012 15:55,2011,2010,B,Other Reporting Airports,NEWCASTLE,SOUTHAMPTON,91471,91471,0,103261,103192,69,-11.41767025
28/02/2012 15:55,2011,2010,B,Other Reporting Airports,NEWQUAY,PLYMOUTH,176,176,0,978,978,0,-82.00408936
28/02/2012 15:55,2011,2010,B,Other Reporting Airports,OBAN (NORTH CONNEL),TIREE,0,0,0,195,195,0,
28/02/2012 15:55,2011,2010,B,Other Reporting Airports,OXFORD (KIDLINGTON),WICK,0,0,0,103,0,103,
28/02/2012 15:55,2011,2010,B,Other Reporting Airports,SOUTH MARSTON,WICK,43,0,43,0,0,0,
28/02/2012 15:55,2011,2010,B,Other Reporting Airports,SOUTHAMPTON,STORNOWAY,144,0,144,0,0,0,
