rundate,this_period,last_period,grp_cd,grp_name,apt1_apt_name,apt2_apt_name,total_pax_tp,total_pax_shd_tp,total_pax_cht_tp,total_pax_lp,total_pax_shd_lp,total_pax_cht_lp,total_pax_pc
24/05/2013 10:18,2012,2011,A,London Area Airports,GATWICK,ABERDEEN,233921,233466,455,177765,177765,0,31.59002113
24/05/2013 10:18,2012,2011,A,London Area Airports,GATWICK,BELFAST CITY (GEORGE BEST),280503,280476,27,247907,247907,0,13.14847946
24/05/2013 10:18,2012,2011,A,London Area Airports,GATWICK,BELFAST INTERNATIONAL,353248,352707,541,341744,341744,0,3.366262436
24/05/2013 10:18,2012,2011,A,London Area Airports,GATWICK,BLACKPOOL,37,0,37,91,0,91,-59.3406601
24/05/2013 10:18,2012,2011,A,London Area Airports,GATWICK,CARDIFF WALES,76,0,76,35,0,35,117.1428604
24/05/2013 10:18,2012,2011,A,London Area Airports,GATWICK,DONCASTER SHEFFIELD,38,0,38,0,0,0,
24/05/2013 10:18,2012,2011,A,London Area Airports,GATWICK,EAST MIDLANDS INTERNATIONAL,145,145,0,0,0,0,
24/05/2013 10:18,2012,2011,A,London Area Airports,GATWICK,EDINBURGH,696791,696746,45,669068,669068,0,4.143525124
24/05/2013 10:18,2012,2011,A,London Area Airports,GATWICK,GLASGOW,607417,607163,254,565787,565744,43,7.357892513
24/05/2013 10:18,2012,2011,A,London Area Airports,GATWICK,GUERNSEY,344782,344782,0,356368,356368,0,-3.25113368
24/05/2013 10:18,2012,2011,A,London Area Airports,GATWICK,HEATHROW,35,0,35,0,0,0,
24/05/2013 10:18,2012,2011,A,London Area Airports,GATWICK,HUMBERSIDE,0,0,0,76,0,76,
24/05/2013 10:18,2012,2011,A,London Area Airports,GATWICK,INVERNESS,230442,230224,218,222737,222466,271,3.459236622
24/05/2013 10:18,2012,2011,A,London Area Airports,GATWICK,ISLE OF MAN,143466,143428,38,127097,127097,0,12.8791399
24/05/2013 10:18,2012,2011,A,London Area Airports,GATWICK,JERSEY,553962,553962,0,574113,574113,0,-3.509936094
24/05/2013 10:18,2012,2011,A,London Area Airports,GATWICK,LEEDS BRADFORD,177,0,177,10001,10001,0,-98.23017883
24/05/2013 10:18,2012,2011,A,London Area Airports,GATWICK,LIVERPOOL (JOHN LENNON),369,0,369,208,0,208,77.40384674
24/05/2013 10:18,2012,2011,A,London Area Airports,GATWICK,MANCHESTER,194568,193695,873,232739,232263,476,-16.40077591
24/05/2013 10:18,2012,2011,A,London Area Airports,GATWICK,NEWCASTLE,84319,84278,41,95122,94969,153,-11.35699463
24/05/2013 10:18,2012,2011,A,London Area Airports,GATWICK,NEWQUAY,96181,96181,0,100902,100837,65,-4.678797245
24/05/2013 10:18,2012,2011,A,London Area Airports,GATWICK,NORWICH,32,0,32,37,0,37,-13.51351357
24/05/2013 10:18,2012,2011,A,London Area Airports,GATWICK,PLYMOUTH,0,0,0,2765,2765,0,
24/05/2013 10:18,2012,2011,A,London Area Airports,HEATHROW,ABERDEEN,663809,663809,0,652520,652520,0,1.730061889
24/05/2013 10:18,2012,2011,A,London Area Airports,HEATHROW,BELFAST CITY (GEORGE BEST),499215,499215,0,428611,428611,0,16.4727459
24/05/2013 10:18,2012,2011,A,London Area Airports,HEATHROW,BELFAST INTERNATIONAL,191463,191463,0,289359,289359,0,-33.83202362
24/05/2013 10:18,2012,2011,A,London Area Airports,HEATHROW,BIRMINGHAM,0,0,0,45,0,45,
24/05/2013 10:18,2012,2011,A,London Area Airports,HEATHROW,CARDIFF WALES,0,0,0,64,0,64,
24/05/2013 10:18,2012,2011,A,London Area Airports,HEATHROW,EDINBURGH,1254993,1254933,60,1271459,1271299,160,-1.295047641
24/05/2013 10:18,2012,2011,A,London Area Airports,HEATHROW,GLASGOW,828531,828277,254,820949,820949,0,0.923565269
24/05/2013 10:18,2012,2011,A,London Area Airports,HEATHROW,LEEDS BRADFORD,5580,5580,0,0,0,0,
24/05/2013 10:18,2012,2011,A,London Area Airports,HEATHROW,LIVERPOOL (JOHN LENNON),70,0,70,144,0,144,-51.38888931
24/05/2013 10:18,2012,2011,A,London Area Airports,HEATHROW,MANCHESTER,792831,792592,239,766906,766718,188,3.380466461
24/05/2013 10:18,2012,2011,A,London Area Airports,HEATHROW,NEWCASTLE,489726,489513,213,473614,473614,0,3.401926517
24/05/2013 10:18,2012,2011,A,London Area Airports,LONDON CITY,ABERDEEN,15793,15793,0,29,29,0,54358.62109
24/05/2013 10:18,2012,2011,A,London Area Airports,LONDON CITY,DUNDEE,27872,27872,0,31632,31632,0,-11.88669682
24/05/2013 10:18,2012,2011,A,London Area Airports,LONDON CITY,EDINBURGH,322729,322729,0,344868,344868,0,-6.419557571
24/05/2013 10:18,2012,2011,A,London Area Airports,LONDON CITY,GLASGOW,158239,158239,0,149481,149481,0,5.858938694
24/05/2013 10:18,2012,2011,A,London Area Airports,LONDON CITY,ISLE OF MAN,38494,38494,0,46010,46010,0,-16.33557892
24/05/2013 10:18,2012,2011,A,London Area Airports,LONDON CITY,JERSEY,27691,27691,0,15923,15923,0,73.90567017
24/05/2013 10:18,2012,2011,A,London Area Airports,LUTON,ABERDEEN,119950,119950,0,147688,147688,0,-18.7814846
24/05/2013 10:18,2012,2011,A,London Area Airports,LUTON,BELFAST CITY (GEORGE BEST),0,0,0,80612,80612,0,
24/05/2013 10:18,2012,2011,A,London Area Airports,LUTON,BELFAST INTERNATIONAL,230104,229311,793,144451,143909,542,59.29553986
24/05/2013 10:18,2012,2011,A,London Area Airports,LUTON,BLACKPOOL,0,0,0,90,0,90,
24/05/2013 10:18,2012,2011,A,London Area Airports,LUTON,CARDIFF WALES,67,0,67,83,0,83,-19.27710915
24/05/2013 10:18,2012,2011,A,London Area Airports,LUTON,DONCASTER SHEFFIELD,11,0,11,0,0,0,
24/05/2013 10:18,2012,2011,A,London Area Airports,LUTON,DURHAM TEES VALLEY,89,0,89,28,0,28,217.8571472
24/05/2013 10:18,2012,2011,A,London Area Airports,LUTON,EDINBURGH,269797,269797,0,259408,259344,64,4.004888058
24/05/2013 10:18,2012,2011,A,London Area Airports,LUTON,EXETER,177,0,177,252,0,252,-29.76190567
24/05/2013 10:18,2012,2011,A,London Area Airports,LUTON,GLASGOW,276488,276278,210,274576,274486,90,0.696346343
24/05/2013 10:18,2012,2011,A,London Area Airports,LUTON,HUMBERSIDE,3,0,3,0,0,0,
24/05/2013 10:18,2012,2011,A,London Area Airports,LUTON,INVERNESS,88841,88841,0,99574,99444,130,-10.77891827
24/05/2013 10:18,2012,2011,A,London Area Airports,LUTON,ISLE OF MAN,18974,18974,0,23927,23902,25,-20.70046425
24/05/2013 10:18,2012,2011,A,London Area Airports,LUTON,JERSEY,16425,16425,0,16648,16648,0,-1.339500189
24/05/2013 10:18,2012,2011,A,London Area Airports,LUTON,LEEDS BRADFORD,63,0,63,0,0,0,
24/05/2013 10:18,2012,2011,A,London Area Airports,LUTON,LIVERPOOL (JOHN LENNON),277,0,277,53,0,53,422.64151
24/05/2013 10:18,2012,2011,A,London Area Airports,LUTON,MANCHESTER,365,0,365,260,0,260,40.38461685
24/05/2013 10:18,2012,2011,A,London Area Airports,LUTON,NEWCASTLE,609,0,609,167,0,167,264.6706543
24/05/2013 10:18,2012,2011,A,London Area Airports,LUTON,NORWICH,57,0,57,52,0,52,9.615385056
24/05/2013 10:18,2012,2011,A,London Area Airports,LUTON,WICK JOHN O GROATS,0,0,0,62,0,62,
24/05/2013 10:18,2012,2011,A,London Area Airports,SOUTHEND,BELFAST INTERNATIONAL,92502,92502,0,0,0,0,
24/05/2013 10:18,2012,2011,A,London Area Airports,SOUTHEND,JERSEY,35169,35169,0,2863,2863,0,1128.396729
24/05/2013 10:18,2012,2011,A,London Area Airports,STANSTED,ABERDEEN,0,0,0,49,0,49,
24/05/2013 10:18,2012,2011,A,London Area Airports,STANSTED,BELFAST CITY (GEORGE BEST),47341,47341,0,73123,73123,0,-35.25839996
24/05/2013 10:18,2012,2011,A,London Area Airports,STANSTED,BELFAST INTERNATIONAL,311454,311454,0,356523,356523,0,-12.64126015
24/05/2013 10:18,2012,2011,A,London Area Airports,STANSTED,BIRMINGHAM,2,0,2,29,0,29,-93.10344696
24/05/2013 10:18,2012,2011,A,London Area Airports,STANSTED,BRISTOL,0,0,0,76,0,76,
24/05/2013 10:18,2012,2011,A,London Area Airports,STANSTED,CITY OF DERRY (EGLINTON),134312,134312,0,131160,131160,0,2.403171778
24/05/2013 10:18,2012,2011,A,London Area Airports,STANSTED,EDINBURGH,346353,346353,0,390372,390272,100,-11.27616692
24/05/2013 10:18,2012,2011,A,London Area Airports,STANSTED,FARNBOROUGH,2,0,2,4,0,4,-50
24/05/2013 10:18,2012,2011,A,London Area Airports,STANSTED,GLASGOW,331607,331607,0,342785,342665,120,-3.26093626
24/05/2013 10:18,2012,2011,A,London Area Airports,STANSTED,GUERNSEY,28244,28244,0,30503,30503,0,-7.405828953
24/05/2013 10:18,2012,2011,A,London Area Airports,STANSTED,INVERNESS,134,0,134,200,0,200,-33
24/05/2013 10:18,2012,2011,A,London Area Airports,STANSTED,JERSEY,6141,6141,0,8059,8059,0,-23.79947853
24/05/2013 10:18,2012,2011,A,London Area Airports,STANSTED,LEEDS BRADFORD,338,338,0,0,0,0,
24/05/2013 10:18,2012,2011,A,London Area Airports,STANSTED,LIVERPOOL (JOHN LENNON),33,0,33,35,0,35,-5.714285851
24/05/2013 10:18,2012,2011,A,London Area Airports,STANSTED,MANCHESTER,269,0,269,0,0,0,
24/05/2013 10:18,2012,2011,A,London Area Airports,STANSTED,NEWCASTLE,153,0,153,28014,28014,0,-99.45384216
24/05/2013 10:18,2012,2011,A,London Area Airports,STANSTED,NEWQUAY,2,0,2,0,0,0,
24/05/2013 10:18,2012,2011,A,London Area Airports,STANSTED,NORWICH,39,0,39,0,0,0,
24/05/2013 10:18,2012,2011,A,London Area Airports,STANSTED,PRESTWICK,0,0,0,88521,88521,0,
24/05/2013 10:18,2012,2011,B,Other Reporting Airports,ABERDEEN,BELFAST CITY (GEORGE BEST),21503,21503,0,18899,18899,0,13.77850723
24/05/2013 10:18,2012,2011,B,Other Reporting Airports,ABERDEEN,BIRMINGHAM,87317,87317,0,83011,83011,0,5.187264442
24/05/2013 10:18,2012,2011,B,Other Reporting Airports,ABERDEEN,BRISTOL,32890,32890,0,32810,32766,44,0.243828103
24/05/2013 10:18,2012,2011,B,Other Reporting Airports,ABERDEEN,CARDIFF WALES,14068,14068,0,10542,10542,0,33.44716263
24/05/2013 10:18,2012,2011,B,Other Reporting Airports,ABERDEEN,DONCASTER SHEFFIELD,0,0,0,57,0,57,
24/05/2013 10:18,2012,2011,B,Other Reporting Airports,ABERDEEN,DURHAM TEES VALLEY,33419,33342,77,31342,31342,0,6.626890659
24/05/2013 10:18,2012,2011,B,Other Reporting Airports,ABERDEEN,EAST MIDLANDS INTERNATIONAL,19788,19705,83,18901,18667,234,4.692873478
24/05/2013 10:18,2012,2011,B,Other Reporting Airports,ABERDEEN,EXETER,4798,4798,0,22429,22429,0,-78.60805511
24/05/2013 10:18,2012,2011,B,Other Reporting Airports,ABERDEEN,GATWICK,234274,233776,498,177367,177367,0,32.08432388
24/05/2013 10:18,2012,2011,B,Other Reporting Airports,ABERDEEN,GLASGOW,145,0,145,241,0,241,-39.83402634
24/05/2013 10:18,2012,2011,B,Other Reporting Airports,ABERDEEN,HEATHROW,663479,663479,0,650986,650986,0,1.91908884
24/05/2013 10:18,2012,2011,B,Other Reporting Airports,ABERDEEN,HUMBERSIDE,32173,32173,0,30175,30175,0,6.621375084
24/05/2013 10:18,2012,2011,B,Other Reporting Airports,ABERDEEN,INVERNESS,37,0,37,0,0,0,
24/05/2013 10:18,2012,2011,B,Other Reporting Airports,ABERDEEN,JERSEY,2344,2344,0,2122,2122,0,10.46182823
24/05/2013 10:18,2012,2011,B,Other Reporting Airports,ABERDEEN,KIRKWALL,47178,46958,220,41512,41334,178,13.64906502
24/05/2013 10:18,2012,2011,B,Other Reporting Airports,ABERDEEN,LEEDS BRADFORD,551,486,65,531,531,0,3.7664783
24/05/2013 10:18,2012,2011,B,Other Reporting Airports,ABERDEEN,LIVERPOOL (JOHN LENNON),0,0,0,86,0,86,
24/05/2013 10:18,2012,2011,B,Other Reporting Airports,ABERDEEN,LONDON CITY,15827,15827,0,0,0,0,
24/05/2013 10:18,2012,2011,B,Other Reporting Airports,ABERDEEN,LUTON,120549,120549,0,147901,147901,0,-18.49345207
24/05/2013 10:18,2012,2011,B,Other Reporting Airports,ABERDEEN,MANCHESTER,180733,177061,3672,144547,141044,3503,25.03407288
24/05/2013 10:18,2012,2011,B,Other Reporting Airports,ABERDEEN,NEWCASTLE,24855,24855,0,24801,24779,22,0.21773316
24/05/2013 10:18,2012,2011,B,Other Reporting Airports,ABERDEEN,NEWQUAY,0,0,0,8,0,8,
24/05/2013 10:18,2012,2011,B,Other Reporting Airports,ABERDEEN,NORWICH,64630,64532,98,61701,61666,35,4.747086525
24/05/2013 10:18,2012,2011,B,Other Reporting Airports,ABERDEEN,OXFORD (KIDLINGTON),0,0,0,25,0,25,
24/05/2013 10:18,2012,2011,B,Other Reporting Airports,ABERDEEN,SCATSTA,168127,0,168127,154147,70,154077,9.069265366
24/05/2013 10:18,2012,2011,B,Other Reporting Airports,ABERDEEN,SOUTHAMPTON,16305,16300,5,22633,22633,0,-27.95917511
24/05/2013 10:18,2012,2011,B,Other Reporting Airports,ABERDEEN,STANSTED,59,0,59,47,0,47,25.53191566
24/05/2013 10:18,2012,2011,B,Other Reporting Airports,ABERDEEN,STORNOWAY,5555,5555,0,5957,5957,0,-6.748363495
24/05/2013 10:18,2012,2011,B,Other Reporting Airports,ABERDEEN,SUMBURGH,75203,68340,6863,69086,64602,4484,8.85418129
24/05/2013 10:18,2012,2011,B,Other Reporting Airports,ABERDEEN,WICK JOHN O GROATS,14638,13534,1104,14798,14798,0,-1.081227183
24/05/2013 10:18,2012,2011,B,Other Reporting Airports,ALDERNEY,GUERNSEY,38902,38902,0,42436,42436,0,-8.327835083
24/05/2013 10:18,2012,2011,B,Other Reporting Airports,ALDERNEY,JERSEY,306,306,0,0,0,0,
24/05/2013 10:18,2012,2011,B,Other Reporting Airports,ALDERNEY,SOUTHAMPTON,24943,24943,0,27112,27112,0,-8.00014782
24/05/2013 10:18,2012,2011,B,Other Reporting Airports,BARRA,BENBECULA,2391,2391,0,2088,2088,0,14.51149464
24/05/2013 10:18,2012,2011,B,Other Reporting Airports,BARRA,GLASGOW,9023,9023,0,8406,8406,0,7.339995384
24/05/2013 10:18,2012,2011,B,Other Reporting Airports,BELFAST CITY (GEORGE BEST),ABERDEEN,21190,21190,0,18802,18802,0,12.7007761
24/05/2013 10:18,2012,2011,B,Other Reporting Airports,BELFAST CITY (GEORGE BEST),BIRMINGHAM,308289,308289,0,309871,309871,0,-0.510535002
24/05/2013 10:18,2012,2011,B,Other Reporting Airports,BELFAST CITY (GEORGE BEST),BLACKPOOL,12014,12014,0,8919,8919,0,34.70119858
24/05/2013 10:18,2012,2011,B,Other Reporting Airports,BELFAST CITY (GEORGE BEST),BRISTOL,17263,17263,0,42504,42504,0,-59.38499832
24/05/2013 10:18,2012,2011,B,Other Reporting Airports,BELFAST CITY (GEORGE BEST),CARDIFF WALES,38412,38412,0,61350,61268,82,-37.38875198
24/05/2013 10:18,2012,2011,B,Other Reporting Airports,BELFAST CITY (GEORGE BEST),DONCASTER SHEFFIELD,0,0,0,15943,15943,0,
24/05/2013 10:18,2012,2011,B,Other Reporting Airports,BELFAST CITY (GEORGE BEST),DUNDEE,8518,8518,0,10071,10071,0,-15.42051411
24/05/2013 10:18,2012,2011,B,Other Reporting Airports,BELFAST CITY (GEORGE BEST),EAST MIDLANDS INTERNATIONAL,164576,164576,0,188821,188639,182,-12.84020329
24/05/2013 10:18,2012,2011,B,Other Reporting Airports,BELFAST CITY (GEORGE BEST),EDINBURGH,124252,124252,0,115422,115422,0,7.650187969
24/05/2013 10:18,2012,2011,B,Other Reporting Airports,BELFAST CITY (GEORGE BEST),EXETER,12492,12492,0,9822,9822,0,27.18387222
24/05/2013 10:18,2012,2011,B,Other Reporting Airports,BELFAST CITY (GEORGE BEST),GATWICK,278551,278428,123,245934,245934,0,13.26250172
24/05/2013 10:18,2012,2011,B,Other Reporting Airports,BELFAST CITY (GEORGE BEST),GLASGOW,100003,99961,42,104547,104427,120,-4.346370697
24/05/2013 10:18,2012,2011,B,Other Reporting Airports,BELFAST CITY (GEORGE BEST),GLOUCESTERSHIRE,223,223,0,0,0,0,
24/05/2013 10:18,2012,2011,B,Other Reporting Airports,BELFAST CITY (GEORGE BEST),GUERNSEY,0,0,0,781,781,0,
24/05/2013 10:18,2012,2011,B,Other Reporting Airports,BELFAST CITY (GEORGE BEST),HEATHROW,495908,495781,127,426433,426433,0,16.2921257
24/05/2013 10:18,2012,2011,B,Other Reporting Airports,BELFAST CITY (GEORGE BEST),INVERNESS,23625,23625,0,21546,21546,0,9.649123192
24/05/2013 10:18,2012,2011,B,Other Reporting Airports,BELFAST CITY (GEORGE BEST),ISLE OF MAN,15299,15232,67,19408,19408,0,-21.17168236
24/05/2013 10:18,2012,2011,B,Other Reporting Airports,BELFAST CITY (GEORGE BEST),JERSEY,1985,1985,0,1876,1876,0,5.810234547
24/05/2013 10:18,2012,2011,B,Other Reporting Airports,BELFAST CITY (GEORGE BEST),LEEDS BRADFORD,100108,100108,0,82334,82334,0,21.58767891
24/05/2013 10:18,2012,2011,B,Other Reporting Airports,BELFAST CITY (GEORGE BEST),LIVERPOOL (JOHN LENNON),0,0,0,73207,73207,0,
24/05/2013 10:18,2012,2011,B,Other Reporting Airports,BELFAST CITY (GEORGE BEST),LUTON,0,0,0,81323,81323,0,
24/05/2013 10:18,2012,2011,B,Other Reporting Airports,BELFAST CITY (GEORGE BEST),MANCHESTER,279917,279917,0,311787,311787,0,-10.22172165
24/05/2013 10:18,2012,2011,B,Other Reporting Airports,BELFAST CITY (GEORGE BEST),MANSTON (KENT INT),0,0,0,4541,4541,0,
24/05/2013 10:18,2012,2011,B,Other Reporting Airports,BELFAST CITY (GEORGE BEST),NEWCASTLE,39118,39118,0,41331,41331,0,-5.354334354
24/05/2013 10:18,2012,2011,B,Other Reporting Airports,BELFAST CITY (GEORGE BEST),NEWQUAY,1758,1758,0,0,0,0,
24/05/2013 10:18,2012,2011,B,Other Reporting Airports,BELFAST CITY (GEORGE BEST),SOUTHAMPTON,84573,84573,0,86883,86883,0,-2.658747911
24/05/2013 10:18,2012,2011,B,Other Reporting Airports,BELFAST CITY (GEORGE BEST),STANSTED,46079,46079,0,68636,68636,0,-32.86467743
24/05/2013 10:18,2012,2011,B,Other Reporting Airports,BELFAST INTERNATIONAL,BIRMINGHAM,24892,24683,209,0,0,0,
24/05/2013 10:18,2012,2011,B,Other Reporting Airports,BELFAST INTERNATIONAL,BLACKPOOL,19318,19318,0,21541,21541,0,-10.31985474
24/05/2013 10:18,2012,2011,B,Other Reporting Airports,BELFAST INTERNATIONAL,BRISTOL,217182,217140,42,179616,179616,0,20.91461754
24/05/2013 10:18,2012,2011,B,Other Reporting Airports,BELFAST INTERNATIONAL,CARDIFF WALES,90,0,90,226,0,226,-60.17699051
24/05/2013 10:18,2012,2011,B,Other Reporting Airports,BELFAST INTERNATIONAL,EAST MIDLANDS INTERNATIONAL,91,0,91,94,0,94,-3.191489458
24/05/2013 10:18,2012,2011,B,Other Reporting Airports,BELFAST INTERNATIONAL,EDINBURGH,237242,237242,0,236628,236498,130,0.259479016
24/05/2013 10:18,2012,2011,B,Other Reporting Airports,BELFAST INTERNATIONAL,FARNBOROUGH,48,0,48,0,0,0,
24/05/2013 10:18,2012,2011,B,Other Reporting Airports,BELFAST INTERNATIONAL,GATWICK,354324,353830,494,342588,342449,139,3.42568922
24/05/2013 10:18,2012,2011,B,Other Reporting Airports,BELFAST INTERNATIONAL,GLASGOW,266987,266879,108,248253,248253,0,7.54633379
24/05/2013 10:18,2012,2011,B,Other Reporting Airports,BELFAST INTERNATIONAL,HEATHROW,190098,190098,0,288948,288948,0,-34.21030807
24/05/2013 10:18,2012,2011,B,Other Reporting Airports,BELFAST INTERNATIONAL,JERSEY,9267,9267,0,9874,9874,0,-6.147458076
24/05/2013 10:18,2012,2011,B,Other Reporting Airports,BELFAST INTERNATIONAL,LEEDS BRADFORD,51535,51535,0,82685,82685,0,-37.6730957
24/05/2013 10:18,2012,2011,B,Other Reporting Airports,BELFAST INTERNATIONAL,LIVERPOOL (JOHN LENNON),447571,447571,0,422595,422595,0,5.910150528
24/05/2013 10:18,2012,2011,B,Other Reporting Airports,BELFAST INTERNATIONAL,LUTON,232310,231517,793,146042,145496,546,59.07067871
24/05/2013 10:18,2012,2011,B,Other Reporting Airports,BELFAST INTERNATIONAL,MANCHESTER,149334,149296,38,21352,21131,221,599.3911743
24/05/2013 10:18,2012,2011,B,Other Reporting Airports,BELFAST INTERNATIONAL,NEWCASTLE,193123,193123,0,180490,180490,0,6.999279976
24/05/2013 10:18,2012,2011,B,Other Reporting Airports,BELFAST INTERNATIONAL,SOUTHEND,95480,95480,0,0,0,0,
24/05/2013 10:18,2012,2011,B,Other Reporting Airports,BELFAST INTERNATIONAL,STANSTED,311074,311074,0,356370,356370,0,-12.71038532
24/05/2013 10:18,2012,2011,B,Other Reporting Airports,BENBECULA,BARRA,1410,1410,0,1346,1346,0,4.75482893
24/05/2013 10:18,2012,2011,B,Other Reporting Airports,BENBECULA,GLASGOW,19716,19716,0,22614,22614,0,-12.81507015
24/05/2013 10:18,2012,2011,B,Other Reporting Airports,BENBECULA,STORNOWAY,9723,9723,0,10270,10270,0,-5.326192856
24/05/2013 10:18,2012,2011,B,Other Reporting Airports,BIRMINGHAM,ABERDEEN,86546,86546,0,82366,82366,0,5.074909687
24/05/2013 10:18,2012,2011,B,Other Reporting Airports,BIRMINGHAM,BELFAST CITY (GEORGE BEST),308479,308479,0,311029,311029,0,-0.819859266
24/05/2013 10:18,2012,2011,B,Other Reporting Airports,BIRMINGHAM,BELFAST INTERNATIONAL,24735,24526,209,265,265,0,9233.961914
24/05/2013 10:18,2012,2011,B,Other Reporting Airports,BIRMINGHAM,CARDIFF WALES,5,5,0,0,0,0,
24/05/2013 10:18,2012,2011,B,Other Reporting Airports,BIRMINGHAM,CITY OF DERRY (EGLINTON),55096,55096,0,55489,55489,0,-0.708248496
24/05/2013 10:18,2012,2011,B,Other Reporting Airports,BIRMINGHAM,DUNDEE,16145,16145,0,18215,18215,0,-11.36426067
24/05/2013 10:18,2012,2011,B,Other Reporting Airports,BIRMINGHAM,EDINBURGH,285911,285911,0,288955,288955,0,-1.05345118
24/05/2013 10:18,2012,2011,B,Other Reporting Airports,BIRMINGHAM,GLASGOW,208123,207857,266,211869,211782,87,-1.768073678
24/05/2013 10:18,2012,2011,B,Other Reporting Airports,BIRMINGHAM,GUERNSEY,27630,27630,0,31399,31371,28,-12.00356674
24/05/2013 10:18,2012,2011,B,Other Reporting Airports,BIRMINGHAM,INVERNESS,32987,32987,0,30318,30318,0,8.803351402
24/05/2013 10:18,2012,2011,B,Other Reporting Airports,BIRMINGHAM,ISLE OF MAN,43412,43412,0,45678,45678,0,-4.960812569
24/05/2013 10:18,2012,2011,B,Other Reporting Airports,BIRMINGHAM,JERSEY,47941,47941,0,51333,51333,0,-6.607835293
24/05/2013 10:18,2012,2011,B,Other Reporting Airports,BIRMINGHAM,KIRKWALL,0,0,0,84,0,84,
24/05/2013 10:18,2012,2011,B,Other Reporting Airports,BIRMINGHAM,NEWCASTLE,10393,10393,0,12720,12593,127,-18.29402542
24/05/2013 10:18,2012,2011,B,Other Reporting Airports,BIRMINGHAM,SOUTHAMPTON,73,73,0,0,0,0,
24/05/2013 10:18,2012,2011,B,Other Reporting Airports,BIRMINGHAM,STORNOWAY,177,0,177,0,0,0,
24/05/2013 10:18,2012,2011,B,Other Reporting Airports,BLACKPOOL,BELFAST INTERNATIONAL,19151,19151,0,21207,21207,0,-9.694911957
24/05/2013 10:18,2012,2011,B,Other Reporting Airports,BLACKPOOL,EDINBURGH,48,0,48,0,0,0,
24/05/2013 10:18,2012,2011,B,Other Reporting Airports,BLACKPOOL,GATWICK,0,0,0,74,0,74,
24/05/2013 10:18,2012,2011,B,Other Reporting Airports,BLACKPOOL,INVERNESS,81,0,81,0,0,0,
24/05/2013 10:18,2012,2011,B,Other Reporting Airports,BLACKPOOL,ISLE OF MAN,22397,22397,0,22881,22881,0,-2.115292072
24/05/2013 10:18,2012,2011,B,Other Reporting Airports,BLACKPOOL,JERSEY,6911,6911,0,7310,7310,0,-5.458276272
24/05/2013 10:18,2012,2011,B,Other Reporting Airports,BLACKPOOL,LUTON,0,0,0,99,0,99,
24/05/2013 10:18,2012,2011,B,Other Reporting Airports,BLACKPOOL,NORWICH,62,0,62,0,0,0,
24/05/2013 10:18,2012,2011,B,Other Reporting Airports,BLACKPOOL,SOUTH MARSTON,0,0,0,86,0,86,
24/05/2013 10:18,2012,2011,B,Other Reporting Airports,BLACKPOOL,WARTON,0,0,0,2,0,2,
24/05/2013 10:18,2012,2011,B,Other Reporting Airports,BOURNEMOUTH,BELFAST CITY (GEORGE BEST),0,0,0,74,74,0,
24/05/2013 10:18,2012,2011,B,Other Reporting Airports,BOURNEMOUTH,EDINBURGH,184,0,184,0,0,0,
24/05/2013 10:18,2012,2011,B,Other Reporting Airports,BOURNEMOUTH,JERSEY,2898,2898,0,550,550,0,426.9090881
24/05/2013 10:18,2012,2011,B,Other Reporting Airports,BOURNEMOUTH,LEEDS BRADFORD,64,0,64,0,0,0,
24/05/2013 10:18,2012,2011,B,Other Reporting Airports,BOURNEMOUTH,MANCHESTER,0,0,0,26,0,26,
24/05/2013 10:18,2012,2011,B,Other Reporting Airports,BOURNEMOUTH,NEWCASTLE,63,0,63,0,0,0,
24/05/2013 10:18,2012,2011,B,Other Reporting Airports,BOURNEMOUTH,SOUTHAMPTON,0,0,0,85,85,0,
24/05/2013 10:18,2012,2011,B,Other Reporting Airports,BOURNEMOUTH,STANSTED,60,0,60,0,0,0,
24/05/2013 10:18,2012,2011,B,Other Reporting Airports,BRISTOL,ABERDEEN,16317,16317,0,18466,18466,0,-11.63760471
24/05/2013 10:18,2012,2011,B,Other Reporting Airports,BRISTOL,BELFAST CITY (GEORGE BEST),17485,17485,0,42802,42734,68,-59.14910507
24/05/2013 10:18,2012,2011,B,Other Reporting Airports,BRISTOL,BELFAST INTERNATIONAL,217225,217225,0,179690,179690,0,20.88875198
24/05/2013 10:18,2012,2011,B,Other Reporting Airports,BRISTOL,BIRMINGHAM,0,0,0,32,32,0,
24/05/2013 10:18,2012,2011,B,Other Reporting Airports,BRISTOL,CARDIFF WALES,36,36,0,1,0,1,3500
24/05/2013 10:18,2012,2011,B,Other Reporting Airports,BRISTOL,EDINBURGH,295532,295532,0,286634,286634,0,3.104307175
24/05/2013 10:18,2012,2011,B,Other Reporting Airports,BRISTOL,FILTON,45,0,45,0,0,0,
24/05/2013 10:18,2012,2011,B,Other Reporting Airports,BRISTOL,GATWICK,56,0,56,0,0,0,
24/05/2013 10:18,2012,2011,B,Other Reporting Airports,BRISTOL,GLASGOW,239666,239574,92,222161,222076,85,7.879420757
24/05/2013 10:18,2012,2011,B,Other Reporting Airports,BRISTOL,GUERNSEY,6833,6833,0,24005,24005,0,-71.53509521
24/05/2013 10:18,2012,2011,B,Other Reporting Airports,BRISTOL,HAWARDEN,18,0,18,37,0,37,-51.35135269
24/05/2013 10:18,2012,2011,B,Other Reporting Airports,BRISTOL,INVERNESS,78072,78072,0,75416,75416,0,3.521799088
24/05/2013 10:18,2012,2011,B,Other Reporting Airports,BRISTOL,ISLE OF MAN,8186,8186,0,8160,8160,0,0.318627447
24/05/2013 10:18,2012,2011,B,Other Reporting Airports,BRISTOL,ISLES OF SCILLY (ST.MARYS),2932,2932,0,3215,3215,0,-8.802488327
24/05/2013 10:18,2012,2011,B,Other Reporting Airports,BRISTOL,JERSEY,33817,33817,0,30389,30389,0,11.28039742
24/05/2013 10:18,2012,2011,B,Other Reporting Airports,BRISTOL,LEEDS BRADFORD,8239,8239,0,11178,11178,0,-26.29271698
24/05/2013 10:18,2012,2011,B,Other Reporting Airports,BRISTOL,MANCHESTER,85,0,85,4970,4970,0,-98.28974152
24/05/2013 10:18,2012,2011,B,Other Reporting Airports,BRISTOL,NEWCASTLE,171460,171460,0,168049,167743,306,2.029765129
24/05/2013 10:18,2012,2011,B,Other Reporting Airports,BRISTOL,NEWQUAY,0,0,0,4062,4062,0,
24/05/2013 10:18,2012,2011,B,Other Reporting Airports,BRISTOL,PLYMOUTH,0,0,0,2589,2589,0,
24/05/2013 10:18,2012,2011,B,Other Reporting Airports,BRISTOL,SOUTHAMPTON,1,1,0,0,0,0,
24/05/2013 10:18,2012,2011,B,Other Reporting Airports,BRISTOL,STANSTED,0,0,0,72,0,72,
24/05/2013 10:18,2012,2011,B,Other Reporting Airports,CAMBRIDGE,EDINBURGH,0,0,0,38,0,38,
24/05/2013 10:18,2012,2011,B,Other Reporting Airports,CAMBRIDGE,JERSEY,1080,0,1080,0,0,0,
24/05/2013 10:18,2012,2011,B,Other Reporting Airports,CAMPBELTOWN,GLASGOW,8554,8554,0,9192,9192,0,-6.94081831
24/05/2013 10:18,2012,2011,B,Other Reporting Airports,CAMPBELTOWN,ISLAY,135,135,0,9,9,0,1400
24/05/2013 10:18,2012,2011,B,Other Reporting Airports,CARDIFF WALES,ABERDEEN,1803,1803,0,1008,1008,0,78.86904907
24/05/2013 10:18,2012,2011,B,Other Reporting Airports,CARDIFF WALES,ANGLESEY (VALLEY),8594,8594,0,9605,9605,0,-10.52576828
24/05/2013 10:18,2012,2011,B,Other Reporting Airports,CARDIFF WALES,BELFAST CITY (GEORGE BEST),38133,38133,0,62255,62173,82,-38.74708939
24/05/2013 10:18,2012,2011,B,Other Reporting Airports,CARDIFF WALES,BELFAST INTERNATIONAL,89,0,89,479,253,226,-81.41962433
24/05/2013 10:18,2012,2011,B,Other Reporting Airports,CARDIFF WALES,DURHAM TEES VALLEY,34,0,34,0,0,0,
24/05/2013 10:18,2012,2011,B,Other Reporting Airports,CARDIFF WALES,EDINBURGH,77719,77511,208,83573,82359,1214,-7.004654408
24/05/2013 10:18,2012,2011,B,Other Reporting Airports,CARDIFF WALES,FARNBOROUGH,74,0,74,33,0,33,124.242424
24/05/2013 10:18,2012,2011,B,Other Reporting Airports,CARDIFF WALES,GATWICK,75,0,75,35,0,35,114.2857132
24/05/2013 10:18,2012,2011,B,Other Reporting Airports,CARDIFF WALES,GLASGOW,39828,39828,0,47222,47116,106,-15.65795612
24/05/2013 10:18,2012,2011,B,Other Reporting Airports,CARDIFF WALES,HEATHROW,168,0,168,59,0,59,184.7457581
24/05/2013 10:18,2012,2011,B,Other Reporting Airports,CARDIFF WALES,HUMBERSIDE,53,0,53,253,0,253,-79.05138397
24/05/2013 10:18,2012,2011,B,Other Reporting Airports,CARDIFF WALES,ISLE OF MAN,50,50,0,36,36,0,38.88888931
24/05/2013 10:18,2012,2011,B,Other Reporting Airports,CARDIFF WALES,JERSEY,9097,9097,0,13421,13421,0,-32.21816635
24/05/2013 10:18,2012,2011,B,Other Reporting Airports,CARDIFF WALES,LIVERPOOL (JOHN LENNON),352,0,352,0,0,0,
24/05/2013 10:18,2012,2011,B,Other Reporting Airports,CARDIFF WALES,LUTON,59,0,59,89,0,89,-33.70786667
24/05/2013 10:18,2012,2011,B,Other Reporting Airports,CARDIFF WALES,MANCHESTER,364,0,364,71,0,71,412.6760559
24/05/2013 10:18,2012,2011,B,Other Reporting Airports,CARDIFF WALES,NEWCASTLE,14336,14077,259,15069,14853,216,-4.864290714
24/05/2013 10:18,2012,2011,B,Other Reporting Airports,CARDIFF WALES,NEWQUAY,0,0,0,708,699,9,
24/05/2013 10:18,2012,2011,B,Other Reporting Airports,CARDIFF WALES,NORWICH,122,0,122,186,0,186,-34.40860367
24/05/2013 10:18,2012,2011,B,Other Reporting Airports,CITY OF DERRY (EGLINTON),BIRMINGHAM,55645,55645,0,56066,56066,0,-0.750900745
24/05/2013 10:18,2012,2011,B,Other Reporting Airports,CITY OF DERRY (EGLINTON),LIVERPOOL (JOHN LENNON),93796,93796,0,86125,86125,0,8.906821251
24/05/2013 10:18,2012,2011,B,Other Reporting Airports,CITY OF DERRY (EGLINTON),MANCHESTER,0,0,0,8433,8433,0,
24/05/2013 10:18,2012,2011,B,Other Reporting Airports,CITY OF DERRY (EGLINTON),PRESTWICK,72752,72752,0,70632,70632,0,3.001472473
24/05/2013 10:18,2012,2011,B,Other Reporting Airports,CITY OF DERRY (EGLINTON),STANSTED,134224,134224,0,131139,131139,0,2.35246563
24/05/2013 10:18,2012,2011,B,Other Reporting Airports,DONCASTER SHEFFIELD,ABERDEEN,0,0,0,57,0,57,
24/05/2013 10:18,2012,2011,B,Other Reporting Airports,DONCASTER SHEFFIELD,BELFAST CITY (GEORGE BEST),0,0,0,15726,15726,0,
24/05/2013 10:18,2012,2011,B,Other Reporting Airports,DONCASTER SHEFFIELD,EDINBURGH,0,0,0,42,0,42,
24/05/2013 10:18,2012,2011,B,Other Reporting Airports,DONCASTER SHEFFIELD,FARNBOROUGH,35,0,35,0,0,0,
24/05/2013 10:18,2012,2011,B,Other Reporting Airports,DONCASTER SHEFFIELD,GATWICK,38,0,38,0,0,0,
24/05/2013 10:18,2012,2011,B,Other Reporting Airports,DONCASTER SHEFFIELD,JERSEY,9414,9414,0,12614,12614,0,-25.36863708
24/05/2013 10:18,2012,2011,B,Other Reporting Airports,DONCASTER SHEFFIELD,LUTON,11,0,11,0,0,0,
24/05/2013 10:18,2012,2011,B,Other Reporting Airports,DONCASTER SHEFFIELD,MANCHESTER,0,0,0,94,0,94,
24/05/2013 10:18,2012,2011,B,Other Reporting Airports,DUNDEE,BELFAST CITY (GEORGE BEST),8521,8521,0,9988,9988,0,-14.68762493
24/05/2013 10:18,2012,2011,B,Other Reporting Airports,DUNDEE,BIRMINGHAM,16097,16097,0,18132,18132,0,-11.22325134
24/05/2013 10:18,2012,2011,B,Other Reporting Airports,DUNDEE,DURHAM TEES VALLEY,71,71,0,0,0,0,
24/05/2013 10:18,2012,2011,B,Other Reporting Airports,DUNDEE,EAST MIDLANDS INTERNATIONAL,17,17,0,0,0,0,
24/05/2013 10:18,2012,2011,B,Other Reporting Airports,DUNDEE,HUMBERSIDE,53,53,0,0,0,0,
24/05/2013 10:18,2012,2011,B,Other Reporting Airports,DUNDEE,JERSEY,1761,310,1451,1813,340,1473,-2.868174314
24/05/2013 10:18,2012,2011,B,Other Reporting Airports,DUNDEE,KIRKWALL,17,17,0,0,0,0,
24/05/2013 10:18,2012,2011,B,Other Reporting Airports,DUNDEE,LIVERPOOL (JOHN LENNON),0,0,0,7,7,0,
24/05/2013 10:18,2012,2011,B,Other Reporting Airports,DUNDEE,LONDON CITY,27789,27789,0,31547,31547,0,-11.91238499
24/05/2013 10:18,2012,2011,B,Other Reporting Airports,DUNDEE,MANCHESTER,92,0,92,0,0,0,
24/05/2013 10:18,2012,2011,B,Other Reporting Airports,DUNDEE,NEWCASTLE,62,62,0,0,0,0,
24/05/2013 10:18,2012,2011,B,Other Reporting Airports,DUNDEE,SCATSTA,0,0,0,36,0,36,
24/05/2013 10:18,2012,2011,B,Other Reporting Airports,DUNDEE,SOUTHAMPTON,9,9,0,0,0,0,
24/05/2013 10:18,2012,2011,B,Other Reporting Airports,DUNDEE,SUMBURGH,64,64,0,0,0,0,
24/05/2013 10:18,2012,2011,B,Other Reporting Airports,DURHAM TEES VALLEY,ABERDEEN,35258,35258,0,33063,33063,0,6.638841152
24/05/2013 10:18,2012,2011,B,Other Reporting Airports,DURHAM TEES VALLEY,BIGGIN HILL,27,0,27,0,0,0,
24/05/2013 10:18,2012,2011,B,Other Reporting Airports,DURHAM TEES VALLEY,CARDIFF WALES,34,0,34,0,0,0,
24/05/2013 10:18,2012,2011,B,Other Reporting Airports,DURHAM TEES VALLEY,FARNBOROUGH,26,0,26,108,0,108,-75.92592621
24/05/2013 10:18,2012,2011,B,Other Reporting Airports,DURHAM TEES VALLEY,GATWICK,0,0,0,33,0,33,
24/05/2013 10:18,2012,2011,B,Other Reporting Airports,DURHAM TEES VALLEY,JERSEY,1764,1700,64,1674,1148,526,5.376344204
24/05/2013 10:18,2012,2011,B,Other Reporting Airports,DURHAM TEES VALLEY,LUTON,87,0,87,28,0,28,210.7142792
24/05/2013 10:18,2012,2011,B,Other Reporting Airports,DURHAM TEES VALLEY,PLYMOUTH,0,0,0,54,0,54,
24/05/2013 10:18,2012,2011,B,Other Reporting Airports,DURHAM TEES VALLEY,SOUTHAMPTON,61,1,60,5028,5028,0,-98.78679657
24/05/2013 10:18,2012,2011,B,Other Reporting Airports,EAST MIDLANDS INTERNATIONAL,ABERDEEN,19763,19683,80,19136,18859,277,3.276546717
24/05/2013 10:18,2012,2011,B,Other Reporting Airports,EAST MIDLANDS INTERNATIONAL,BELFAST CITY (GEORGE BEST),163930,163930,0,187861,187861,0,-12.73867416
24/05/2013 10:18,2012,2011,B,Other Reporting Airports,EAST MIDLANDS INTERNATIONAL,BELFAST INTERNATIONAL,45,0,45,101,0,101,-55.4455452
24/05/2013 10:18,2012,2011,B,Other Reporting Airports,EAST MIDLANDS INTERNATIONAL,DUNDEE,1,1,0,0,0,0,
24/05/2013 10:18,2012,2011,B,Other Reporting Airports,EAST MIDLANDS INTERNATIONAL,EDINBURGH,72656,72656,0,109782,109782,0,-33.81792831
24/05/2013 10:18,2012,2011,B,Other Reporting Airports,EAST MIDLANDS INTERNATIONAL,GATWICK,179,0,179,0,0,0,
24/05/2013 10:18,2012,2011,B,Other Reporting Airports,EAST MIDLANDS INTERNATIONAL,GLASGOW,70677,70645,32,103434,103343,91,-31.66946983
24/05/2013 10:18,2012,2011,B,Other Reporting Airports,EAST MIDLANDS INTERNATIONAL,GUERNSEY,28842,28842,0,28523,28456,67,1.118395686
24/05/2013 10:18,2012,2011,B,Other Reporting Airports,EAST MIDLANDS INTERNATIONAL,JERSEY,46601,46601,0,54639,54639,0,-14.71110344
24/05/2013 10:18,2012,2011,B,Other Reporting Airports,EAST MIDLANDS INTERNATIONAL,LEEDS BRADFORD,293,293,0,0,0,0,
24/05/2013 10:18,2012,2011,B,Other Reporting Airports,EAST MIDLANDS INTERNATIONAL,NEWCASTLE,40,0,40,0,0,0,
24/05/2013 10:18,2012,2011,B,Other Reporting Airports,EAST MIDLANDS INTERNATIONAL,NEWQUAY,810,810,0,6409,6191,218,-87.36152649
24/05/2013 10:18,2012,2011,B,Other Reporting Airports,EAST MIDLANDS INTERNATIONAL,NORWICH,0,0,0,10,0,10,
24/05/2013 10:18,2012,2011,B,Other Reporting Airports,EAST MIDLANDS INTERNATIONAL,STANSTED,0,0,0,30,0,30,
24/05/2013 10:18,2012,2011,B,Other Reporting Airports,EDINBURGH,BELFAST CITY (GEORGE BEST),125186,125186,0,115595,115595,0,8.297071457
24/05/2013 10:18,2012,2011,B,Other Reporting Airports,EDINBURGH,BELFAST INTERNATIONAL,236023,236023,0,235342,235342,0,0.289366126
24/05/2013 10:18,2012,2011,B,Other Reporting Airports,EDINBURGH,BIRMINGHAM,287158,287099,59,290471,290471,0,-1.140561342
24/05/2013 10:18,2012,2011,B,Other Reporting Airports,EDINBURGH,BLACKPOOL,48,0,48,0,0,0,
24/05/2013 10:18,2012,2011,B,Other Reporting Airports,EDINBURGH,BOURNEMOUTH,91,0,91,0,0,0,
24/05/2013 10:18,2012,2011,B,Other Reporting Airports,EDINBURGH,BRISTOL,294049,294049,0,285405,285405,0,3.028678656
24/05/2013 10:18,2012,2011,B,Other Reporting Airports,EDINBURGH,CARDIFF WALES,77976,77768,208,84441,83223,1218,-7.656233311
24/05/2013 10:18,2012,2011,B,Other Reporting Airports,EDINBURGH,DONCASTER SHEFFIELD,0,0,0,44,0,44,
24/05/2013 10:18,2012,2011,B,Other Reporting Airports,EDINBURGH,DUNDEE,23,23,0,0,0,0,
24/05/2013 10:18,2012,2011,B,Other Reporting Airports,EDINBURGH,EAST MIDLANDS INTERNATIONAL,72538,72538,0,110349,110349,0,-34.2649231
24/05/2013 10:18,2012,2011,B,Other Reporting Airports,EDINBURGH,EXETER,40188,40188,0,51353,51353,0,-21.74167061
24/05/2013 10:18,2012,2011,B,Other Reporting Airports,EDINBURGH,FARNBOROUGH,0,0,0,50,0,50,
24/05/2013 10:18,2012,2011,B,Other Reporting Airports,EDINBURGH,GATWICK,695801,695756,45,668014,668014,0,4.159643173
24/05/2013 10:18,2012,2011,B,Other Reporting Airports,EDINBURGH,GLASGOW,187,187,0,0,0,0,
24/05/2013 10:18,2012,2011,B,Other Reporting Airports,EDINBURGH,HEATHROW,1255711,1255651,60,1270629,1270469,160,-1.174064159
24/05/2013 10:18,2012,2011,B,Other Reporting Airports,EDINBURGH,ISLAY,83,0,83,0,0,0,
24/05/2013 10:18,2012,2011,B,Other Reporting Airports,EDINBURGH,ISLE OF MAN,10826,10826,0,11607,11607,0,-6.728698254
24/05/2013 10:18,2012,2011,B,Other Reporting Airports,EDINBURGH,JERSEY,11085,11085,0,14611,14611,0,-24.13250351
24/05/2013 10:18,2012,2011,B,Other Reporting Airports,EDINBURGH,KIRKWALL,39995,39995,0,36458,36458,0,9.701574326
24/05/2013 10:18,2012,2011,B,Other Reporting Airports,EDINBURGH,LEEDS BRADFORD,2182,2182,0,9825,9825,0,-77.79135132
24/05/2013 10:18,2012,2011,B,Other Reporting Airports,EDINBURGH,LONDON CITY,324176,324176,0,345414,345414,0,-6.148563862
24/05/2013 10:18,2012,2011,B,Other Reporting Airports,EDINBURGH,LUTON,269811,269811,0,260008,260008,0,3.770268679
24/05/2013 10:18,2012,2011,B,Other Reporting Airports,EDINBURGH,MANCHESTER,108278,108278,0,119615,119603,12,-9.477908134
24/05/2013 10:18,2012,2011,B,Other Reporting Airports,EDINBURGH,MANSTON (KENT INT),3446,3446,0,26529,26529,0,-87.01044464
24/05/2013 10:18,2012,2011,B,Other Reporting Airports,EDINBURGH,NEWQUAY,9878,9878,0,13689,13689,0,-27.83987236
24/05/2013 10:18,2012,2011,B,Other Reporting Airports,EDINBURGH,NORWICH,39663,39663,0,46412,46412,0,-14.54149818
24/05/2013 10:18,2012,2011,B,Other Reporting Airports,EDINBURGH,PLYMOUTH,0,0,0,100,0,100,
24/05/2013 10:18,2012,2011,B,Other Reporting Airports,EDINBURGH,SOUTHAMPTON,204488,204488,0,203591,203591,0,0.440589219
24/05/2013 10:18,2012,2011,B,Other Reporting Airports,EDINBURGH,STANSTED,344804,344804,0,388824,388720,104,-11.32131767
24/05/2013 10:18,2012,2011,B,Other Reporting Airports,EDINBURGH,STORNOWAY,19900,19900,0,21739,21739,0,-8.459450722
24/05/2013 10:18,2012,2011,B,Other Reporting Airports,EDINBURGH,SUMBURGH,36914,36914,0,35610,35610,0,3.661892653
24/05/2013 10:18,2012,2011,B,Other Reporting Airports,EDINBURGH,WICK JOHN O GROATS,9645,9645,0,9116,9116,0,5.802983761
24/05/2013 10:18,2012,2011,B,Other Reporting Airports,EXETER,ABERDEEN,2889,2889,0,13548,13548,0,-78.6758194
24/05/2013 10:18,2012,2011,B,Other Reporting Airports,EXETER,BELFAST CITY (GEORGE BEST),29894,29894,0,28720,28720,0,4.087743759
24/05/2013 10:18,2012,2011,B,Other Reporting Airports,EXETER,EAST MIDLANDS INTERNATIONAL,16,0,16,0,0,0,
24/05/2013 10:18,2012,2011,B,Other Reporting Airports,EXETER,EDINBURGH,40338,40338,0,51691,51646,45,-21.96320534
24/05/2013 10:18,2012,2011,B,Other Reporting Airports,EXETER,FARNBOROUGH,8,0,8,0,0,0,
24/05/2013 10:18,2012,2011,B,Other Reporting Airports,EXETER,GATWICK,0,0,0,161,0,161,
24/05/2013 10:18,2012,2011,B,Other Reporting Airports,EXETER,GLASGOW,25617,25617,0,24409,24401,8,4.94899416
24/05/2013 10:18,2012,2011,B,Other Reporting Airports,EXETER,GUERNSEY,22283,22283,0,23080,23080,0,-3.453206301
24/05/2013 10:18,2012,2011,B,Other Reporting Airports,EXETER,ISLES OF SCILLY (ST.MARYS),2414,2414,0,2952,2952,0,-18.22493172
24/05/2013 10:18,2012,2011,B,Other Reporting Airports,EXETER,JERSEY,35430,35430,0,34904,34904,0,1.506990552
24/05/2013 10:18,2012,2011,B,Other Reporting Airports,EXETER,LEEDS BRADFORD,7967,7967,0,10489,10489,0,-24.04423714
24/05/2013 10:18,2012,2011,B,Other Reporting Airports,EXETER,LIVERPOOL (JOHN LENNON),0,0,0,45,0,45,
24/05/2013 10:18,2012,2011,B,Other Reporting Airports,EXETER,LUTON,96,0,96,252,0,252,-61.90476227
24/05/2013 10:18,2012,2011,B,Other Reporting Airports,EXETER,MANCHESTER,64049,64048,1,41681,41681,0,53.6647377
24/05/2013 10:18,2012,2011,B,Other Reporting Airports,EXETER,NEWCASTLE,29797,29789,8,24147,24147,0,23.39835167
24/05/2013 10:18,2012,2011,B,Other Reporting Airports,EXETER,NORWICH,7080,7080,0,0,0,0,
24/05/2013 10:18,2012,2011,B,Other Reporting Airports,EXETER,SOUTHAMPTON,0,0,0,3,0,3,
24/05/2013 10:18,2012,2011,B,Other Reporting Airports,EXETER,STANSTED,0,0,0,277,0,277,
24/05/2013 10:18,2012,2011,B,Other Reporting Airports,GLASGOW,ANGLESEY (VALLEY),0,0,0,7,0,7,
24/05/2013 10:18,2012,2011,B,Other Reporting Airports,GLASGOW,BARRA,9260,9260,0,8605,8605,0,7.6118536
24/05/2013 10:18,2012,2011,B,Other Reporting Airports,GLASGOW,BELFAST CITY (GEORGE BEST),100307,100219,88,104860,104739,121,-4.34197998
24/05/2013 10:18,2012,2011,B,Other Reporting Airports,GLASGOW,BELFAST INTERNATIONAL,267028,266879,149,247993,247993,0,7.675620079
24/05/2013 10:18,2012,2011,B,Other Reporting Airports,GLASGOW,BENBECULA,21363,21363,0,22890,22890,0,-6.67103529
24/05/2013 10:18,2012,2011,B,Other Reporting Airports,GLASGOW,BIRMINGHAM,209907,209493,414,213360,213094,266,-1.618391395
24/05/2013 10:18,2012,2011,B,Other Reporting Airports,GLASGOW,BRISTOL,238974,238888,86,221838,221746,92,7.724555969
24/05/2013 10:18,2012,2011,B,Other Reporting Airports,GLASGOW,CAMPBELTOWN,9504,9504,0,9228,9228,0,2.990897179
24/05/2013 10:18,2012,2011,B,Other Reporting Airports,GLASGOW,CARDIFF WALES,12555,12555,0,18834,18728,106,-33.33864212
24/05/2013 10:18,2012,2011,B,Other Reporting Airports,GLASGOW,EAST MIDLANDS INTERNATIONAL,71018,70986,32,103806,103704,102,-31.58584213
24/05/2013 10:18,2012,2011,B,Other Reporting Airports,GLASGOW,EDINBURGH,259,259,0,0,0,0,
24/05/2013 10:18,2012,2011,B,Other Reporting Airports,GLASGOW,EXETER,25497,25497,0,24455,24455,0,4.260887146
24/05/2013 10:18,2012,2011,B,Other Reporting Airports,GLASGOW,FARNBOROUGH,0,0,0,60,0,60,
24/05/2013 10:18,2012,2011,B,Other Reporting Airports,GLASGOW,GATWICK,608449,608145,304,565674,565624,50,7.561775684
24/05/2013 10:18,2012,2011,B,Other Reporting Airports,GLASGOW,HAWARDEN,0,0,0,36,0,36,
24/05/2013 10:18,2012,2011,B,Other Reporting Airports,GLASGOW,HEATHROW,830512,830258,254,821028,821028,0,1.155137181
24/05/2013 10:18,2012,2011,B,Other Reporting Airports,GLASGOW,INVERNESS,8,8,0,32,32,0,-75
24/05/2013 10:18,2012,2011,B,Other Reporting Airports,GLASGOW,ISLAY,25081,25081,0,25454,25454,0,-1.465388536
24/05/2013 10:18,2012,2011,B,Other Reporting Airports,GLASGOW,ISLE OF MAN,11097,11097,0,11037,11037,0,0.54362601
24/05/2013 10:18,2012,2011,B,Other Reporting Airports,GLASGOW,JERSEY,28292,28292,0,17027,17027,0,66.15962982
24/05/2013 10:18,2012,2011,B,Other Reporting Airports,GLASGOW,KIRKWALL,15122,15122,0,15275,15275,0,-1.001636624
24/05/2013 10:18,2012,2011,B,Other Reporting Airports,GLASGOW,LEEDS BRADFORD,11942,11942,0,13161,13161,0,-9.262213707
24/05/2013 10:18,2012,2011,B,Other Reporting Airports,GLASGOW,LIVERPOOL (JOHN LENNON),0,0,0,90,0,90,
24/05/2013 10:18,2012,2011,B,Other Reporting Airports,GLASGOW,LONDON CITY,159009,159009,0,150007,150007,0,6.001053333
24/05/2013 10:18,2012,2011,B,Other Reporting Airports,GLASGOW,LUTON,277483,277271,212,275616,275527,89,0.677391708
24/05/2013 10:18,2012,2011,B,Other Reporting Airports,GLASGOW,MANCHESTER,50042,49918,124,49425,49423,2,1.248356104
24/05/2013 10:18,2012,2011,B,Other Reporting Airports,GLASGOW,NEWQUAY,3559,3559,0,881,881,0,303.9727478
24/05/2013 10:18,2012,2011,B,Other Reporting Airports,GLASGOW,NORWICH,4,0,4,0,0,0,
24/05/2013 10:18,2012,2011,B,Other Reporting Airports,GLASGOW,PLYMOUTH,0,0,0,13559,13559,0,
24/05/2013 10:18,2012,2011,B,Other Reporting Airports,GLASGOW,SOUTHAMPTON,173576,173477,99,139553,139451,102,24.3799839
24/05/2013 10:18,2012,2011,B,Other Reporting Airports,GLASGOW,STANSTED,331481,331481,0,342162,342162,0,-3.121620655
24/05/2013 10:18,2012,2011,B,Other Reporting Airports,GLASGOW,STORNOWAY,55556,55556,0,55135,55135,0,0.763580322
24/05/2013 10:18,2012,2011,B,Other Reporting Airports,GLASGOW,SUMBURGH,17964,17964,0,17915,17915,0,0.273513824
24/05/2013 10:18,2012,2011,B,Other Reporting Airports,GLASGOW,TIREE,7864,7864,0,7767,7767,0,1.248873472
24/05/2013 10:18,2012,2011,B,Other Reporting Airports,GLOUCESTERSHIRE,ISLE OF MAN,14266,14266,0,14224,14224,0,0.295275599
24/05/2013 10:18,2012,2011,B,Other Reporting Airports,GLOUCESTERSHIRE,JERSEY,1014,1014,0,402,402,0,152.2388
24/05/2013 10:18,2012,2011,B,Other Reporting Airports,GUERNSEY,ALDERNEY,38772,38772,0,40460,40460,0,-4.172021866
24/05/2013 10:18,2012,2011,B,Other Reporting Airports,GUERNSEY,BELFAST CITY (GEORGE BEST),0,0,0,785,785,0,
24/05/2013 10:18,2012,2011,B,Other Reporting Airports,GUERNSEY,BIRMINGHAM,25751,25691,60,27492,27437,55,-6.332751274
24/05/2013 10:18,2012,2011,B,Other Reporting Airports,GUERNSEY,BRISTOL,28087,28087,0,27068,27068,0,3.764592886
24/05/2013 10:18,2012,2011,B,Other Reporting Airports,GUERNSEY,EAST MIDLANDS INTERNATIONAL,29107,29107,0,28646,28605,41,1.609299779
24/05/2013 10:18,2012,2011,B,Other Reporting Airports,GUERNSEY,EXETER,22157,22157,0,22716,22716,0,-2.460820675
24/05/2013 10:18,2012,2011,B,Other Reporting Airports,GUERNSEY,GATWICK,344507,344462,45,356070,356070,0,-3.247395277
24/05/2013 10:18,2012,2011,B,Other Reporting Airports,GUERNSEY,ISLE OF MAN,22,22,0,1097,1097,0,-97.99452972
24/05/2013 10:18,2012,2011,B,Other Reporting Airports,GUERNSEY,JERSEY,141944,141853,91,149767,149756,11,-5.223447323
24/05/2013 10:18,2012,2011,B,Other Reporting Airports,GUERNSEY,MANCHESTER,63200,63200,0,65959,65959,0,-4.182901382
24/05/2013 10:18,2012,2011,B,Other Reporting Airports,GUERNSEY,NEWQUAY,38,0,38,1235,1235,0,-96.92308044
24/05/2013 10:18,2012,2011,B,Other Reporting Airports,GUERNSEY,NORWICH,1612,1612,0,1555,1555,0,3.665594816
24/05/2013 10:18,2012,2011,B,Other Reporting Airports,GUERNSEY,PLYMOUTH,0,0,0,1406,1406,0,
24/05/2013 10:18,2012,2011,B,Other Reporting Airports,GUERNSEY,SOUTHAMPTON,132030,131926,104,133843,133801,42,-1.354572177
24/05/2013 10:18,2012,2011,B,Other Reporting Airports,GUERNSEY,STANSTED,22271,22271,0,23429,23393,36,-4.942592621
24/05/2013 10:18,2012,2011,B,Other Reporting Airports,HUMBERSIDE,ABERDEEN,35655,35631,24,33142,33043,99,7.582523823
24/05/2013 10:18,2012,2011,B,Other Reporting Airports,HUMBERSIDE,BRISTOL,3,0,3,0,0,0,
24/05/2013 10:18,2012,2011,B,Other Reporting Airports,HUMBERSIDE,CARDIFF WALES,53,0,53,206,0,206,-74.27184296
24/05/2013 10:18,2012,2011,B,Other Reporting Airports,HUMBERSIDE,GATWICK,0,0,0,76,0,76,
24/05/2013 10:18,2012,2011,B,Other Reporting Airports,HUMBERSIDE,GUERNSEY,0,0,0,4,0,4,
24/05/2013 10:18,2012,2011,B,Other Reporting Airports,HUMBERSIDE,JERSEY,2178,1341,837,2151,2151,0,1.255230069
24/05/2013 10:18,2012,2011,B,Other Reporting Airports,HUMBERSIDE,LEEDS BRADFORD,27,0,27,30,0,30,-10
24/05/2013 10:18,2012,2011,B,Other Reporting Airports,HUMBERSIDE,NORWICH,1804,1804,0,1170,1170,0,54.18803406
24/05/2013 10:18,2012,2011,B,Other Reporting Airports,HUMBERSIDE,SOUTHAMPTON,75,0,75,58,0,58,29.3103447
24/05/2013 10:18,2012,2011,B,Other Reporting Airports,INVERNESS,BELFAST CITY (GEORGE BEST),23903,23903,0,21374,21374,0,11.83213234
24/05/2013 10:18,2012,2011,B,Other Reporting Airports,INVERNESS,BIRMINGHAM,33023,33023,0,30372,30370,2,8.728433609
24/05/2013 10:18,2012,2011,B,Other Reporting Airports,INVERNESS,BLACKPOOL,75,0,75,0,0,0,
24/05/2013 10:18,2012,2011,B,Other Reporting Airports,INVERNESS,BRISTOL,78000,78000,0,75670,75670,0,3.079159498
24/05/2013 10:18,2012,2011,B,Other Reporting Airports,INVERNESS,DURHAM TEES VALLEY,51,51,0,0,0,0,
24/05/2013 10:18,2012,2011,B,Other Reporting Airports,INVERNESS,EAST MIDLANDS INTERNATIONAL,17,17,0,0,0,0,
24/05/2013 10:18,2012,2011,B,Other Reporting Airports,INVERNESS,EDINBURGH,202,202,0,498,498,0,-59.43775177
24/05/2013 10:18,2012,2011,B,Other Reporting Airports,INVERNESS,FARNBOROUGH,0,0,0,30,0,30,
24/05/2013 10:18,2012,2011,B,Other Reporting Airports,INVERNESS,GATWICK,230329,230018,311,222188,221917,271,3.664014339
24/05/2013 10:18,2012,2011,B,Other Reporting Airports,INVERNESS,GLASGOW,28,28,0,71,0,71,-60.5633812
24/05/2013 10:18,2012,2011,B,Other Reporting Airports,INVERNESS,JERSEY,1633,1633,0,1843,1843,0,-11.39446545
24/05/2013 10:18,2012,2011,B,Other Reporting Airports,INVERNESS,KIRKWALL,16810,16810,0,21700,21700,0,-22.53456306
24/05/2013 10:18,2012,2011,B,Other Reporting Airports,INVERNESS,LEEDS BRADFORD,64,39,25,0,0,0,
24/05/2013 10:18,2012,2011,B,Other Reporting Airports,INVERNESS,LUTON,89910,89910,0,100731,100663,68,-10.74247265
24/05/2013 10:18,2012,2011,B,Other Reporting Airports,INVERNESS,MANCHESTER,50998,50998,0,49188,49188,0,3.679759264
24/05/2013 10:18,2012,2011,B,Other Reporting Airports,INVERNESS,MANSTON (KENT INT),0,0,0,29,0,29,
24/05/2013 10:18,2012,2011,B,Other Reporting Airports,INVERNESS,NEWCASTLE,7,7,0,0,0,0,
24/05/2013 10:18,2012,2011,B,Other Reporting Airports,INVERNESS,NORWICH,33,33,0,0,0,0,
24/05/2013 10:18,2012,2011,B,Other Reporting Airports,INVERNESS,SCATSTA,124,88,36,0,0,0,
24/05/2013 10:18,2012,2011,B,Other Reporting Airports,INVERNESS,SOUTHAMPTON,1827,1827,0,2127,2127,0,-14.10437202
24/05/2013 10:18,2012,2011,B,Other Reporting Airports,INVERNESS,STANSTED,203,0,203,197,0,197,3.045685291
24/05/2013 10:18,2012,2011,B,Other Reporting Airports,INVERNESS,STORNOWAY,36249,36249,0,36364,36364,0,-0.316246837
24/05/2013 10:18,2012,2011,B,Other Reporting Airports,INVERNESS,SUMBURGH,4244,4204,40,1472,1472,0,188.3152161
24/05/2013 10:18,2012,2011,B,Other Reporting Airports,ISLAY,CAMPBELTOWN,335,335,0,14,14,0,2292.857178
24/05/2013 10:18,2012,2011,B,Other Reporting Airports,ISLAY,GLASGOW,20369,20369,0,25127,25127,0,-18.93580627
24/05/2013 10:18,2012,2011,B,Other Reporting Airports,ISLAY,STORNOWAY,0,0,0,179,179,0,
24/05/2013 10:18,2012,2011,B,Other Reporting Airports,ISLE OF MAN,ANGLESEY (VALLEY),320,320,0,514,514,0,-37.74319077
24/05/2013 10:18,2012,2011,B,Other Reporting Airports,ISLE OF MAN,BELFAST CITY (GEORGE BEST),26443,26375,68,27437,27437,0,-3.622845173
24/05/2013 10:18,2012,2011,B,Other Reporting Airports,ISLE OF MAN,BIRMINGHAM,43020,43020,0,45001,45001,0,-4.402124405
24/05/2013 10:18,2012,2011,B,Other Reporting Airports,ISLE OF MAN,BLACKPOOL,21335,21335,0,21840,21840,0,-2.312271118
24/05/2013 10:18,2012,2011,B,Other Reporting Airports,ISLE OF MAN,BRISTOL,8197,8197,0,8154,8154,0,0.527348518
24/05/2013 10:18,2012,2011,B,Other Reporting Airports,ISLE OF MAN,CARDIFF WALES,37,37,0,38,38,0,-2.631578922
24/05/2013 10:18,2012,2011,B,Other Reporting Airports,ISLE OF MAN,EDINBURGH,10835,10835,0,11598,11598,0,-6.57872057
24/05/2013 10:18,2012,2011,B,Other Reporting Airports,ISLE OF MAN,GATWICK,142677,142677,0,126508,126508,0,12.78100967
24/05/2013 10:18,2012,2011,B,Other Reporting Airports,ISLE OF MAN,GLASGOW,11028,11028,0,11126,11126,0,-0.880819678
24/05/2013 10:18,2012,2011,B,Other Reporting Airports,ISLE OF MAN,GLOUCESTERSHIRE,14252,14252,0,14225,14225,0,0.189806685
24/05/2013 10:18,2012,2011,B,Other Reporting Airports,ISLE OF MAN,ISLE OF MAN,0,0,0,39,39,0,
24/05/2013 10:18,2012,2011,B,Other Reporting Airports,ISLE OF MAN,JERSEY,2746,2746,0,3946,3946,0,-30.41054153
24/05/2013 10:18,2012,2011,B,Other Reporting Airports,ISLE OF MAN,LEEDS BRADFORD,7177,7177,0,8275,8275,0,-13.2688818
24/05/2013 10:18,2012,2011,B,Other Reporting Airports,ISLE OF MAN,LIVERPOOL (JOHN LENNON),174618,174548,70,166669,166669,0,4.769333363
24/05/2013 10:18,2012,2011,B,Other Reporting Airports,ISLE OF MAN,LONDON CITY,38394,38394,0,46552,46552,0,-17.52448845
24/05/2013 10:18,2012,2011,B,Other Reporting Airports,ISLE OF MAN,LUTON,19739,19678,61,26166,26137,29,-24.56240845
24/05/2013 10:18,2012,2011,B,Other Reporting Airports,ISLE OF MAN,MANCHESTER,125249,125249,0,123862,123862,0,1.119794607
24/05/2013 10:18,2012,2011,B,Other Reporting Airports,ISLE OF MAN,NEWCASTLE,5469,5469,0,5507,5507,0,-0.690030873
24/05/2013 10:18,2012,2011,B,Other Reporting Airports,ISLE OF MAN,NORWICH,1054,1054,0,0,0,0,
24/05/2013 10:18,2012,2011,B,Other Reporting Airports,ISLE OF MAN,OXFORD (KIDLINGTON),4014,4014,0,0,0,0,
24/05/2013 10:18,2012,2011,B,Other Reporting Airports,ISLE OF MAN,SOUTHAMPTON,1885,1885,0,14435,14435,0,-86.94145966
24/05/2013 10:18,2012,2011,B,Other Reporting Airports,JERSEY,ABERDEEN,2329,2329,0,1908,1908,0,22.06498909
24/05/2013 10:18,2012,2011,B,Other Reporting Airports,JERSEY,ALDERNEY,394,394,0,183,183,0,115.3005447
24/05/2013 10:18,2012,2011,B,Other Reporting Airports,JERSEY,BELFAST CITY (GEORGE BEST),1984,1984,0,1824,1824,0,8.771929741
24/05/2013 10:18,2012,2011,B,Other Reporting Airports,JERSEY,BELFAST INTERNATIONAL,9137,7217,1920,9642,7052,2590,-5.237502575
24/05/2013 10:18,2012,2011,B,Other Reporting Airports,JERSEY,BIGGIN HILL,49,0,49,0,0,0,
24/05/2013 10:18,2012,2011,B,Other Reporting Airports,JERSEY,BIRMINGHAM,52744,52744,0,57008,57008,0,-7.479651928
24/05/2013 10:18,2012,2011,B,Other Reporting Airports,JERSEY,BLACKPOOL,6781,5206,1575,7195,4904,2291,-5.753995895
24/05/2013 10:18,2012,2011,B,Other Reporting Airports,JERSEY,BOURNEMOUTH,3000,2906,94,558,558,0,437.6343994
24/05/2013 10:18,2012,2011,B,Other Reporting Airports,JERSEY,BRISTOL,33595,33595,0,31438,31438,0,6.861123562
24/05/2013 10:18,2012,2011,B,Other Reporting Airports,JERSEY,CAMBRIDGE,1011,0,1011,0,0,0,
24/05/2013 10:18,2012,2011,B,Other Reporting Airports,JERSEY,CARDIFF WALES,9065,9065,0,13465,13465,0,-32.67731094
24/05/2013 10:18,2012,2011,B,Other Reporting Airports,JERSEY,DONCASTER SHEFFIELD,9441,9441,0,12660,12660,0,-25.42654037
24/05/2013 10:18,2012,2011,B,Other Reporting Airports,JERSEY,DUNDEE,1740,0,1740,1814,340,1474,-4.07938242
24/05/2013 10:18,2012,2011,B,Other Reporting Airports,JERSEY,DURHAM TEES VALLEY,1816,1417,399,1845,1845,0,-1.571815729
24/05/2013 10:18,2012,2011,B,Other Reporting Airports,JERSEY,EAST MIDLANDS INTERNATIONAL,46500,46500,0,54871,54871,0,-15.25578213
24/05/2013 10:18,2012,2011,B,Other Reporting Airports,JERSEY,EDINBURGH,10946,10946,0,14683,14683,0,-25.45120239
24/05/2013 10:18,2012,2011,B,Other Reporting Airports,JERSEY,EXETER,37148,37145,3,37401,37264,137,-0.676452518
24/05/2013 10:18,2012,2011,B,Other Reporting Airports,JERSEY,GATWICK,549251,549120,131,568976,568895,81,-3.466754198
24/05/2013 10:18,2012,2011,B,Other Reporting Airports,JERSEY,GLASGOW,27749,27749,0,16672,16672,0,66.44074249
24/05/2013 10:18,2012,2011,B,Other Reporting Airports,JERSEY,GLOUCESTERSHIRE,1023,1023,0,418,418,0,144.7368469
24/05/2013 10:18,2012,2011,B,Other Reporting Airports,JERSEY,GUERNSEY,141344,141344,0,152927,152927,0,-7.574202061
24/05/2013 10:18,2012,2011,B,Other Reporting Airports,JERSEY,HUMBERSIDE,2174,2174,0,2206,2206,0,-1.450589299
24/05/2013 10:18,2012,2011,B,Other Reporting Airports,JERSEY,INVERNESS,1424,1424,0,1835,1835,0,-22.39781952
24/05/2013 10:18,2012,2011,B,Other Reporting Airports,JERSEY,ISLE OF MAN,2765,2765,0,3712,3712,0,-25.51185417
24/05/2013 10:18,2012,2011,B,Other Reporting Airports,JERSEY,LEEDS BRADFORD,20449,20449,0,18878,18878,0,8.321856499
24/05/2013 10:18,2012,2011,B,Other Reporting Airports,JERSEY,LIVERPOOL (JOHN LENNON),78457,78457,0,72080,72080,0,8.847114563
24/05/2013 10:18,2012,2011,B,Other Reporting Airports,JERSEY,LONDON CITY,27703,27703,0,15658,15658,0,76.92552948
24/05/2013 10:18,2012,2011,B,Other Reporting Airports,JERSEY,LUTON,16871,16871,0,19205,19205,0,-12.15308475
24/05/2013 10:18,2012,2011,B,Other Reporting Airports,JERSEY,MANCHESTER,57096,57096,0,79761,79761,0,-28.41614342
24/05/2013 10:18,2012,2011,B,Other Reporting Airports,JERSEY,MANSTON (KENT INT),1379,0,1379,1527,0,1527,-9.692207336
24/05/2013 10:18,2012,2011,B,Other Reporting Airports,JERSEY,NEWCASTLE,12362,12066,296,14179,14179,0,-12.81472588
24/05/2013 10:18,2012,2011,B,Other Reporting Airports,JERSEY,NEWQUAY,0,0,0,473,419,54,
24/05/2013 10:18,2012,2011,B,Other Reporting Airports,JERSEY,NORWICH,4968,4968,0,4913,4913,0,1.119478941
24/05/2013 10:18,2012,2011,B,Other Reporting Airports,JERSEY,OXFORD (KIDLINGTON),3590,3590,0,1489,0,1489,141.1014099
24/05/2013 10:18,2012,2011,B,Other Reporting Airports,JERSEY,PLYMOUTH,0,0,0,3865,3865,0,
24/05/2013 10:18,2012,2011,B,Other Reporting Airports,JERSEY,SOUTHAMPTON,147305,147305,0,153248,153248,0,-3.878027678
24/05/2013 10:18,2012,2011,B,Other Reporting Airports,JERSEY,SOUTHEND,36380,36380,0,2826,2826,0,1187.331909
24/05/2013 10:18,2012,2011,B,Other Reporting Airports,JERSEY,STANSTED,11697,11697,0,14273,14273,0,-18.04806328
24/05/2013 10:18,2012,2011,B,Other Reporting Airports,KIRKWALL,ABERDEEN,44535,44325,210,41752,41673,79,6.665548801
24/05/2013 10:18,2012,2011,B,Other Reporting Airports,KIRKWALL,BIRMINGHAM,0,0,0,84,0,84,
24/05/2013 10:18,2012,2011,B,Other Reporting Airports,KIRKWALL,EDAY,539,539,0,451,451,0,19.51219559
24/05/2013 10:18,2012,2011,B,Other Reporting Airports,KIRKWALL,EDINBURGH,38587,38587,0,36482,36482,0,5.769968987
24/05/2013 10:18,2012,2011,B,Other Reporting Airports,KIRKWALL,GLASGOW,14008,14008,0,15199,15199,0,-7.836041927
24/05/2013 10:18,2012,2011,B,Other Reporting Airports,KIRKWALL,INVERNESS,8819,8819,0,10488,10488,0,-15.91342449
24/05/2013 10:18,2012,2011,B,Other Reporting Airports,KIRKWALL,NORTH RONALDSAY,5640,5640,0,6737,6737,0,-16.28321266
24/05/2013 10:18,2012,2011,B,Other Reporting Airports,KIRKWALL,PAPA WESTRAY,3891,3891,0,4462,4462,0,-12.79695225
24/05/2013 10:18,2012,2011,B,Other Reporting Airports,KIRKWALL,SANDAY,2428,2428,0,2659,2659,0,-8.687476158
24/05/2013 10:18,2012,2011,B,Other Reporting Airports,KIRKWALL,STRONSAY,2808,2808,0,3055,3055,0,-8.08510685
24/05/2013 10:18,2012,2011,B,Other Reporting Airports,KIRKWALL,SUMBURGH,7935,7935,0,9008,9008,0,-11.91163445
24/05/2013 10:18,2012,2011,B,Other Reporting Airports,KIRKWALL,WESTRAY,2979,2979,0,3507,3507,0,-15.05560303
24/05/2013 10:18,2012,2011,B,Other Reporting Airports,LEEDS BRADFORD,ABERDEEN,17630,17593,37,24363,24331,32,-27.63616943
24/05/2013 10:18,2012,2011,B,Other Reporting Airports,LEEDS BRADFORD,BELFAST CITY (GEORGE BEST),99676,99676,0,82116,82116,0,21.38438225
24/05/2013 10:18,2012,2011,B,Other Reporting Airports,LEEDS BRADFORD,BELFAST INTERNATIONAL,51126,51029,97,82470,82470,0,-38.00654602
24/05/2013 10:18,2012,2011,B,Other Reporting Airports,LEEDS BRADFORD,BOURNEMOUTH,67,0,67,0,0,0,
24/05/2013 10:18,2012,2011,B,Other Reporting Airports,LEEDS BRADFORD,BRISTOL,6853,6849,4,3744,3744,0,83.03952789
24/05/2013 10:18,2012,2011,B,Other Reporting Airports,LEEDS BRADFORD,EDINBURGH,1614,1614,0,9545,9545,0,-83.09062195
24/05/2013 10:18,2012,2011,B,Other Reporting Airports,LEEDS BRADFORD,EXETER,7938,7938,0,9430,9430,0,-15.82184505
24/05/2013 10:18,2012,2011,B,Other Reporting Airports,LEEDS BRADFORD,FARNBOROUGH,34,0,34,0,0,0,
24/05/2013 10:18,2012,2011,B,Other Reporting Airports,LEEDS BRADFORD,GATWICK,163,0,163,9981,9981,0,-98.36689758
24/05/2013 10:18,2012,2011,B,Other Reporting Airports,LEEDS BRADFORD,GLASGOW,11887,11887,0,13121,13121,0,-9.404770851
24/05/2013 10:18,2012,2011,B,Other Reporting Airports,LEEDS BRADFORD,HEATHROW,5518,5518,0,0,0,0,
24/05/2013 10:18,2012,2011,B,Other Reporting Airports,LEEDS BRADFORD,ISLE OF MAN,7089,7089,0,7449,7449,0,-4.832863331
24/05/2013 10:18,2012,2011,B,Other Reporting Airports,LEEDS BRADFORD,JERSEY,20514,20514,0,19018,19018,0,7.866231918
24/05/2013 10:18,2012,2011,B,Other Reporting Airports,LEEDS BRADFORD,LUTON,62,0,62,0,0,0,
24/05/2013 10:18,2012,2011,B,Other Reporting Airports,LEEDS BRADFORD,MANCHESTER,86,86,0,84,84,0,2.380952358
24/05/2013 10:18,2012,2011,B,Other Reporting Airports,LEEDS BRADFORD,NEWCASTLE,0,0,0,26,26,0,
24/05/2013 10:18,2012,2011,B,Other Reporting Airports,LEEDS BRADFORD,NEWQUAY,29,29,0,5519,5519,0,-99.47454071
24/05/2013 10:18,2012,2011,B,Other Reporting Airports,LEEDS BRADFORD,PLYMOUTH,0,0,0,10864,10864,0,
24/05/2013 10:18,2012,2011,B,Other Reporting Airports,LEEDS BRADFORD,SOUTHAMPTON,65048,65010,38,66072,66043,29,-1.549824476
24/05/2013 10:18,2012,2011,B,Other Reporting Airports,LERWICK (TINGWALL),FAIR ISLE,3060,3060,0,3210,3210,0,-4.672897339
24/05/2013 10:18,2012,2011,B,Other Reporting Airports,LERWICK (TINGWALL),FOULA,1446,1446,0,1299,1299,0,11.31639767
24/05/2013 10:18,2012,2011,B,Other Reporting Airports,LERWICK (TINGWALL),OUT SKERRIES,366,366,0,484,484,0,-24.3801651
24/05/2013 10:18,2012,2011,B,Other Reporting Airports,LERWICK (TINGWALL),PAPA STOUR,60,60,0,127,127,0,-52.75590515
24/05/2013 10:18,2012,2011,B,Other Reporting Airports,LERWICK (TINGWALL),SUMBURGH,1,1,0,0,0,0,
24/05/2013 10:18,2012,2011,B,Other Reporting Airports,LIVERPOOL (JOHN LENNON),ABERDEEN,0,0,0,4000,4000,0,
24/05/2013 10:18,2012,2011,B,Other Reporting Airports,LIVERPOOL (JOHN LENNON),BELFAST CITY (GEORGE BEST),0,0,0,72843,72843,0,
24/05/2013 10:18,2012,2011,B,Other Reporting Airports,LIVERPOOL (JOHN LENNON),BELFAST INTERNATIONAL,444436,444436,0,420791,420791,0,5.619179249
24/05/2013 10:18,2012,2011,B,Other Reporting Airports,LIVERPOOL (JOHN LENNON),CARDIFF WALES,339,0,339,0,0,0,
24/05/2013 10:18,2012,2011,B,Other Reporting Airports,LIVERPOOL (JOHN LENNON),CITY OF DERRY (EGLINTON),92914,92914,0,85236,85236,0,9.007930756
24/05/2013 10:18,2012,2011,B,Other Reporting Airports,LIVERPOOL (JOHN LENNON),EDINBURGH,86,0,86,0,0,0,
24/05/2013 10:18,2012,2011,B,Other Reporting Airports,LIVERPOOL (JOHN LENNON),EXETER,0,0,0,73,0,73,
24/05/2013 10:18,2012,2011,B,Other Reporting Airports,LIVERPOOL (JOHN LENNON),FARNBOROUGH,422,0,422,178,0,178,137.0786591
24/05/2013 10:18,2012,2011,B,Other Reporting Airports,LIVERPOOL (JOHN LENNON),GATWICK,347,0,347,197,0,197,76.14213562
24/05/2013 10:18,2012,2011,B,Other Reporting Airports,LIVERPOOL (JOHN LENNON),GLASGOW,0,0,0,70,0,70,
24/05/2013 10:18,2012,2011,B,Other Reporting Airports,LIVERPOOL (JOHN LENNON),HEATHROW,114,36,78,208,0,208,-45.19230652
24/05/2013 10:18,2012,2011,B,Other Reporting Airports,LIVERPOOL (JOHN LENNON),ISLE OF MAN,173635,173565,70,166029,166029,0,4.581127167
24/05/2013 10:18,2012,2011,B,Other Reporting Airports,LIVERPOOL (JOHN LENNON),JERSEY,78554,78554,0,72735,72735,0,8.000274658
24/05/2013 10:18,2012,2011,B,Other Reporting Airports,LIVERPOOL (JOHN LENNON),LUTON,171,0,171,10,0,10,1610
24/05/2013 10:18,2012,2011,B,Other Reporting Airports,LIVERPOOL (JOHN LENNON),NEWCASTLE,253,0,253,191,0,191,32.46073151
24/05/2013 10:18,2012,2011,B,Other Reporting Airports,LIVERPOOL (JOHN LENNON),NORWICH,280,0,280,123,0,123,127.6422729
24/05/2013 10:18,2012,2011,B,Other Reporting Airports,LIVERPOOL (JOHN LENNON),SOUTHAMPTON,134,0,134,3341,3341,0,-95.98922729
24/05/2013 10:18,2012,2011,B,Other Reporting Airports,LIVERPOOL (JOHN LENNON),STANSTED,78,0,78,35,0,35,122.8571396
24/05/2013 10:18,2012,2011,B,Other Reporting Airports,MANCHESTER,ABERDEEN,179825,176116,3709,144566,141025,3541,24.38955307
24/05/2013 10:18,2012,2011,B,Other Reporting Airports,MANCHESTER,BELFAST CITY (GEORGE BEST),279411,279411,0,311536,311536,0,-10.31180954
24/05/2013 10:18,2012,2011,B,Other Reporting Airports,MANCHESTER,BELFAST INTERNATIONAL,148205,148167,38,21060,20839,221,603.727417
24/05/2013 10:18,2012,2011,B,Other Reporting Airports,MANCHESTER,BIGGIN HILL,81,0,81,0,0,0,
24/05/2013 10:18,2012,2011,B,Other Reporting Airports,MANCHESTER,BOURNEMOUTH,0,0,0,26,0,26,
24/05/2013 10:18,2012,2011,B,Other Reporting Airports,MANCHESTER,BRISTOL,59,0,59,0,0,0,
24/05/2013 10:18,2012,2011,B,Other Reporting Airports,MANCHESTER,CARDIFF WALES,399,0,399,0,0,0,
24/05/2013 10:18,2012,2011,B,Other Reporting Airports,MANCHESTER,CITY OF DERRY (EGLINTON),0,0,0,8353,8353,0,
24/05/2013 10:18,2012,2011,B,Other Reporting Airports,MANCHESTER,EDINBURGH,107718,107718,0,119480,119480,0,-9.844325066
24/05/2013 10:18,2012,2011,B,Other Reporting Airports,MANCHESTER,EXETER,63557,63557,0,41701,41701,0,52.41121292
24/05/2013 10:18,2012,2011,B,Other Reporting Airports,MANCHESTER,FARNBOROUGH,491,0,491,222,0,222,121.1711731
24/05/2013 10:18,2012,2011,B,Other Reporting Airports,MANCHESTER,FILTON,91,0,91,28,0,28,225
24/05/2013 10:18,2012,2011,B,Other Reporting Airports,MANCHESTER,GATWICK,193274,192811,463,231702,231253,449,-16.58509636
24/05/2013 10:18,2012,2011,B,Other Reporting Airports,MANCHESTER,GLASGOW,49606,49482,124,49403,49403,0,0.410906225
24/05/2013 10:18,2012,2011,B,Other Reporting Airports,MANCHESTER,GUERNSEY,62904,62904,0,65764,65764,0,-4.348884106
24/05/2013 10:18,2012,2011,B,Other Reporting Airports,MANCHESTER,HAWARDEN,24,0,24,0,0,0,
24/05/2013 10:18,2012,2011,B,Other Reporting Airports,MANCHESTER,HEATHROW,788817,788649,168,761658,761513,145,3.565773726
24/05/2013 10:18,2012,2011,B,Other Reporting Airports,MANCHESTER,INVERNESS,50933,50933,0,48811,48811,0,4.347380638
24/05/2013 10:18,2012,2011,B,Other Reporting Airports,MANCHESTER,ISLE OF MAN,124321,124321,0,123248,123248,0,0.870602369
24/05/2013 10:18,2012,2011,B,Other Reporting Airports,MANCHESTER,JERSEY,57155,57155,0,79905,79905,0,-28.47130966
24/05/2013 10:18,2012,2011,B,Other Reporting Airports,MANCHESTER,LEEDS BRADFORD,580,580,0,92,92,0,530.4347534
24/05/2013 10:18,2012,2011,B,Other Reporting Airports,MANCHESTER,LUTON,192,0,192,183,0,183,4.918032646
24/05/2013 10:18,2012,2011,B,Other Reporting Airports,MANCHESTER,MANSTON (KENT INT),0,0,0,1862,1762,100,
24/05/2013 10:18,2012,2011,B,Other Reporting Airports,MANCHESTER,NEWCASTLE,540,0,540,228,0,228,136.8421021
24/05/2013 10:18,2012,2011,B,Other Reporting Airports,MANCHESTER,NEWQUAY,31136,31136,0,38111,38111,0,-18.30180168
24/05/2013 10:18,2012,2011,B,Other Reporting Airports,MANCHESTER,NORWICH,28778,28499,279,26480,26321,159,8.678247452
24/05/2013 10:18,2012,2011,B,Other Reporting Airports,MANCHESTER,PLYMOUTH,0,0,0,7649,7649,0,
24/05/2013 10:18,2012,2011,B,Other Reporting Airports,MANCHESTER,SOUTHAMPTON,114719,114608,111,114254,114254,0,0.406987935
24/05/2013 10:18,2012,2011,B,Other Reporting Airports,MANCHESTER,STANSTED,270,0,270,0,0,0,
24/05/2013 10:18,2012,2011,B,Other Reporting Airports,MANCHESTER,STORNOWAY,77,0,77,154,0,154,-50
24/05/2013 10:18,2012,2011,B,Other Reporting Airports,MANSTON (KENT INT),BELFAST CITY (GEORGE BEST),0,0,0,4481,4481,0,
24/05/2013 10:18,2012,2011,B,Other Reporting Airports,MANSTON (KENT INT),EDINBURGH,3344,3344,0,26197,26197,0,-87.23517609
24/05/2013 10:18,2012,2011,B,Other Reporting Airports,MANSTON (KENT INT),INVERNESS,0,0,0,50,0,50,
24/05/2013 10:18,2012,2011,B,Other Reporting Airports,MANSTON (KENT INT),JERSEY,1359,180,1179,1502,0,1502,-9.52063942
24/05/2013 10:18,2012,2011,B,Other Reporting Airports,MANSTON (KENT INT),MANCHESTER,0,0,0,1832,1732,100,
24/05/2013 10:18,2012,2011,B,Other Reporting Airports,MANSTON (KENT INT),NEWQUAY,70,0,70,0,0,0,
24/05/2013 10:18,2012,2011,B,Other Reporting Airports,MANSTON (KENT INT),OXFORD (KIDLINGTON),0,0,0,34,0,34,
24/05/2013 10:18,2012,2011,B,Other Reporting Airports,NEWCASTLE,ABERDEEN,36300,36240,60,33971,33933,38,6.855847836
24/05/2013 10:18,2012,2011,B,Other Reporting Airports,NEWCASTLE,BELFAST CITY (GEORGE BEST),39185,39185,0,41232,41232,0,-4.964590549
24/05/2013 10:18,2012,2011,B,Other Reporting Airports,NEWCASTLE,BELFAST INTERNATIONAL,191844,191844,0,179319,179319,0,6.984758854
24/05/2013 10:18,2012,2011,B,Other Reporting Airports,NEWCASTLE,BIRMINGHAM,10925,10593,332,12737,12598,139,-14.22626972
24/05/2013 10:18,2012,2011,B,Other Reporting Airports,NEWCASTLE,BOURNEMOUTH,102,0,102,0,0,0,
24/05/2013 10:18,2012,2011,B,Other Reporting Airports,NEWCASTLE,BRISTOL,170375,170366,9,167340,167034,306,1.813672781
24/05/2013 10:18,2012,2011,B,Other Reporting Airports,NEWCASTLE,CARDIFF WALES,13214,12938,276,14935,14719,216,-11.52326775
24/05/2013 10:18,2012,2011,B,Other Reporting Airports,NEWCASTLE,EAST MIDLANDS INTERNATIONAL,40,0,40,0,0,0,
24/05/2013 10:18,2012,2011,B,Other Reporting Airports,NEWCASTLE,EXETER,29494,29494,0,24420,24420,0,20.77805138
24/05/2013 10:18,2012,2011,B,Other Reporting Airports,NEWCASTLE,FARNBOROUGH,337,0,337,208,0,208,62.01922989
24/05/2013 10:18,2012,2011,B,Other Reporting Airports,NEWCASTLE,GATWICK,84053,84013,40,94599,94416,183,-11.14810944
24/05/2013 10:18,2012,2011,B,Other Reporting Airports,NEWCASTLE,HEATHROW,487404,487169,235,471522,471522,0,3.368241549
24/05/2013 10:18,2012,2011,B,Other Reporting Airports,NEWCASTLE,ISLE OF MAN,5440,5440,0,5120,5120,0,6.25
24/05/2013 10:18,2012,2011,B,Other Reporting Airports,NEWCASTLE,JERSEY,12255,11959,296,14230,14230,0,-13.87912846
24/05/2013 10:18,2012,2011,B,Other Reporting Airports,NEWCASTLE,LIVERPOOL (JOHN LENNON),257,0,257,138,0,138,86.23188782
24/05/2013 10:18,2012,2011,B,Other Reporting Airports,NEWCASTLE,LONDON CITY,73,0,73,92,0,92,-20.652174
24/05/2013 10:18,2012,2011,B,Other Reporting Airports,NEWCASTLE,LUTON,625,0,625,103,0,103,506.7961121
24/05/2013 10:18,2012,2011,B,Other Reporting Airports,NEWCASTLE,MANCHESTER,873,0,873,134,0,134,551.4925537
24/05/2013 10:18,2012,2011,B,Other Reporting Airports,NEWCASTLE,NEWQUAY,2590,2590,0,841,841,0,207.9667053
24/05/2013 10:18,2012,2011,B,Other Reporting Airports,NEWCASTLE,NORWICH,215,0,215,0,0,0,
24/05/2013 10:18,2012,2011,B,Other Reporting Airports,NEWCASTLE,PLYMOUTH,0,0,0,227,227,0,
24/05/2013 10:18,2012,2011,B,Other Reporting Airports,NEWCASTLE,SOUTHAMPTON,87044,86851,193,91471,91471,0,-4.839785099
24/05/2013 10:18,2012,2011,B,Other Reporting Airports,NEWCASTLE,STANSTED,210,0,210,28040,28040,0,-99.25106812
24/05/2013 10:18,2012,2011,B,Other Reporting Airports,NEWCASTLE,WARTON,40,0,40,0,0,0,
24/05/2013 10:18,2012,2011,B,Other Reporting Airports,NEWQUAY,ABERDEEN,0,0,0,1562,1562,0,
24/05/2013 10:18,2012,2011,B,Other Reporting Airports,NEWQUAY,BELFAST CITY (GEORGE BEST),1832,1832,0,0,0,0,
24/05/2013 10:18,2012,2011,B,Other Reporting Airports,NEWQUAY,BRISTOL,0,0,0,2555,2555,0,
24/05/2013 10:18,2012,2011,B,Other Reporting Airports,NEWQUAY,CARDIFF WALES,0,0,0,353,334,19,
24/05/2013 10:18,2012,2011,B,Other Reporting Airports,NEWQUAY,EAST MIDLANDS INTERNATIONAL,899,899,0,6131,6131,0,-85.33681488
24/05/2013 10:18,2012,2011,B,Other Reporting Airports,NEWQUAY,EDINBURGH,9806,9806,0,13677,13677,0,-28.30298996
24/05/2013 10:18,2012,2011,B,Other Reporting Airports,NEWQUAY,GATWICK,95244,95244,0,100379,100379,0,-5.11561203
24/05/2013 10:18,2012,2011,B,Other Reporting Airports,NEWQUAY,GLASGOW,3532,3532,0,7632,7632,0,-53.72117233
24/05/2013 10:18,2012,2011,B,Other Reporting Airports,NEWQUAY,GUERNSEY,0,0,0,709,709,0,
24/05/2013 10:18,2012,2011,B,Other Reporting Airports,NEWQUAY,ISLES OF SCILLY (ST.MARYS),14197,14197,0,16157,16157,0,-12.13096523
24/05/2013 10:18,2012,2011,B,Other Reporting Airports,NEWQUAY,JERSEY,0,0,0,1459,1459,0,
24/05/2013 10:18,2012,2011,B,Other Reporting Airports,NEWQUAY,LANDS END (ST JUST),3,3,0,0,0,0,
24/05/2013 10:18,2012,2011,B,Other Reporting Airports,NEWQUAY,LEEDS BRADFORD,0,0,0,4501,4501,0,
24/05/2013 10:18,2012,2011,B,Other Reporting Airports,NEWQUAY,MANCHESTER,31214,31214,0,38931,38931,0,-19.82225037
24/05/2013 10:18,2012,2011,B,Other Reporting Airports,NEWQUAY,NEWCASTLE,2675,2675,0,1730,1730,0,54.62427902
24/05/2013 10:18,2012,2011,B,Other Reporting Airports,NEWQUAY,NORWICH,2706,2706,0,0,0,0,
24/05/2013 10:18,2012,2011,B,Other Reporting Airports,NEWQUAY,PLYMOUTH,0,0,0,176,176,0,
24/05/2013 10:18,2012,2011,B,Other Reporting Airports,NORWICH,ABERDEEN,62792,62792,0,60201,60201,0,4.303915024
24/05/2013 10:18,2012,2011,B,Other Reporting Airports,NORWICH,BLACKPOOL,62,0,62,0,0,0,
24/05/2013 10:18,2012,2011,B,Other Reporting Airports,NORWICH,CARDIFF WALES,135,0,135,187,0,187,-27.80748749
24/05/2013 10:18,2012,2011,B,Other Reporting Airports,NORWICH,EDINBURGH,39504,39504,0,46160,46160,0,-14.41941071
24/05/2013 10:18,2012,2011,B,Other Reporting Airports,NORWICH,EXETER,7081,7081,0,0,0,0,
24/05/2013 10:18,2012,2011,B,Other Reporting Airports,NORWICH,FARNBOROUGH,0,0,0,37,0,37,
24/05/2013 10:18,2012,2011,B,Other Reporting Airports,NORWICH,GATWICK,32,0,32,33,0,33,-3.030303001
24/05/2013 10:18,2012,2011,B,Other Reporting Airports,NORWICH,GUERNSEY,1617,1617,0,1536,1536,0,5.2734375
24/05/2013 10:18,2012,2011,B,Other Reporting Airports,NORWICH,HUMBERSIDE,58,49,9,0,0,0,
24/05/2013 10:18,2012,2011,B,Other Reporting Airports,NORWICH,ISLE OF MAN,1082,1082,0,0,0,0,
24/05/2013 10:18,2012,2011,B,Other Reporting Airports,NORWICH,JERSEY,5000,5000,0,4909,4909,0,1.85373807
24/05/2013 10:18,2012,2011,B,Other Reporting Airports,NORWICH,LIVERPOOL (JOHN LENNON),241,0,241,89,0,89,170.7865143
24/05/2013 10:18,2012,2011,B,Other Reporting Airports,NORWICH,LUTON,69,0,69,52,0,52,32.69230652
24/05/2013 10:18,2012,2011,B,Other Reporting Airports,NORWICH,MANCHESTER,28731,28368,363,26085,25887,198,10.14376068
24/05/2013 10:18,2012,2011,B,Other Reporting Airports,NORWICH,NEWCASTLE,225,0,225,0,0,0,
24/05/2013 10:18,2012,2011,B,Other Reporting Airports,NORWICH,NEWQUAY,2721,2721,0,0,0,0,
24/05/2013 10:18,2012,2011,B,Other Reporting Airports,NORWICH,SOUTHAMPTON,79,0,79,0,0,0,
24/05/2013 10:18,2012,2011,B,Other Reporting Airports,OXFORD (KIDLINGTON),ABERDEEN,0,0,0,23,0,23,
24/05/2013 10:18,2012,2011,B,Other Reporting Airports,OXFORD (KIDLINGTON),BIGGIN HILL,0,0,0,5,0,5,
24/05/2013 10:18,2012,2011,B,Other Reporting Airports,OXFORD (KIDLINGTON),GUERNSEY,26,26,0,0,0,0,
24/05/2013 10:18,2012,2011,B,Other Reporting Airports,OXFORD (KIDLINGTON),ISLE OF MAN,2974,2974,0,0,0,0,
24/05/2013 10:18,2012,2011,B,Other Reporting Airports,OXFORD (KIDLINGTON),JERSEY,3252,3252,0,1241,0,1241,162.0467377
24/05/2013 10:18,2012,2011,B,Other Reporting Airports,PRESTWICK,CITY OF DERRY (EGLINTON),72970,72970,0,70971,70971,0,2.816643476
24/05/2013 10:18,2012,2011,B,Other Reporting Airports,PRESTWICK,HEATHROW,0,0,0,306,0,306,
24/05/2013 10:18,2012,2011,B,Other Reporting Airports,PRESTWICK,STANSTED,0,0,0,88571,88571,0,
24/05/2013 10:18,2012,2011,B,Other Reporting Airports,SCATSTA,ABERDEEN,164747,0,164747,153148,46,153102,7.573719501
24/05/2013 10:18,2012,2011,B,Other Reporting Airports,SCATSTA,TURWESTON,34,0,34,0,0,0,
24/05/2013 10:18,2012,2011,B,Other Reporting Airports,SCATSTA,WOODVALE,28,0,28,0,0,0,
24/05/2013 10:18,2012,2011,B,Other Reporting Airports,SOUTHAMPTON,ABERDEEN,14087,14082,5,20735,20735,0,-32.06173325
24/05/2013 10:18,2012,2011,B,Other Reporting Airports,SOUTHAMPTON,ALDERNEY,24378,24378,0,26769,26769,0,-8.931973457
24/05/2013 10:18,2012,2011,B,Other Reporting Airports,SOUTHAMPTON,BELFAST CITY (GEORGE BEST),84942,84942,0,86252,86252,0,-1.518805385
24/05/2013 10:18,2012,2011,B,Other Reporting Airports,SOUTHAMPTON,DURHAM TEES VALLEY,145,85,60,10466,10466,0,-98.61456299
24/05/2013 10:18,2012,2011,B,Other Reporting Airports,SOUTHAMPTON,EDINBURGH,203631,203631,0,202321,202321,0,0.647485912
24/05/2013 10:18,2012,2011,B,Other Reporting Airports,SOUTHAMPTON,GLASGOW,173781,173682,99,164851,164749,102,5.417013168
24/05/2013 10:18,2012,2011,B,Other Reporting Airports,SOUTHAMPTON,GUERNSEY,132296,132225,71,132936,132895,41,-0.481434673
24/05/2013 10:18,2012,2011,B,Other Reporting Airports,SOUTHAMPTON,HUMBERSIDE,103,0,103,40,0,40,157.5
24/05/2013 10:18,2012,2011,B,Other Reporting Airports,SOUTHAMPTON,INVERNESS,1839,1839,0,2120,2120,0,-13.25471687
24/05/2013 10:18,2012,2011,B,Other Reporting Airports,SOUTHAMPTON,ISLE OF MAN,1868,1868,0,14211,14211,0,-86.85525513
24/05/2013 10:18,2012,2011,B,Other Reporting Airports,SOUTHAMPTON,ISLES OF SCILLY (ST.MARYS),2973,2973,0,2957,2957,0,0.541088939
24/05/2013 10:18,2012,2011,B,Other Reporting Airports,SOUTHAMPTON,JERSEY,148109,148037,72,153196,153196,0,-3.320582867
24/05/2013 10:18,2012,2011,B,Other Reporting Airports,SOUTHAMPTON,LEEDS BRADFORD,65673,65598,75,59937,59908,29,9.570048332
24/05/2013 10:18,2012,2011,B,Other Reporting Airports,SOUTHAMPTON,LIVERPOOL (JOHN LENNON),100,0,100,0,0,0,
24/05/2013 10:18,2012,2011,B,Other Reporting Airports,SOUTHAMPTON,MANCHESTER,115061,114953,108,114263,114193,70,0.698388815
24/05/2013 10:18,2012,2011,B,Other Reporting Airports,SOUTHAMPTON,NEWCASTLE,87746,87514,232,91572,91572,0,-4.178133011
24/05/2013 10:18,2012,2011,B,Other Reporting Airports,SOUTHAMPTON,NORWICH,116,0,116,0,0,0,
24/05/2013 10:18,2012,2011,B,Other Reporting Airports,SOUTHAMPTON,STORNOWAY,0,0,0,144,0,144,
24/05/2013 10:18,2012,2011,B,Other Reporting Airports,STORNOWAY,ABERDEEN,5452,5452,0,5891,5891,0,-7.452045441
24/05/2013 10:18,2012,2011,B,Other Reporting Airports,STORNOWAY,BENBECULA,7041,7041,0,7258,7258,0,-2.989804268
24/05/2013 10:18,2012,2011,B,Other Reporting Airports,STORNOWAY,BIRMINGHAM,178,0,178,0,0,0,
24/05/2013 10:18,2012,2011,B,Other Reporting Airports,STORNOWAY,EDINBURGH,16204,16204,0,17769,17769,0,-8.807474136
24/05/2013 10:18,2012,2011,B,Other Reporting Airports,STORNOWAY,GLASGOW,52043,52043,0,54823,54823,0,-5.070864201
24/05/2013 10:18,2012,2011,B,Other Reporting Airports,STORNOWAY,INVERNESS,34885,34885,0,36207,36207,0,-3.651227713
24/05/2013 10:18,2012,2011,B,Other Reporting Airports,STORNOWAY,ISLAY,0,0,0,179,179,0,
24/05/2013 10:18,2012,2011,B,Other Reporting Airports,STORNOWAY,MANCHESTER,77,0,77,153,0,153,-49.67320251
24/05/2013 10:18,2012,2011,B,Other Reporting Airports,STORNOWAY,SOUTHAMPTON,0,0,0,144,0,144,
24/05/2013 10:18,2012,2011,B,Other Reporting Airports,SUMBURGH,ABERDEEN,71286,63663,7623,66294,60831,5463,7.530093193
24/05/2013 10:18,2012,2011,B,Other Reporting Airports,SUMBURGH,DUNDEE,31,31,0,0,0,0,
24/05/2013 10:18,2012,2011,B,Other Reporting Airports,SUMBURGH,EDINBURGH,35751,35751,0,33619,33619,0,6.341651917
24/05/2013 10:18,2012,2011,B,Other Reporting Airports,SUMBURGH,FAIR ISLE,103,103,0,106,106,0,-2.830188751
24/05/2013 10:18,2012,2011,B,Other Reporting Airports,SUMBURGH,GLASGOW,16647,16647,0,16858,16858,0,-1.25163126
24/05/2013 10:18,2012,2011,B,Other Reporting Airports,SUMBURGH,INVERNESS,3960,3960,0,1435,1435,0,175.9581909
24/05/2013 10:18,2012,2011,B,Other Reporting Airports,SUMBURGH,KIRKWALL,14971,14962,9,19593,19593,0,-23.59005737
24/05/2013 10:18,2012,2011,B,Other Reporting Airports,SUMBURGH,LERWICK (TINGWALL),7,7,0,0,0,0,
24/05/2013 10:18,2012,2011,B,Other Reporting Airports,SUMBURGH,SCATSTA,2,0,2,31,0,31,-93.54838562
24/05/2013 10:18,2012,2011,B,Other Reporting Airports,TIREE,CAMPBELTOWN,0,0,0,17,17,0,
24/05/2013 10:18,2012,2011,B,Other Reporting Airports,TIREE,GLASGOW,6204,6204,0,7477,7477,0,-17.02554512
24/05/2013 10:18,2012,2011,B,Other Reporting Airports,WICK JOHN O GROATS,ABERDEEN,14044,12973,1071,14050,14050,0,-0.042704627
24/05/2013 10:18,2012,2011,B,Other Reporting Airports,WICK JOHN O GROATS,EDINBURGH,9306,9306,0,9111,9111,0,2.140269995
24/05/2013 10:18,2012,2011,B,Other Reporting Airports,WICK JOHN O GROATS,FARNBOROUGH,0,0,0,67,0,67,
24/05/2013 10:18,2012,2011,B,Other Reporting Airports,WICK JOHN O GROATS,LONDON CITY,0,0,0,55,0,55,
24/05/2013 10:18,2012,2011,B,Other Reporting Airports,WICK JOHN O GROATS,LUTON,0,0,0,60,0,60,
24/05/2013 10:18,2012,2011,B,Other Reporting Airports,WICK JOHN O GROATS,SOUTH MARSTON,0,0,0,43,0,43,
24/05/2013 10:18,2012,2011,B,Other Reporting Airports,WICK JOHN O GROATS,STANSTED,0,0,0,79,0,79,
