rundate,this_period,last_period,grp_cd,grp_name,apt1_apt_name,apt2_apt_name,total_pax_tp,total_pax_shd_tp,total_pax_cht_tp,total_pax_lp,total_pax_shd_lp,total_pax_cht_lp,total_pax_pc
10/10/2008 12:01,1993,1992,A,London Area Airports,GATWICK,ABERDEEN,202289,202289,0,159811,159811,0,26.5801487
10/10/2008 12:01,1993,1992,A,London Area Airports,GATWICK,BELFAST CITY (GEORGE BEST),121007,121007,0,0,0,0,
10/10/2008 12:01,1993,1992,A,London Area Airports,GATWICK,BELFAST INTERNATIONAL,1964,1692,272,1914,1438,476,2.612330198
10/10/2008 12:01,1993,1992,A,London Area Airports,GATWICK,BIRMINGHAM,88,0,88,0,0,0,
10/10/2008 12:01,1993,1992,A,London Area Airports,GATWICK,BOURNEMOUTH,15,0,15,13,0,13,15.38461494
10/10/2008 12:01,1993,1992,A,London Area Airports,GATWICK,CARDIFF WALES,220,0,220,802,0,802,-72.56858063
10/10/2008 12:01,1993,1992,A,London Area Airports,GATWICK,CITY OF DERRY (EGLINTON),223,0,223,0,0,0,
10/10/2008 12:01,1993,1992,A,London Area Airports,GATWICK,DURHAM TEES VALLEY,220,0,220,0,0,0,
10/10/2008 12:01,1993,1992,A,London Area Airports,GATWICK,EAST MIDLANDS INTERNATIONAL,2,0,2,0,0,0,
10/10/2008 12:01,1993,1992,A,London Area Airports,GATWICK,EDINBURGH,189871,189664,207,173019,172970,49,9.739971161
10/10/2008 12:01,1993,1992,A,London Area Airports,GATWICK,GLASGOW,175984,175141,843,167441,167435,6,5.102095604
10/10/2008 12:01,1993,1992,A,London Area Airports,GATWICK,GUERNSEY,175218,175215,3,153383,153278,105,14.23560619
10/10/2008 12:01,1993,1992,A,London Area Airports,GATWICK,HUMBERSIDE,0,0,0,198,0,198,
10/10/2008 12:01,1993,1992,A,London Area Airports,GATWICK,ISLE OF MAN,473,0,473,33,0,33,1333.333374
10/10/2008 12:01,1993,1992,A,London Area Airports,GATWICK,JERSEY,249195,244752,4443,238967,235985,2982,4.280088902
10/10/2008 12:01,1993,1992,A,London Area Airports,GATWICK,LEEDS BRADFORD,2987,2949,38,0,0,0,
10/10/2008 12:01,1993,1992,A,London Area Airports,GATWICK,LIVERPOOL,29,0,29,0,0,0,
10/10/2008 12:01,1993,1992,A,London Area Airports,GATWICK,LUTON,0,0,0,11,0,11,
10/10/2008 12:01,1993,1992,A,London Area Airports,GATWICK,LYDD,2,0,2,0,0,0,
10/10/2008 12:01,1993,1992,A,London Area Airports,GATWICK,MANCHESTER,212946,212173,773,186951,185691,1260,13.90471268
10/10/2008 12:01,1993,1992,A,London Area Airports,GATWICK,NEWCASTLE,64292,64156,136,66074,65851,223,-2.696976185
10/10/2008 12:01,1993,1992,A,London Area Airports,GATWICK,PLYMOUTH,0,0,0,38,0,38,
10/10/2008 12:01,1993,1992,A,London Area Airports,GATWICK,SOUTHEND,0,0,0,1,0,1,
10/10/2008 12:01,1993,1992,A,London Area Airports,GATWICK,STANSTED,6,0,6,52,0,52,-88.46154022
10/10/2008 12:01,1993,1992,A,London Area Airports,HEATHROW,ABERDEEN,469604,469553,51,463438,463423,15,1.330490828
10/10/2008 12:01,1993,1992,A,London Area Airports,HEATHROW,BELFAST CITY (GEORGE BEST),13763,13763,0,0,0,0,
10/10/2008 12:01,1993,1992,A,London Area Airports,HEATHROW,BELFAST INTERNATIONAL,1119614,1119551,63,1173780,1173767,13,-4.614663601
10/10/2008 12:01,1993,1992,A,London Area Airports,HEATHROW,BIRMINGHAM,70810,70335,475,63609,62944,665,11.32072544
10/10/2008 12:01,1993,1992,A,London Area Airports,HEATHROW,CAMBRIDGE,40,0,40,0,0,0,
10/10/2008 12:01,1993,1992,A,London Area Airports,HEATHROW,CARDIFF WALES,201,0,201,201,0,201,0
10/10/2008 12:01,1993,1992,A,London Area Airports,HEATHROW,DURHAM TEES VALLEY,162322,162322,0,172527,172514,13,-5.915016174
10/10/2008 12:01,1993,1992,A,London Area Airports,HEATHROW,EAST MIDLANDS INTERNATIONAL,259,59,200,56875,56201,674,-99.5446167
10/10/2008 12:01,1993,1992,A,London Area Airports,HEATHROW,EDINBURGH,1375202,1375202,0,1307585,1307585,0,5.171135902
10/10/2008 12:01,1993,1992,A,London Area Airports,HEATHROW,GLASGOW,1328511,1328346,165,1301662,1301468,194,2.062670708
10/10/2008 12:01,1993,1992,A,London Area Airports,HEATHROW,GUERNSEY,79255,79255,0,75975,75966,9,4.317209721
10/10/2008 12:01,1993,1992,A,London Area Airports,HEATHROW,HUMBERSIDE,200,0,200,201,0,201,-0.49751243
10/10/2008 12:01,1993,1992,A,London Area Airports,HEATHROW,INVERNESS,169435,169435,0,151914,151861,53,11.53349876
10/10/2008 12:01,1993,1992,A,London Area Airports,HEATHROW,ISLE OF MAN,109269,109231,38,103257,103188,69,5.822365761
10/10/2008 12:01,1993,1992,A,London Area Airports,HEATHROW,JERSEY,281371,280786,585,264352,264027,325,6.438006878
10/10/2008 12:01,1993,1992,A,London Area Airports,HEATHROW,KENT INTERNATIONAL,400,0,400,401,0,401,-0.249376565
10/10/2008 12:01,1993,1992,A,London Area Airports,HEATHROW,LEEDS BRADFORD,178574,177875,699,187936,187106,830,-4.981482983
10/10/2008 12:01,1993,1992,A,London Area Airports,HEATHROW,LEUCHARS,132,0,132,101,0,101,30.69306946
10/10/2008 12:01,1993,1992,A,London Area Airports,HEATHROW,LIVERPOOL,237,0,237,18014,17701,313,-98.68435669
10/10/2008 12:01,1993,1992,A,London Area Airports,HEATHROW,MANCHESTER,928374,927348,1026,915860,914845,1015,1.366366029
10/10/2008 12:01,1993,1992,A,London Area Airports,HEATHROW,NEWCASTLE,389403,389403,0,377181,377157,24,3.240354061
10/10/2008 12:01,1993,1992,A,London Area Airports,HEATHROW,NEWQUAY,30304,30304,0,32140,32140,0,-5.712507725
10/10/2008 12:01,1993,1992,A,London Area Airports,HEATHROW,PLYMOUTH,44330,44310,20,40821,40754,67,8.596065521
10/10/2008 12:01,1993,1992,A,London Area Airports,HEATHROW,STANSTED,0,0,0,354,0,354,
10/10/2008 12:01,1993,1992,A,London Area Airports,HEATHROW,WICK,52,0,52,0,0,0,
10/10/2008 12:01,1993,1992,A,London Area Airports,LONDON CITY,JERSEY,0,0,0,2595,341,2254,
10/10/2008 12:01,1993,1992,A,London Area Airports,LONDON CITY,LIVERPOOL,33,0,33,0,0,0,
10/10/2008 12:01,1993,1992,A,London Area Airports,LONDON CITY,NEWCASTLE,0,0,0,92,0,92,
10/10/2008 12:01,1993,1992,A,London Area Airports,LUTON,BELFAST CITY (GEORGE BEST),35737,35619,118,4561,4561,0,683.5343018
10/10/2008 12:01,1993,1992,A,London Area Airports,LUTON,BELFAST INTERNATIONAL,121833,121801,32,150384,149538,846,-18.98539734
10/10/2008 12:01,1993,1992,A,London Area Airports,LUTON,CAMBRIDGE,2,0,2,15,0,15,-86.66666412
10/10/2008 12:01,1993,1992,A,London Area Airports,LUTON,EDINBURGH,0,0,0,424,0,424,
10/10/2008 12:01,1993,1992,A,London Area Airports,LUTON,EXETER,0,0,0,8,0,8,
10/10/2008 12:01,1993,1992,A,London Area Airports,LUTON,GLASGOW,96,0,96,0,0,0,
10/10/2008 12:01,1993,1992,A,London Area Airports,LUTON,ISLE OF MAN,16337,16337,0,14911,14911,0,9.563409805
10/10/2008 12:01,1993,1992,A,London Area Airports,LUTON,JERSEY,11681,10431,1250,15694,12613,3081,-25.57028198
10/10/2008 12:01,1993,1992,A,London Area Airports,LUTON,LIVERPOOL,1,0,1,2,1,1,-50
10/10/2008 12:01,1993,1992,A,London Area Airports,LUTON,MANCHESTER,40,0,40,114,0,114,-64.91227722
10/10/2008 12:01,1993,1992,A,London Area Airports,LUTON,NEWCASTLE,196,0,196,2,0,2,9700
10/10/2008 12:01,1993,1992,A,London Area Airports,LUTON,SOUTHAMPTON,4,0,4,9,0,9,-55.55555725
10/10/2008 12:01,1993,1992,A,London Area Airports,LUTON,SOUTHEND,0,0,0,2,0,2,
10/10/2008 12:01,1993,1992,A,London Area Airports,LUTON,STANSTED,129,0,129,0,0,0,
10/10/2008 12:01,1993,1992,A,London Area Airports,SOUTHEND,CRANFIELD,49,0,49,0,0,0,
10/10/2008 12:01,1993,1992,A,London Area Airports,SOUTHEND,DUXFORD,52,0,52,0,0,0,
10/10/2008 12:01,1993,1992,A,London Area Airports,SOUTHEND,GLASGOW,0,0,0,90,0,90,
10/10/2008 12:01,1993,1992,A,London Area Airports,SOUTHEND,JERSEY,9120,0,9120,9762,0,9762,-6.576521397
10/10/2008 12:01,1993,1992,A,London Area Airports,SOUTHEND,LIVERPOOL,0,0,0,160,0,160,
10/10/2008 12:01,1993,1992,A,London Area Airports,SOUTHEND,MANCHESTER,18,0,18,0,0,0,
10/10/2008 12:01,1993,1992,A,London Area Airports,SOUTHEND,NEWCASTLE,66,0,66,78,0,78,-15.38461494
10/10/2008 12:01,1993,1992,A,London Area Airports,STANSTED,ABERDEEN,72473,71711,762,68736,68736,0,5.436743259
10/10/2008 12:01,1993,1992,A,London Area Airports,STANSTED,BELFAST INTERNATIONAL,5,0,5,259,0,259,-98.06949615
10/10/2008 12:01,1993,1992,A,London Area Airports,STANSTED,BIRMINGHAM,109,0,109,2,0,2,5350
10/10/2008 12:01,1993,1992,A,London Area Airports,STANSTED,BRISTOL,0,0,0,124,0,124,
10/10/2008 12:01,1993,1992,A,London Area Airports,STANSTED,CAMBRIDGE,14,0,14,0,0,0,
10/10/2008 12:01,1993,1992,A,London Area Airports,STANSTED,CITY OF DERRY (EGLINTON),0,0,0,22,0,22,
10/10/2008 12:01,1993,1992,A,London Area Airports,STANSTED,DUNDEE,0,0,0,142,0,142,
10/10/2008 12:01,1993,1992,A,London Area Airports,STANSTED,DURHAM TEES VALLEY,63,0,63,25,0,25,152
10/10/2008 12:01,1993,1992,A,London Area Airports,STANSTED,EAST MIDLANDS INTERNATIONAL,25,0,25,49,0,49,-48.97959137
10/10/2008 12:01,1993,1992,A,London Area Airports,STANSTED,EDINBURGH,54099,54062,37,33653,33653,0,60.75535583
10/10/2008 12:01,1993,1992,A,London Area Airports,STANSTED,EXETER,0,0,0,33,0,33,
10/10/2008 12:01,1993,1992,A,London Area Airports,STANSTED,FILTON,0,0,0,2,0,2,
10/10/2008 12:01,1993,1992,A,London Area Airports,STANSTED,GLASGOW,115564,115564,0,105450,105396,54,9.591275215
10/10/2008 12:01,1993,1992,A,London Area Airports,STANSTED,GLOUCESTERSHIRE,0,0,0,5,0,5,
10/10/2008 12:01,1993,1992,A,London Area Airports,STANSTED,GUERNSEY,20030,19950,80,28485,28351,134,-29.68228912
10/10/2008 12:01,1993,1992,A,London Area Airports,STANSTED,HUMBERSIDE,74,0,74,0,0,0,
10/10/2008 12:01,1993,1992,A,London Area Airports,STANSTED,ISLE OF MAN,269,0,269,0,0,0,
10/10/2008 12:01,1993,1992,A,London Area Airports,STANSTED,JERSEY,39648,37898,1750,38866,38027,839,2.01204133
10/10/2008 12:01,1993,1992,A,London Area Airports,STANSTED,LEEDS BRADFORD,48,0,48,0,0,0,
10/10/2008 12:01,1993,1992,A,London Area Airports,STANSTED,LIVERPOOL,138,0,138,3,0,3,4500
10/10/2008 12:01,1993,1992,A,London Area Airports,STANSTED,MANCHESTER,9828,9646,182,58,0,58,16844.82813
10/10/2008 12:01,1993,1992,A,London Area Airports,STANSTED,NEWCASTLE,22220,21664,556,129,0,129,17124.80664
10/10/2008 12:01,1993,1992,A,London Area Airports,STANSTED,NORWICH,0,0,0,3,0,3,
10/10/2008 12:01,1993,1992,A,London Area Airports,STANSTED,SOUTHAMPTON,137,84,53,0,0,0,
10/10/2008 12:01,1993,1992,A,London Area Airports,STANSTED,STORNOWAY,0,0,0,139,0,139,
10/10/2008 12:01,1993,1992,A,London Area Airports,STANSTED,SUMBURGH,186,0,186,0,0,0,
10/10/2008 12:01,1993,1992,B,Other UK Airports,ABERDEEN,ABERDEEN,33,0,33,0,0,0,
10/10/2008 12:01,1993,1992,B,Other UK Airports,ABERDEEN,BELFAST CITY (GEORGE BEST),1094,1094,0,3042,3018,24,-64.03681946
10/10/2008 12:01,1993,1992,B,Other UK Airports,ABERDEEN,BELFAST INTERNATIONAL,2912,2912,0,0,0,0,
10/10/2008 12:01,1993,1992,B,Other UK Airports,ABERDEEN,BENBECULA,12,0,12,48,0,48,-75
10/10/2008 12:01,1993,1992,B,Other UK Airports,ABERDEEN,BIRMINGHAM,42684,42567,117,38712,38642,70,10.26038456
10/10/2008 12:01,1993,1992,B,Other UK Airports,ABERDEEN,BRISTOL,9573,9573,0,8900,8829,71,7.561797619
10/10/2008 12:01,1993,1992,B,Other UK Airports,ABERDEEN,CARDIFF WALES,6216,6216,0,0,0,0,
10/10/2008 12:01,1993,1992,B,Other UK Airports,ABERDEEN,COVENTRY,0,0,0,64,0,64,
10/10/2008 12:01,1993,1992,B,Other UK Airports,ABERDEEN,DOUNREAY,0,0,0,21,0,21,
10/10/2008 12:01,1993,1992,B,Other UK Airports,ABERDEEN,DUNDEE,0,0,0,636,610,26,
10/10/2008 12:01,1993,1992,B,Other UK Airports,ABERDEEN,DURHAM TEES VALLEY,9193,9171,22,8360,8266,94,9.964115143
10/10/2008 12:01,1993,1992,B,Other UK Airports,ABERDEEN,EAST MIDLANDS INTERNATIONAL,22490,21997,493,9963,9698,265,125.7352219
10/10/2008 12:01,1993,1992,B,Other UK Airports,ABERDEEN,EDINBURGH,294,273,21,6660,6583,77,-95.58558655
10/10/2008 12:01,1993,1992,B,Other UK Airports,ABERDEEN,EXETER,23,0,23,0,0,0,
10/10/2008 12:01,1993,1992,B,Other UK Airports,ABERDEEN,FLOTTA,14,0,14,20,0,20,-30
10/10/2008 12:01,1993,1992,B,Other UK Airports,ABERDEEN,GLASGOW,34472,33913,559,39687,39410,277,-13.14032269
10/10/2008 12:01,1993,1992,B,Other UK Airports,ABERDEEN,HUMBERSIDE,38762,38762,0,26271,26271,0,47.54672623
10/10/2008 12:01,1993,1992,B,Other UK Airports,ABERDEEN,INVERNESS,852,795,57,434,406,28,96.31336212
10/10/2008 12:01,1993,1992,B,Other UK Airports,ABERDEEN,JERSEY,2910,0,2910,1743,0,1743,66.95352936
10/10/2008 12:01,1993,1992,B,Other UK Airports,ABERDEEN,KINLOSS,2,0,2,24,0,24,-91.66666412
10/10/2008 12:01,1993,1992,B,Other UK Airports,ABERDEEN,KIRKWALL,24676,24412,264,24769,24666,103,-0.375469327
10/10/2008 12:01,1993,1992,B,Other UK Airports,ABERDEEN,LEEDS BRADFORD,50,0,50,0,0,0,
10/10/2008 12:01,1993,1992,B,Other UK Airports,ABERDEEN,LEUCHARS,2,0,2,0,0,0,
10/10/2008 12:01,1993,1992,B,Other UK Airports,ABERDEEN,LIVERPOOL,0,0,0,2,0,2,
10/10/2008 12:01,1993,1992,B,Other UK Airports,ABERDEEN,MANCHESTER,76967,76923,44,67652,67567,85,13.76899433
10/10/2008 12:01,1993,1992,B,Other UK Airports,ABERDEEN,NEWCASTLE,35843,35685,158,28528,28367,161,25.64147568
10/10/2008 12:01,1993,1992,B,Other UK Airports,ABERDEEN,NORWICH,51737,51698,39,65248,65214,34,-20.7071476
10/10/2008 12:01,1993,1992,B,Other UK Airports,ABERDEEN,PETERHEAD,28,0,28,49,0,49,-42.8571434
10/10/2008 12:01,1993,1992,B,Other UK Airports,ABERDEEN,PLYMOUTH,0,0,0,1,0,1,
10/10/2008 12:01,1993,1992,B,Other UK Airports,ABERDEEN,PRESTWICK,37,0,37,0,0,0,
10/10/2008 12:01,1993,1992,B,Other UK Airports,ABERDEEN,SCATSTA,13067,0,13067,13705,0,13705,-4.655235291
10/10/2008 12:01,1993,1992,B,Other UK Airports,ABERDEEN,STORNOWAY,13,0,13,62,61,1,-79.03225708
10/10/2008 12:01,1993,1992,B,Other UK Airports,ABERDEEN,SUMBURGH,237841,80619,157222,231011,75498,155513,2.956569195
10/10/2008 12:01,1993,1992,B,Other UK Airports,ABERDEEN,UNST,73508,0,73508,38907,0,38907,88.93257904
10/10/2008 12:01,1993,1992,B,Other UK Airports,ABERDEEN,WICK,13137,13074,63,16304,16176,128,-19.42468071
10/10/2008 12:01,1993,1992,B,Other UK Airports,ALDERNEY,BOURNEMOUTH,0,0,0,1085,1085,0,
10/10/2008 12:01,1993,1992,B,Other UK Airports,ALDERNEY,GUERNSEY,33950,33950,0,34991,34991,0,-2.975050688
10/10/2008 12:01,1993,1992,B,Other UK Airports,ALDERNEY,JERSEY,13621,13621,0,14235,14235,0,-4.313312054
10/10/2008 12:01,1993,1992,B,Other UK Airports,ALDERNEY,SOUTHAMPTON,29055,29055,0,28011,28011,0,3.727107286
10/10/2008 12:01,1993,1992,B,Other UK Airports,ANGLESEY (VALLEY),CARDIFF WALES,0,0,0,39,0,39,
10/10/2008 12:01,1993,1992,B,Other UK Airports,BARRA,GLASGOW,8,8,0,0,0,0,
10/10/2008 12:01,1993,1992,B,Other UK Airports,BARROW-IN-FURNESS,BLACKPOOL,0,0,0,17,17,0,
10/10/2008 12:01,1993,1992,B,Other UK Airports,BARROW-IN-FURNESS,MANCHESTER,0,0,0,287,287,0,
10/10/2008 12:01,1993,1992,B,Other UK Airports,BECCLES,HUMBERSIDE,0,0,0,2,0,2,
10/10/2008 12:01,1993,1992,B,Other UK Airports,BECCLES,NORWICH,0,0,0,11,0,11,
10/10/2008 12:01,1993,1992,B,Other UK Airports,BELFAST CITY (GEORGE BEST),BELFAST CITY (GEORGE BEST),0,0,0,57,0,57,
10/10/2008 12:01,1993,1992,B,Other UK Airports,BELFAST CITY (GEORGE BEST),BIRMINGHAM,74711,74711,0,61094,61094,0,22.28860474
10/10/2008 12:01,1993,1992,B,Other UK Airports,BELFAST CITY (GEORGE BEST),BLACKPOOL,45121,45121,0,49713,49713,0,-9.237020493
10/10/2008 12:01,1993,1992,B,Other UK Airports,BELFAST CITY (GEORGE BEST),BRISTOL,35587,35587,0,32173,32173,0,10.61138248
10/10/2008 12:01,1993,1992,B,Other UK Airports,BELFAST CITY (GEORGE BEST),CARDIFF WALES,14850,14850,0,12721,12721,0,16.73610497
10/10/2008 12:01,1993,1992,B,Other UK Airports,BELFAST CITY (GEORGE BEST),DURHAM TEES VALLEY,7142,7142,0,539,539,0,1225.046387
10/10/2008 12:01,1993,1992,B,Other UK Airports,BELFAST CITY (GEORGE BEST),EAST MIDLANDS INTERNATIONAL,7452,7295,157,73,73,0,10108.21875
10/10/2008 12:01,1993,1992,B,Other UK Airports,BELFAST CITY (GEORGE BEST),EDINBURGH,64416,64416,0,64096,64096,0,0.499251127
10/10/2008 12:01,1993,1992,B,Other UK Airports,BELFAST CITY (GEORGE BEST),EXETER,8225,8225,0,14412,14412,0,-42.92950439
10/10/2008 12:01,1993,1992,B,Other UK Airports,BELFAST CITY (GEORGE BEST),GLASGOW,66379,66379,0,64828,64828,0,2.392484665
10/10/2008 12:01,1993,1992,B,Other UK Airports,BELFAST CITY (GEORGE BEST),GUERNSEY,2613,2479,134,426,426,0,513.3803101
10/10/2008 12:01,1993,1992,B,Other UK Airports,BELFAST CITY (GEORGE BEST),ISLE OF MAN,22376,22376,0,15806,15759,47,41.56649399
10/10/2008 12:01,1993,1992,B,Other UK Airports,BELFAST CITY (GEORGE BEST),JERSEY,29046,29046,0,3019,2523,496,862.1066284
10/10/2008 12:01,1993,1992,B,Other UK Airports,BELFAST CITY (GEORGE BEST),LEEDS BRADFORD,67184,67184,0,62833,62833,0,6.924705029
10/10/2008 12:01,1993,1992,B,Other UK Airports,BELFAST CITY (GEORGE BEST),LIVERPOOL,71559,71559,0,77669,77669,0,-7.866716385
10/10/2008 12:01,1993,1992,B,Other UK Airports,BELFAST CITY (GEORGE BEST),MANCHESTER,102131,102065,66,89099,89099,0,14.6264267
10/10/2008 12:01,1993,1992,B,Other UK Airports,BELFAST CITY (GEORGE BEST),NEWCASTLE,43209,43209,0,36643,36612,31,17.9188385
10/10/2008 12:01,1993,1992,B,Other UK Airports,BELFAST CITY (GEORGE BEST),SOUTHAMPTON,1295,1295,0,18246,18246,0,-92.90255737
10/10/2008 12:01,1993,1992,B,Other UK Airports,BELFAST INTERNATIONAL,BIRMINGHAM,93351,93039,312,100547,99974,573,-7.156852245
10/10/2008 12:01,1993,1992,B,Other UK Airports,BELFAST INTERNATIONAL,BLACKPOOL,15,15,0,0,0,0,
10/10/2008 12:01,1993,1992,B,Other UK Airports,BELFAST INTERNATIONAL,CARDIFF WALES,0,0,0,288,0,288,
10/10/2008 12:01,1993,1992,B,Other UK Airports,BELFAST INTERNATIONAL,COVENTRY,4,0,4,1,0,1,300
10/10/2008 12:01,1993,1992,B,Other UK Airports,BELFAST INTERNATIONAL,EAST MIDLANDS INTERNATIONAL,52936,52808,128,53337,53337,0,-0.751823306
10/10/2008 12:01,1993,1992,B,Other UK Airports,BELFAST INTERNATIONAL,EDINBURGH,90,0,90,236,0,236,-61.86440659
10/10/2008 12:01,1993,1992,B,Other UK Airports,BELFAST INTERNATIONAL,GLASGOW,61880,61753,127,64352,64230,122,-3.84137249
10/10/2008 12:01,1993,1992,B,Other UK Airports,BELFAST INTERNATIONAL,GLOUCESTERSHIRE,54,0,54,60,0,60,-10
10/10/2008 12:01,1993,1992,B,Other UK Airports,BELFAST INTERNATIONAL,HUMBERSIDE,4737,4737,0,841,841,0,463.2580261
10/10/2008 12:01,1993,1992,B,Other UK Airports,BELFAST INTERNATIONAL,JERSEY,21302,21003,299,21134,20923,211,0.794927597
10/10/2008 12:01,1993,1992,B,Other UK Airports,BELFAST INTERNATIONAL,LEEDS BRADFORD,9228,9228,0,16330,16330,0,-43.49050903
10/10/2008 12:01,1993,1992,B,Other UK Airports,BELFAST INTERNATIONAL,MANCHESTER,127846,127738,108,127190,127177,13,0.515763819
10/10/2008 12:01,1993,1992,B,Other UK Airports,BELFAST INTERNATIONAL,NEWCASTLE,951,951,0,8232,8059,173,-88.44752502
10/10/2008 12:01,1993,1992,B,Other UK Airports,BELFAST INTERNATIONAL,PRESTWICK,1,0,1,0,0,0,
10/10/2008 12:01,1993,1992,B,Other UK Airports,BEMBRIDGE,JERSEY,513,0,513,43,0,43,1093.023315
10/10/2008 12:01,1993,1992,B,Other UK Airports,BENBECULA,GLASGOW,20604,20604,0,20522,20522,0,0.39957118
10/10/2008 12:01,1993,1992,B,Other UK Airports,BENBECULA,INVERNESS,0,0,0,9,0,9,
10/10/2008 12:01,1993,1992,B,Other UK Airports,BENBECULA,PRIVATE STRIPS/HELIPADS,0,0,0,39,0,39,
10/10/2008 12:01,1993,1992,B,Other UK Airports,BENBECULA,ST KILDA,397,0,397,395,0,395,0.506329119
10/10/2008 12:01,1993,1992,B,Other UK Airports,BENBECULA,STORNOWAY,11294,11294,0,9667,9667,0,16.83045387
10/10/2008 12:01,1993,1992,B,Other UK Airports,BENSON,NEWCASTLE,43,0,43,0,0,0,
10/10/2008 12:01,1993,1992,B,Other UK Airports,BIGGIN HILL,GLOUCESTERSHIRE,0,0,0,90,0,90,
10/10/2008 12:01,1993,1992,B,Other UK Airports,BIRMINGHAM,BLACKPOOL,0,0,0,59,0,59,
10/10/2008 12:01,1993,1992,B,Other UK Airports,BIRMINGHAM,BRISTOL,95,0,95,648,157,491,-85.33950806
10/10/2008 12:01,1993,1992,B,Other UK Airports,BIRMINGHAM,CARDIFF WALES,14,0,14,0,0,0,
10/10/2008 12:01,1993,1992,B,Other UK Airports,BIRMINGHAM,DUNDEE,31,0,31,0,0,0,
10/10/2008 12:01,1993,1992,B,Other UK Airports,BIRMINGHAM,DURHAM TEES VALLEY,0,0,0,19,0,19,
10/10/2008 12:01,1993,1992,B,Other UK Airports,BIRMINGHAM,EAST MIDLANDS INTERNATIONAL,300,72,228,1042,697,345,-71.20921326
10/10/2008 12:01,1993,1992,B,Other UK Airports,BIRMINGHAM,EDINBURGH,168004,167574,430,159096,158879,217,5.599134922
10/10/2008 12:01,1993,1992,B,Other UK Airports,BIRMINGHAM,EXETER,89,0,89,0,0,0,
10/10/2008 12:01,1993,1992,B,Other UK Airports,BIRMINGHAM,FILTON,3,0,3,0,0,0,
10/10/2008 12:01,1993,1992,B,Other UK Airports,BIRMINGHAM,GLASGOW,156325,155628,697,145621,144865,756,7.350588322
10/10/2008 12:01,1993,1992,B,Other UK Airports,BIRMINGHAM,GUERNSEY,12457,12036,421,14645,14497,148,-14.9402523
10/10/2008 12:01,1993,1992,B,Other UK Airports,BIRMINGHAM,HUMBERSIDE,48,0,48,0,0,0,
10/10/2008 12:01,1993,1992,B,Other UK Airports,BIRMINGHAM,INVERNESS,57,0,57,0,0,0,
10/10/2008 12:01,1993,1992,B,Other UK Airports,BIRMINGHAM,ISLE OF MAN,36817,36817,0,33480,33480,0,9.967144966
10/10/2008 12:01,1993,1992,B,Other UK Airports,BIRMINGHAM,JERSEY,75526,62364,13162,76339,67664,8675,-1.064986467
10/10/2008 12:01,1993,1992,B,Other UK Airports,BIRMINGHAM,KIRKWALL,521,521,0,599,599,0,-13.02170277
10/10/2008 12:01,1993,1992,B,Other UK Airports,BIRMINGHAM,MANCHESTER,696,54,642,211,0,211,229.8578186
10/10/2008 12:01,1993,1992,B,Other UK Airports,BIRMINGHAM,NEWCASTLE,17920,17666,254,16617,16259,358,7.841367245
10/10/2008 12:01,1993,1992,B,Other UK Airports,BIRMINGHAM,NEWQUAY,41,0,41,0,0,0,
10/10/2008 12:01,1993,1992,B,Other UK Airports,BIRMINGHAM,NORTHOLT,0,0,0,72,0,72,
10/10/2008 12:01,1993,1992,B,Other UK Airports,BIRMINGHAM,NORWICH,0,0,0,342,0,342,
10/10/2008 12:01,1993,1992,B,Other UK Airports,BIRMINGHAM,PLYMOUTH,0,0,0,133,0,133,
10/10/2008 12:01,1993,1992,B,Other UK Airports,BIRMINGHAM,PRESTWICK,60,0,60,0,0,0,
10/10/2008 12:01,1993,1992,B,Other UK Airports,BIRMINGHAM,SOUTHAMPTON,7410,7383,27,0,0,0,
10/10/2008 12:01,1993,1992,B,Other UK Airports,BLACKPOOL,CARDIFF WALES,0,0,0,61,0,61,
10/10/2008 12:01,1993,1992,B,Other UK Airports,BLACKPOOL,ISLE OF MAN,6979,6979,0,14854,14815,39,-53.01602173
10/10/2008 12:01,1993,1992,B,Other UK Airports,BLACKPOOL,JERSEY,2505,2505,0,3381,3381,0,-25.9094944
10/10/2008 12:01,1993,1992,B,Other UK Airports,BLACKPOOL,MANCHESTER,0,0,0,30,30,0,
10/10/2008 12:01,1993,1992,B,Other UK Airports,BLACKPOOL,NORTHOLT,0,0,0,137,0,137,
10/10/2008 12:01,1993,1992,B,Other UK Airports,BOOKER,JERSEY,13,0,13,0,0,0,
10/10/2008 12:01,1993,1992,B,Other UK Airports,BOURNEMOUTH,BRISTOL,1524,0,1524,0,0,0,
10/10/2008 12:01,1993,1992,B,Other UK Airports,BOURNEMOUTH,DOUNREAY,0,0,0,1,0,1,
10/10/2008 12:01,1993,1992,B,Other UK Airports,BOURNEMOUTH,DURHAM TEES VALLEY,7,0,7,0,0,0,
10/10/2008 12:01,1993,1992,B,Other UK Airports,BOURNEMOUTH,EXETER,165,0,165,51,0,51,223.5294189
10/10/2008 12:01,1993,1992,B,Other UK Airports,BOURNEMOUTH,GLASGOW,592,0,592,998,0,998,-40.68136215
10/10/2008 12:01,1993,1992,B,Other UK Airports,BOURNEMOUTH,GUERNSEY,237,2,235,3685,1080,2605,-93.56851959
10/10/2008 12:01,1993,1992,B,Other UK Airports,BOURNEMOUTH,JERSEY,12382,10986,1396,25300,20007,5293,-51.05928802
10/10/2008 12:01,1993,1992,B,Other UK Airports,BOURNEMOUTH,MANCHESTER,220,0,220,0,0,0,
10/10/2008 12:01,1993,1992,B,Other UK Airports,BOURNEMOUTH,NORWICH,0,0,0,95,0,95,
10/10/2008 12:01,1993,1992,B,Other UK Airports,BRISTOL,BRISTOL,84,1,83,0,0,0,
10/10/2008 12:01,1993,1992,B,Other UK Airports,BRISTOL,CARDIFF WALES,0,0,0,80,0,80,
10/10/2008 12:01,1993,1992,B,Other UK Airports,BRISTOL,DURHAM TEES VALLEY,43,0,43,0,0,0,
10/10/2008 12:01,1993,1992,B,Other UK Airports,BRISTOL,EDINBURGH,36777,36777,0,32097,32097,0,14.58080196
10/10/2008 12:01,1993,1992,B,Other UK Airports,BRISTOL,EXETER,0,0,0,103,103,0,
10/10/2008 12:01,1993,1992,B,Other UK Airports,BRISTOL,GLASGOW,48556,48556,0,39827,39827,0,21.91729164
10/10/2008 12:01,1993,1992,B,Other UK Airports,BRISTOL,GUERNSEY,8349,8349,0,11604,11604,0,-28.05067253
10/10/2008 12:01,1993,1992,B,Other UK Airports,BRISTOL,HAWARDEN,0,0,0,54,0,54,
10/10/2008 12:01,1993,1992,B,Other UK Airports,BRISTOL,JERSEY,25792,25524,268,25859,25378,481,-0.259097427
10/10/2008 12:01,1993,1992,B,Other UK Airports,BRISTOL,LIVERPOOL,0,0,0,31,0,31,
10/10/2008 12:01,1993,1992,B,Other UK Airports,BRISTOL,MANCHESTER,31,0,31,1,0,1,3000
10/10/2008 12:01,1993,1992,B,Other UK Airports,BRISTOL,NEWCASTLE,4502,4373,129,109,109,0,4030.275146
10/10/2008 12:01,1993,1992,B,Other UK Airports,BRISTOL,NORTHOLT,0,0,0,69,0,69,
10/10/2008 12:01,1993,1992,B,Other UK Airports,BRISTOL,NORWICH,0,0,0,72,0,72,
10/10/2008 12:01,1993,1992,B,Other UK Airports,BRISTOL,PLYMOUTH,5487,5487,0,3784,3784,0,45.00528717
10/10/2008 12:01,1993,1992,B,Other UK Airports,CAMBRIDGE,EAST MIDLANDS INTERNATIONAL,0,0,0,46,0,46,
10/10/2008 12:01,1993,1992,B,Other UK Airports,CAMBRIDGE,ISLE OF MAN,47,0,47,0,0,0,
10/10/2008 12:01,1993,1992,B,Other UK Airports,CAMBRIDGE,JERSEY,3660,2955,705,3986,3671,315,-8.178625107
10/10/2008 12:01,1993,1992,B,Other UK Airports,CAMBRIDGE,MANCHESTER,7064,6965,99,6349,6349,0,11.26161575
10/10/2008 12:01,1993,1992,B,Other UK Airports,CAMBRIDGE,NEWCASTLE,91,0,91,0,0,0,
10/10/2008 12:01,1993,1992,B,Other UK Airports,CAMBRIDGE,SOUTHAMPTON,0,0,0,4,0,4,
10/10/2008 12:01,1993,1992,B,Other UK Airports,CAMPBELTOWN,GLASGOW,10007,10007,0,9472,9472,0,5.648226261
10/10/2008 12:01,1993,1992,B,Other UK Airports,CAMPBELTOWN,ISLAY,238,238,0,198,197,1,20.20202065
10/10/2008 12:01,1993,1992,B,Other UK Airports,CAMPBELTOWN,KIRKWALL,0,0,0,99,0,99,
10/10/2008 12:01,1993,1992,B,Other UK Airports,CARDIFF WALES,EDINBURGH,6447,1084,5363,40,0,40,16017.5
10/10/2008 12:01,1993,1992,B,Other UK Airports,CARDIFF WALES,GLASGOW,17444,17083,361,15838,15481,357,10.14016914
10/10/2008 12:01,1993,1992,B,Other UK Airports,CARDIFF WALES,GUERNSEY,1079,1079,0,3179,2984,195,-66.05850983
10/10/2008 12:01,1993,1992,B,Other UK Airports,CARDIFF WALES,ISLE OF MAN,2567,2567,0,1073,1073,0,139.2357941
10/10/2008 12:01,1993,1992,B,Other UK Airports,CARDIFF WALES,JERSEY,24883,22877,2006,25585,19539,6046,-2.743795156
10/10/2008 12:01,1993,1992,B,Other UK Airports,CARDIFF WALES,LEEDS BRADFORD,0,0,0,14,0,14,
10/10/2008 12:01,1993,1992,B,Other UK Airports,CARDIFF WALES,LIVERPOOL,50,0,50,0,0,0,
10/10/2008 12:01,1993,1992,B,Other UK Airports,CARDIFF WALES,MANCHESTER,0,0,0,284,0,284,
10/10/2008 12:01,1993,1992,B,Other UK Airports,CARDIFF WALES,NEWCASTLE,30,0,30,347,0,347,-91.3544693
10/10/2008 12:01,1993,1992,B,Other UK Airports,CARDIFF WALES,NORWICH,264,0,264,0,0,0,
10/10/2008 12:01,1993,1992,B,Other UK Airports,CARDIFF WALES,PRESTWICK,30,0,30,0,0,0,
10/10/2008 12:01,1993,1992,B,Other UK Airports,CARLISLE,EDINBURGH,0,0,0,14,0,14,
10/10/2008 12:01,1993,1992,B,Other UK Airports,CARLISLE,NORWICH,0,0,0,38,0,38,
10/10/2008 12:01,1993,1992,B,Other UK Airports,CITY OF DERRY (EGLINTON),GLASGOW,0,0,0,36,36,0,
10/10/2008 12:01,1993,1992,B,Other UK Airports,CITY OF DERRY (EGLINTON),MANCHESTER,0,0,0,16,16,0,
10/10/2008 12:01,1993,1992,B,Other UK Airports,COMPTON ABASS,LIVERPOOL,18,0,18,0,0,0,
10/10/2008 12:01,1993,1992,B,Other UK Airports,COVENTRY,EDINBURGH,0,0,0,17,0,17,
10/10/2008 12:01,1993,1992,B,Other UK Airports,COVENTRY,GLOUCESTERSHIRE,215,215,0,0,0,0,
10/10/2008 12:01,1993,1992,B,Other UK Airports,COVENTRY,NEWCASTLE,74,0,74,0,0,0,
10/10/2008 12:01,1993,1992,B,Other UK Airports,COVENTRY,NORTH WEALD,0,0,0,23,0,23,
10/10/2008 12:01,1993,1992,B,Other UK Airports,DORNOCH,GLASGOW,0,0,0,65,65,0,
10/10/2008 12:01,1993,1992,B,Other UK Airports,DUNDEE,EAST MIDLANDS INTERNATIONAL,26,0,26,0,0,0,
10/10/2008 12:01,1993,1992,B,Other UK Airports,DUNDEE,INVERNESS,21,4,17,0,0,0,
10/10/2008 12:01,1993,1992,B,Other UK Airports,DUNDEE,JERSEY,1854,0,1854,646,0,646,186.9969025
10/10/2008 12:01,1993,1992,B,Other UK Airports,DUNDEE,MANCHESTER,1946,1865,81,45,45,0,4224.444336
10/10/2008 12:01,1993,1992,B,Other UK Airports,DUNKESWELL,JERSEY,0,0,0,142,0,142,
10/10/2008 12:01,1993,1992,B,Other UK Airports,DURHAM TEES VALLEY,EDINBURGH,0,0,0,63,0,63,
10/10/2008 12:01,1993,1992,B,Other UK Airports,DURHAM TEES VALLEY,GLASGOW,0,0,0,96,0,96,
10/10/2008 12:01,1993,1992,B,Other UK Airports,DURHAM TEES VALLEY,HUMBERSIDE,263,263,0,333,333,0,-21.02102089
10/10/2008 12:01,1993,1992,B,Other UK Airports,DURHAM TEES VALLEY,JERSEY,10418,10418,0,9453,9453,0,10.20839977
10/10/2008 12:01,1993,1992,B,Other UK Airports,DURHAM TEES VALLEY,MANCHESTER,7,0,7,0,0,0,
10/10/2008 12:01,1993,1992,B,Other UK Airports,DURHAM TEES VALLEY,NEWCASTLE,0,0,0,53,27,26,
10/10/2008 12:01,1993,1992,B,Other UK Airports,DURHAM TEES VALLEY,NORTHOLT,0,0,0,62,0,62,
10/10/2008 12:01,1993,1992,B,Other UK Airports,DURHAM TEES VALLEY,NORWICH,2613,2213,400,2311,2310,1,13.06793594
10/10/2008 12:01,1993,1992,B,Other UK Airports,EAST MIDLANDS INTERNATIONAL,EDINBURGH,21876,18370,3506,21580,21515,65,1.371640444
10/10/2008 12:01,1993,1992,B,Other UK Airports,EAST MIDLANDS INTERNATIONAL,GLASGOW,79053,78857,196,75854,75642,212,4.217312336
10/10/2008 12:01,1993,1992,B,Other UK Airports,EAST MIDLANDS INTERNATIONAL,GUERNSEY,13313,13228,85,17585,17540,45,-24.29343224
10/10/2008 12:01,1993,1992,B,Other UK Airports,EAST MIDLANDS INTERNATIONAL,INVERNESS,0,0,0,32,0,32,
10/10/2008 12:01,1993,1992,B,Other UK Airports,EAST MIDLANDS INTERNATIONAL,JERSEY,54619,52968,1651,60479,56885,3594,-9.689313889
10/10/2008 12:01,1993,1992,B,Other UK Airports,EAST MIDLANDS INTERNATIONAL,LEEDS BRADFORD,40,0,40,0,0,0,
10/10/2008 12:01,1993,1992,B,Other UK Airports,EAST MIDLANDS INTERNATIONAL,MANCHESTER,58,0,58,90,0,90,-35.55555725
10/10/2008 12:01,1993,1992,B,Other UK Airports,EAST MIDLANDS INTERNATIONAL,NORTHOLT,0,0,0,129,0,129,
10/10/2008 12:01,1993,1992,B,Other UK Airports,EAST MIDLANDS INTERNATIONAL,SUMBURGH,1263,1263,0,0,0,0,
10/10/2008 12:01,1993,1992,B,Other UK Airports,EDAY,KIRKWALL,632,632,0,2263,2263,0,-72.07247162
10/10/2008 12:01,1993,1992,B,Other UK Airports,EDINBURGH,GLASGOW,579,579,0,726,726,0,-20.24793434
10/10/2008 12:01,1993,1992,B,Other UK Airports,EDINBURGH,GLOUCESTERSHIRE,0,0,0,30,0,30,
10/10/2008 12:01,1993,1992,B,Other UK Airports,EDINBURGH,GUERNSEY,2460,2460,0,2203,2203,0,11.66590977
10/10/2008 12:01,1993,1992,B,Other UK Airports,EDINBURGH,HUMBERSIDE,1088,1088,0,1741,1741,0,-37.50717926
10/10/2008 12:01,1993,1992,B,Other UK Airports,EDINBURGH,INVERNESS,2,2,0,0,0,0,
10/10/2008 12:01,1993,1992,B,Other UK Airports,EDINBURGH,ISLAY,36,0,36,303,0,303,-88.11881256
10/10/2008 12:01,1993,1992,B,Other UK Airports,EDINBURGH,ISLE OF MAN,85,0,85,0,0,0,
10/10/2008 12:01,1993,1992,B,Other UK Airports,EDINBURGH,JERSEY,8247,3170,5077,5766,2838,2928,43.02809525
10/10/2008 12:01,1993,1992,B,Other UK Airports,EDINBURGH,KIRKWALL,10369,10369,0,11760,11069,691,-11.82823086
10/10/2008 12:01,1993,1992,B,Other UK Airports,EDINBURGH,LEEDS BRADFORD,17810,17810,0,22673,22613,60,-21.44841957
10/10/2008 12:01,1993,1992,B,Other UK Airports,EDINBURGH,LEEMING,0,0,0,32,0,32,
10/10/2008 12:01,1993,1992,B,Other UK Airports,EDINBURGH,MANCHESTER,88715,88641,74,87445,87364,81,1.452341437
10/10/2008 12:01,1993,1992,B,Other UK Airports,EDINBURGH,NEWCASTLE,79,0,79,120,0,120,-34.16666794
10/10/2008 12:01,1993,1992,B,Other UK Airports,EDINBURGH,NORTHOLT,0,0,0,63,0,63,
10/10/2008 12:01,1993,1992,B,Other UK Airports,EDINBURGH,NORWICH,16765,16765,0,15589,15589,0,7.543780804
10/10/2008 12:01,1993,1992,B,Other UK Airports,EDINBURGH,PLYMOUTH,7041,7041,0,0,0,0,
10/10/2008 12:01,1993,1992,B,Other UK Airports,EDINBURGH,PRESTWICK,0,0,0,38,0,38,
10/10/2008 12:01,1993,1992,B,Other UK Airports,EDINBURGH,SOUTHAMPTON,14352,14352,0,11933,11885,48,20.2715168
10/10/2008 12:01,1993,1992,B,Other UK Airports,EDINBURGH,SUMBURGH,9313,9313,0,11766,11712,54,-20.84820747
10/10/2008 12:01,1993,1992,B,Other UK Airports,EDINBURGH,UNST,7381,7381,0,2510,2510,0,194.0637512
10/10/2008 12:01,1993,1992,B,Other UK Airports,EDINBURGH,WICK,2190,2045,145,2211,2155,56,-0.949796498
10/10/2008 12:01,1993,1992,B,Other UK Airports,EXETER,GLASGOW,144,0,144,66,0,66,118.1818161
10/10/2008 12:01,1993,1992,B,Other UK Airports,EXETER,GUERNSEY,12221,12221,0,13597,13597,0,-10.11987972
10/10/2008 12:01,1993,1992,B,Other UK Airports,EXETER,ISLES OF SCILLY (ST.MARYS),5604,5604,0,6359,6359,0,-11.87293625
10/10/2008 12:01,1993,1992,B,Other UK Airports,EXETER,JERSEY,18992,18144,848,37360,35463,1897,-49.16488266
10/10/2008 12:01,1993,1992,B,Other UK Airports,EXETER,LANDS END (ST JUST),0,0,0,1,1,0,
10/10/2008 12:01,1993,1992,B,Other UK Airports,EXETER,LEEDS BRADFORD,0,0,0,454,0,454,
10/10/2008 12:01,1993,1992,B,Other UK Airports,EXETER,LIVERPOOL,2,0,2,0,0,0,
10/10/2008 12:01,1993,1992,B,Other UK Airports,EXETER,MANCHESTER,0,0,0,400,0,400,
10/10/2008 12:01,1993,1992,B,Other UK Airports,EXETER,NEWCASTLE,0,0,0,118,0,118,
10/10/2008 12:01,1993,1992,B,Other UK Airports,EXETER,NORTHOLT,38,0,38,0,0,0,
10/10/2008 12:01,1993,1992,B,Other UK Airports,EXETER,NORWICH,0,0,0,206,0,206,
10/10/2008 12:01,1993,1992,B,Other UK Airports,FAIR ISLE,KIRKWALL,0,0,0,56,56,0,
10/10/2008 12:01,1993,1992,B,Other UK Airports,FAIR ISLE,LERWICK (TINGWALL),2,2,0,17,17,0,-88.23529053
10/10/2008 12:01,1993,1992,B,Other UK Airports,FAIR ISLE,SUMBURGH,180,111,69,219,116,103,-17.80821991
10/10/2008 12:01,1993,1992,B,Other UK Airports,FILTON,JERSEY,88,0,88,0,0,0,
10/10/2008 12:01,1993,1992,B,Other UK Airports,FILTON,LIVERPOOL,35,0,35,0,0,0,
10/10/2008 12:01,1993,1992,B,Other UK Airports,GLASGOW,GLOUCESTERSHIRE,23,23,0,0,0,0,
10/10/2008 12:01,1993,1992,B,Other UK Airports,GLASGOW,GUERNSEY,2342,2305,37,2455,2455,0,-4.602851391
10/10/2008 12:01,1993,1992,B,Other UK Airports,GLASGOW,HUMBERSIDE,4265,4261,4,1184,1184,0,260.2196045
10/10/2008 12:01,1993,1992,B,Other UK Airports,GLASGOW,INVERNESS,683,678,5,2066,2066,0,-66.94094849
10/10/2008 12:01,1993,1992,B,Other UK Airports,GLASGOW,ISLAY,18250,18250,0,18733,18724,9,-2.578337669
10/10/2008 12:01,1993,1992,B,Other UK Airports,GLASGOW,ISLE OF MAN,17755,17755,0,18182,18164,18,-2.34847641
10/10/2008 12:01,1993,1992,B,Other UK Airports,GLASGOW,JERSEY,35080,29723,5357,37383,30305,7078,-6.160554409
10/10/2008 12:01,1993,1992,B,Other UK Airports,GLASGOW,KINLOSS,28,0,28,0,0,0,
10/10/2008 12:01,1993,1992,B,Other UK Airports,GLASGOW,KIRKWALL,38193,38157,36,32920,32920,0,16.01761818
10/10/2008 12:01,1993,1992,B,Other UK Airports,GLASGOW,LEEDS BRADFORD,22267,22265,2,22803,22753,50,-2.350567818
10/10/2008 12:01,1993,1992,B,Other UK Airports,GLASGOW,LIVERPOOL,58,0,58,0,0,0,
10/10/2008 12:01,1993,1992,B,Other UK Airports,GLASGOW,MANCHESTER,99364,99076,288,96378,96069,309,3.098217487
10/10/2008 12:01,1993,1992,B,Other UK Airports,GLASGOW,NEWCASTLE,771,225,546,49,39,10,1473.46936
10/10/2008 12:01,1993,1992,B,Other UK Airports,GLASGOW,NORWICH,134,0,134,0,0,0,
10/10/2008 12:01,1993,1992,B,Other UK Airports,GLASGOW,PLYMOUTH,7259,7259,0,5113,5113,0,41.97144699
10/10/2008 12:01,1993,1992,B,Other UK Airports,GLASGOW,PRESTWICK,55,0,55,61,0,61,-9.836065292
10/10/2008 12:01,1993,1992,B,Other UK Airports,GLASGOW,SOUTHAMPTON,19009,19009,0,20657,20657,0,-7.977925301
10/10/2008 12:01,1993,1992,B,Other UK Airports,GLASGOW,STORNOWAY,51325,51278,47,50692,50692,0,1.248717785
10/10/2008 12:01,1993,1992,B,Other UK Airports,GLASGOW,SUMBURGH,6065,6015,50,5729,5651,78,5.864897728
10/10/2008 12:01,1993,1992,B,Other UK Airports,GLASGOW,TIREE,4166,4166,0,4145,4145,0,0.506634474
10/10/2008 12:01,1993,1992,B,Other UK Airports,GLOUCESTERSHIRE,GUERNSEY,140,0,140,0,0,0,
10/10/2008 12:01,1993,1992,B,Other UK Airports,GLOUCESTERSHIRE,JERSEY,1585,0,1585,3208,0,3208,-50.5922699
10/10/2008 12:01,1993,1992,B,Other UK Airports,GLOUCESTERSHIRE,NEWCASTLE,67,0,67,0,0,0,
10/10/2008 12:01,1993,1992,B,Other UK Airports,GLOUCESTERSHIRE,NORTHOLT,0,0,0,66,0,66,
10/10/2008 12:01,1993,1992,B,Other UK Airports,GUERNSEY,HATFIELD,43,0,43,0,0,0,
10/10/2008 12:01,1993,1992,B,Other UK Airports,GUERNSEY,JERSEY,185557,184555,1002,192710,192380,330,-3.711794853
10/10/2008 12:01,1993,1992,B,Other UK Airports,GUERNSEY,LEEDS BRADFORD,3552,3384,168,4729,4729,0,-24.88898277
10/10/2008 12:01,1993,1992,B,Other UK Airports,GUERNSEY,MANCHESTER,29143,29143,0,26496,26496,0,9.990187645
10/10/2008 12:01,1993,1992,B,Other UK Airports,GUERNSEY,NORWICH,1865,1865,0,1904,1904,0,-2.04831934
10/10/2008 12:01,1993,1992,B,Other UK Airports,GUERNSEY,PLYMOUTH,357,357,0,4327,4327,0,-91.7494812
10/10/2008 12:01,1993,1992,B,Other UK Airports,GUERNSEY,SOUTHAMPTON,93999,92286,1713,101622,100572,1050,-7.501328468
10/10/2008 12:01,1993,1992,B,Other UK Airports,HUMBERSIDE,JERSEY,5981,1821,4160,6142,1483,4659,-2.621295929
10/10/2008 12:01,1993,1992,B,Other UK Airports,HUMBERSIDE,KENT INTERNATIONAL,547,0,547,0,0,0,
10/10/2008 12:01,1993,1992,B,Other UK Airports,HUMBERSIDE,KIRKWALL,0,0,0,54,0,54,
10/10/2008 12:01,1993,1992,B,Other UK Airports,HUMBERSIDE,LEEDS BRADFORD,14,0,14,0,0,0,
10/10/2008 12:01,1993,1992,B,Other UK Airports,HUMBERSIDE,NEWCASTLE,84,0,84,0,0,0,
10/10/2008 12:01,1993,1992,B,Other UK Airports,HUMBERSIDE,NORTHOLT,0,0,0,16,0,16,
10/10/2008 12:01,1993,1992,B,Other UK Airports,HUMBERSIDE,NORWICH,1327,1327,0,2301,2301,0,-42.329422
10/10/2008 12:01,1993,1992,B,Other UK Airports,HUMBERSIDE,SOUTHAMPTON,37,0,37,0,0,0,
10/10/2008 12:01,1993,1992,B,Other UK Airports,INVERNESS,KIRKWALL,6384,6370,14,7461,7461,0,-14.43506241
10/10/2008 12:01,1993,1992,B,Other UK Airports,INVERNESS,MANCHESTER,4504,4504,0,7582,7582,0,-40.59614944
10/10/2008 12:01,1993,1992,B,Other UK Airports,INVERNESS,STORNOWAY,30079,30079,0,29052,29052,0,3.535040617
10/10/2008 12:01,1993,1992,B,Other UK Airports,INVERNESS,SUMBURGH,134,28,106,88,31,57,52.27272797
10/10/2008 12:01,1993,1992,B,Other UK Airports,INVERNESS,WICK,4,4,0,0,0,0,
10/10/2008 12:01,1993,1992,B,Other UK Airports,ISLAY,PRESTWICK,23,0,23,3,0,3,666.666687
10/10/2008 12:01,1993,1992,B,Other UK Airports,ISLE OF MAN,JERSEY,290,290,0,111,111,0,161.261261
10/10/2008 12:01,1993,1992,B,Other UK Airports,ISLE OF MAN,LEEDS BRADFORD,2271,2127,144,1692,1692,0,34.21985626
10/10/2008 12:01,1993,1992,B,Other UK Airports,ISLE OF MAN,LIVERPOOL,135561,135482,79,122306,122187,119,10.83757114
10/10/2008 12:01,1993,1992,B,Other UK Airports,ISLE OF MAN,MANCHESTER,75494,75222,272,70642,70608,34,6.868435383
10/10/2008 12:01,1993,1992,B,Other UK Airports,ISLE OF MAN,NEWCASTLE,955,902,53,963,963,0,-0.830737293
10/10/2008 12:01,1993,1992,B,Other UK Airports,ISLE OF MAN,NORTHOLT,102,0,102,0,0,0,
10/10/2008 12:01,1993,1992,B,Other UK Airports,ISLE OF MAN,SOUTHAMPTON,0,0,0,44,0,44,
10/10/2008 12:01,1993,1992,B,Other UK Airports,JERSEY,KENT INTERNATIONAL,1742,0,1742,1802,0,1802,-3.329633713
10/10/2008 12:01,1993,1992,B,Other UK Airports,JERSEY,LEEDS BRADFORD,19109,19109,0,22095,21973,122,-13.51436996
10/10/2008 12:01,1993,1992,B,Other UK Airports,JERSEY,LIVERPOOL,7357,3084,4273,10267,6740,3527,-28.34323502
10/10/2008 12:01,1993,1992,B,Other UK Airports,JERSEY,MANCHESTER,123795,96453,27342,111594,92595,18999,10.93338394
10/10/2008 12:01,1993,1992,B,Other UK Airports,JERSEY,NEWCASTLE,14898,5013,9885,18208,17509,699,-18.17882156
10/10/2008 12:01,1993,1992,B,Other UK Airports,JERSEY,NORWICH,6983,6983,0,8239,8239,0,-15.24456882
10/10/2008 12:01,1993,1992,B,Other UK Airports,JERSEY,PLYMOUTH,7334,5958,1376,13946,13946,0,-47.41144562
10/10/2008 12:01,1993,1992,B,Other UK Airports,JERSEY,PRESTWICK,1097,0,1097,68,0,68,1513.235352
10/10/2008 12:01,1993,1992,B,Other UK Airports,JERSEY,SHOREHAM,0,0,0,276,0,276,
10/10/2008 12:01,1993,1992,B,Other UK Airports,JERSEY,SOUTHAMPTON,144391,139263,5128,157084,145092,11992,-8.080389977
10/10/2008 12:01,1993,1992,B,Other UK Airports,JERSEY,STORNOWAY,0,0,0,75,0,75,
10/10/2008 12:01,1993,1992,B,Other UK Airports,KENT INTERNATIONAL,NORWICH,103,0,103,0,0,0,
10/10/2008 12:01,1993,1992,B,Other UK Airports,KIRKWALL,MANCHESTER,1195,1195,0,0,0,0,
10/10/2008 12:01,1993,1992,B,Other UK Airports,KIRKWALL,NORTH RONALDSAY,3105,3105,0,3378,3378,0,-8.081705093
10/10/2008 12:01,1993,1992,B,Other UK Airports,KIRKWALL,PAPA WESTRAY,3061,3061,0,3048,3048,0,0.426509172
10/10/2008 12:01,1993,1992,B,Other UK Airports,KIRKWALL,SANDAY,2571,2571,0,4305,4305,0,-40.27874374
10/10/2008 12:01,1993,1992,B,Other UK Airports,KIRKWALL,SCATSTA,0,0,0,11,0,11,
10/10/2008 12:01,1993,1992,B,Other UK Airports,KIRKWALL,STRONSAY,2794,2794,0,3399,3399,0,-17.79935265
10/10/2008 12:01,1993,1992,B,Other UK Airports,KIRKWALL,SUMBURGH,11487,11228,259,11155,11155,0,2.976243734
10/10/2008 12:01,1993,1992,B,Other UK Airports,KIRKWALL,WESTRAY,3180,3180,0,5085,5085,0,-37.46312714
10/10/2008 12:01,1993,1992,B,Other UK Airports,KIRKWALL,WICK,8658,8608,50,8290,8272,18,4.439083099
10/10/2008 12:01,1993,1992,B,Other UK Airports,LEEDS BRADFORD,MANCHESTER,224,0,224,222,0,222,0.9009009
10/10/2008 12:01,1993,1992,B,Other UK Airports,LEEDS BRADFORD,NEWCASTLE,146,9,137,33,0,33,342.4242554
10/10/2008 12:01,1993,1992,B,Other UK Airports,LEEDS BRADFORD,NORTHOLT,0,0,0,60,0,60,
10/10/2008 12:01,1993,1992,B,Other UK Airports,LEEDS BRADFORD,NORWICH,403,44,359,0,0,0,
10/10/2008 12:01,1993,1992,B,Other UK Airports,LEEDS BRADFORD,SOUTHAMPTON,0,0,0,54,0,54,
10/10/2008 12:01,1993,1992,B,Other UK Airports,LIVERPOOL,MANCHESTER,43,0,43,37,0,37,16.21621704
10/10/2008 12:01,1993,1992,B,Other UK Airports,LIVERPOOL,NEWCASTLE,62,0,62,0,0,0,
10/10/2008 12:01,1993,1992,B,Other UK Airports,LIVERPOOL,PRESTWICK,0,0,0,90,0,90,
10/10/2008 12:01,1993,1992,B,Other UK Airports,LYNEHAM,MANCHESTER,38,0,38,0,0,0,
10/10/2008 12:01,1993,1992,B,Other UK Airports,LYNEHAM,NEWCASTLE,311,0,311,0,0,0,
10/10/2008 12:01,1993,1992,B,Other UK Airports,MANCHESTER,MANCHESTER,0,0,0,54,0,54,
10/10/2008 12:01,1993,1992,B,Other UK Airports,MANCHESTER,NEWCASTLE,17640,17420,220,19845,19326,519,-11.11111069
10/10/2008 12:01,1993,1992,B,Other UK Airports,MANCHESTER,NEWQUAY,41,0,41,0,0,0,
10/10/2008 12:01,1993,1992,B,Other UK Airports,MANCHESTER,NORTHOLT,0,0,0,73,0,73,
10/10/2008 12:01,1993,1992,B,Other UK Airports,MANCHESTER,NORWICH,410,0,410,446,0,446,-8.071748734
10/10/2008 12:01,1993,1992,B,Other UK Airports,MANCHESTER,SOUTHAMPTON,15558,15558,0,44,0,44,35259.08984
10/10/2008 12:01,1993,1992,B,Other UK Airports,MANCHESTER,SUMBURGH,45061,45061,0,42122,42122,0,6.977351665
10/10/2008 12:01,1993,1992,B,Other UK Airports,MANCHESTER,UNST,2028,2028,0,0,0,0,
10/10/2008 12:01,1993,1992,B,Other UK Airports,NEWCASTLE,NORTHOLT,0,0,0,28,0,28,
10/10/2008 12:01,1993,1992,B,Other UK Airports,NEWCASTLE,NORWICH,103,0,103,0,0,0,
10/10/2008 12:01,1993,1992,B,Other UK Airports,NEWCASTLE,PLYMOUTH,0,0,0,100,0,100,
10/10/2008 12:01,1993,1992,B,Other UK Airports,NEWCASTLE,SOUTHAMPTON,161,0,161,0,0,0,
10/10/2008 12:01,1993,1992,B,Other UK Airports,NEWCASTLE,SWANSEA,54,0,54,0,0,0,
10/10/2008 12:01,1993,1992,B,Other UK Airports,NEWCASTLE,WICK,15,0,15,0,0,0,
10/10/2008 12:01,1993,1992,B,Other UK Airports,NORTH RONALDSAY,SUMBURGH,0,0,0,12,0,12,
10/10/2008 12:01,1993,1992,B,Other UK Airports,NORWICH,ORONSAY,33,0,33,0,0,0,
10/10/2008 12:01,1993,1992,B,Other UK Airports,NORWICH,PLYMOUTH,0,0,0,98,0,98,
10/10/2008 12:01,1993,1992,B,Other UK Airports,NORWICH,SOUTHAMPTON,4,0,4,0,0,0,
10/10/2008 12:01,1993,1992,B,Other UK Airports,PRESTWICK,SHAWBURY,0,0,0,35,0,35,
10/10/2008 12:01,1993,1992,B,Other UK Airports,PRESTWICK,SOUTHAMPTON,34,0,34,0,0,0,
10/10/2008 12:01,1993,1992,B,Other UK Airports,SCATSTA,SCATSTA,25,0,25,0,0,0,
10/10/2008 12:01,1993,1992,B,Other UK Airports,SOUTHAMPTON,SUMBURGH,148,0,148,0,0,0,
10/10/2008 12:01,1993,1992,B,Other UK Airports,SOUTHAMPTON,WICK,1,1,0,0,0,0,
10/10/2008 12:01,1993,1992,B,Other UK Airports,SUMBURGH,UNST,2936,2072,864,2943,2108,835,-0.237852529
10/10/2008 12:01,1993,1992,B,Other UK Airports,WICK,WICK,23,0,23,0,0,0,
