rundate,this_period,last_period,grp_cd,grp_name,apt1_apt_name,apt2_apt_name,total_pax_tp,total_pax_shd_tp,total_pax_cht_tp,total_pax_lp,total_pax_shd_lp,total_pax_cht_lp,total_pax_pc
15/04/2011 10:12,2010,2009,A,London Area Airports,GATWICK,ABERDEEN,129948,129744,204,135545,135543,2,-4.129255772
15/04/2011 10:12,2010,2009,A,London Area Airports,GATWICK,BELFAST CITY (GEORGE BEST),218943,218943,0,215485,215485,0,1.604752064
15/04/2011 10:12,2010,2009,A,London Area Airports,GATWICK,BELFAST INTERNATIONAL,296802,296466,336,309976,309922,54,-4.250006676
15/04/2011 10:12,2010,2009,A,London Area Airports,GATWICK,BIRMINGHAM,0,0,0,1,0,1,
15/04/2011 10:12,2010,2009,A,London Area Airports,GATWICK,BLACKPOOL,217,0,217,36,0,36,502.777771
15/04/2011 10:12,2010,2009,A,London Area Airports,GATWICK,CARDIFF WALES,0,0,0,219,0,219,
15/04/2011 10:12,2010,2009,A,London Area Airports,GATWICK,DONCASTER SHEFFIELD,0,0,0,40,0,40,
15/04/2011 10:12,2010,2009,A,London Area Airports,GATWICK,DURHAM TEES VALLEY,0,0,0,84,0,84,
15/04/2011 10:12,2010,2009,A,London Area Airports,GATWICK,EAST MIDLANDS INTERNATIONAL,149,0,149,0,0,0,
15/04/2011 10:12,2010,2009,A,London Area Airports,GATWICK,EDINBURGH,604073,604001,72,647908,647908,0,-6.765621185
15/04/2011 10:12,2010,2009,A,London Area Airports,GATWICK,GLASGOW,488774,488704,70,514660,514660,0,-5.029728413
15/04/2011 10:12,2010,2009,A,London Area Airports,GATWICK,GUERNSEY,335937,335937,0,341656,341656,0,-1.673905969
15/04/2011 10:12,2010,2009,A,London Area Airports,GATWICK,HUMBERSIDE,86,0,86,0,0,0,
15/04/2011 10:12,2010,2009,A,London Area Airports,GATWICK,INVERNESS,206837,206837,0,224872,224792,80,-8.02011776
15/04/2011 10:12,2010,2009,A,London Area Airports,GATWICK,ISLE OF MAN,122159,122159,0,126462,126348,114,-3.402603149
15/04/2011 10:12,2010,2009,A,London Area Airports,GATWICK,JERSEY,534303,534133,170,555971,555906,65,-3.897325516
15/04/2011 10:12,2010,2009,A,London Area Airports,GATWICK,LEEDS BRADFORD,50617,50617,0,30431,30431,0,66.33367157
15/04/2011 10:12,2010,2009,A,London Area Airports,GATWICK,LIVERPOOL (JOHN LENNON),40,0,40,40,0,40,0
15/04/2011 10:12,2010,2009,A,London Area Airports,GATWICK,MANCHESTER,246842,246522,320,288191,287665,526,-14.34777641
15/04/2011 10:12,2010,2009,A,London Area Airports,GATWICK,NEWCASTLE,97385,97345,40,110583,110429,154,-11.93492699
15/04/2011 10:12,2010,2009,A,London Area Airports,GATWICK,NEWQUAY,105968,105968,0,100918,100918,0,5.004062653
15/04/2011 10:12,2010,2009,A,London Area Airports,GATWICK,PLYMOUTH,55816,55816,0,57516,57516,0,-2.955699205
15/04/2011 10:12,2010,2009,A,London Area Airports,HEATHROW,ABERDEEN,617693,617693,0,641294,641294,0,-3.680215359
15/04/2011 10:12,2010,2009,A,London Area Airports,HEATHROW,BELFAST CITY (GEORGE BEST),467826,467826,0,522676,522676,0,-10.49407291
15/04/2011 10:12,2010,2009,A,London Area Airports,HEATHROW,BELFAST INTERNATIONAL,284029,284029,0,266819,266819,0,6.450065613
15/04/2011 10:12,2010,2009,A,London Area Airports,HEATHROW,CITY OF DERRY (EGLINTON),0,0,0,262,0,262,
15/04/2011 10:12,2010,2009,A,London Area Airports,HEATHROW,DURHAM TEES VALLEY,0,0,0,13852,13852,0,
15/04/2011 10:12,2010,2009,A,London Area Airports,HEATHROW,EDINBURGH,1244793,1244787,6,1306065,1305830,235,-4.691343784
15/04/2011 10:12,2010,2009,A,London Area Airports,HEATHROW,GLASGOW,1003344,1003344,0,1079970,1079970,0,-7.095197201
15/04/2011 10:12,2010,2009,A,London Area Airports,HEATHROW,JERSEY,0,0,0,18519,18519,0,
15/04/2011 10:12,2010,2009,A,London Area Airports,HEATHROW,LEEDS BRADFORD,152,0,152,21160,21160,0,-99.28166199
15/04/2011 10:12,2010,2009,A,London Area Airports,HEATHROW,LIVERPOOL (JOHN LENNON),30,0,30,368,0,368,-91.8478241
15/04/2011 10:12,2010,2009,A,London Area Airports,HEATHROW,MANCHESTER,799264,799264,0,908723,908723,0,-12.04536438
15/04/2011 10:12,2010,2009,A,London Area Airports,HEATHROW,NEWCASTLE,424251,424251,0,475432,475432,0,-10.76515675
15/04/2011 10:12,2010,2009,A,London Area Airports,LONDON CITY,DUNDEE,40480,40480,0,41297,41297,0,-1.978351951
15/04/2011 10:12,2010,2009,A,London Area Airports,LONDON CITY,EDINBURGH,334709,334661,48,326553,326553,0,2.497603655
15/04/2011 10:12,2010,2009,A,London Area Airports,LONDON CITY,GLASGOW,111050,111050,0,114920,114920,0,-3.367560148
15/04/2011 10:12,2010,2009,A,London Area Airports,LONDON CITY,GUERNSEY,0,0,0,5,0,5,
15/04/2011 10:12,2010,2009,A,London Area Airports,LONDON CITY,ISLE OF MAN,52224,52224,0,60521,60521,0,-13.70929146
15/04/2011 10:12,2010,2009,A,London Area Airports,LONDON CITY,JERSEY,10121,10121,0,9512,9512,0,6.402439117
15/04/2011 10:12,2010,2009,A,London Area Airports,LONDON CITY,LIVERPOOL (JOHN LENNON),0,0,0,31,0,31,
15/04/2011 10:12,2010,2009,A,London Area Airports,LONDON CITY,MANCHESTER,90,0,90,21913,21913,0,-99.5892868
15/04/2011 10:12,2010,2009,A,London Area Airports,LONDON CITY,NEWCASTLE,42,0,42,28,0,28,50
15/04/2011 10:12,2010,2009,A,London Area Airports,LONDON CITY,NEWQUAY,7864,7864,0,18680,18680,0,-57.9015007
15/04/2011 10:12,2010,2009,A,London Area Airports,LONDON CITY,PLYMOUTH,720,720,0,0,0,0,
15/04/2011 10:12,2010,2009,A,London Area Airports,LUTON,ABERDEEN,129018,128900,118,126877,126716,161,1.687461138
15/04/2011 10:12,2010,2009,A,London Area Airports,LUTON,BELFAST CITY (GEORGE BEST),170023,170023,0,0,0,0,
15/04/2011 10:12,2010,2009,A,London Area Airports,LUTON,BELFAST INTERNATIONAL,3257,3248,9,246905,246894,11,-98.68087006
15/04/2011 10:12,2010,2009,A,London Area Airports,LUTON,BIRMINGHAM,0,0,0,19,19,0,
15/04/2011 10:12,2010,2009,A,London Area Airports,LUTON,BLACKPOOL,148,0,148,68,0,68,117.6470566
15/04/2011 10:12,2010,2009,A,London Area Airports,LUTON,CARDIFF WALES,0,0,0,96,0,96,
15/04/2011 10:12,2010,2009,A,London Area Airports,LUTON,CITY OF DERRY (EGLINTON),8672,8672,0,33388,33388,0,-74.02659607
15/04/2011 10:12,2010,2009,A,London Area Airports,LUTON,DONCASTER SHEFFIELD,0,0,0,86,0,86,
15/04/2011 10:12,2010,2009,A,London Area Airports,LUTON,DURHAM TEES VALLEY,28,0,28,60,0,60,-53.33333206
15/04/2011 10:12,2010,2009,A,London Area Airports,LUTON,EDINBURGH,242100,242100,0,315623,315383,240,-23.29456329
15/04/2011 10:12,2010,2009,A,London Area Airports,LUTON,FARNBOROUGH,4,0,4,0,0,0,
15/04/2011 10:12,2010,2009,A,London Area Airports,LUTON,GLASGOW,247681,247662,19,326033,325324,709,-24.03192329
15/04/2011 10:12,2010,2009,A,London Area Airports,LUTON,HUMBERSIDE,59,0,59,59,0,59,0
15/04/2011 10:12,2010,2009,A,London Area Airports,LUTON,INVERNESS,90264,90264,0,86604,86604,0,4.22613287
15/04/2011 10:12,2010,2009,A,London Area Airports,LUTON,ISLE OF MAN,27067,27067,0,27322,27178,144,-0.933313787
15/04/2011 10:12,2010,2009,A,London Area Airports,LUTON,JERSEY,17181,17181,0,13088,13088,0,31.27292252
15/04/2011 10:12,2010,2009,A,London Area Airports,LUTON,LIVERPOOL (JOHN LENNON),198,0,198,332,0,332,-40.36144638
15/04/2011 10:12,2010,2009,A,London Area Airports,LUTON,MANCHESTER,273,0,273,582,0,582,-53.09278488
15/04/2011 10:12,2010,2009,A,London Area Airports,LUTON,NEWCASTLE,93,0,93,68,0,68,36.76470566
15/04/2011 10:12,2010,2009,A,London Area Airports,LUTON,NEWQUAY,12,0,12,113,0,113,-89.38053131
15/04/2011 10:12,2010,2009,A,London Area Airports,LUTON,PLYMOUTH,0,0,0,60,0,60,
15/04/2011 10:12,2010,2009,A,London Area Airports,LUTON,STANSTED,589,589,0,238,238,0,147.4789886
15/04/2011 10:12,2010,2009,A,London Area Airports,LUTON,WICK,62,0,62,0,0,0,
15/04/2011 10:12,2010,2009,A,London Area Airports,SOUTHEND,JERSEY,2492,2492,0,2448,2448,0,1.797385573
15/04/2011 10:12,2010,2009,A,London Area Airports,STANSTED,BELFAST CITY (GEORGE BEST),301637,301637,0,328619,328619,0,-8.210723877
15/04/2011 10:12,2010,2009,A,London Area Airports,STANSTED,BELFAST INTERNATIONAL,301069,301045,24,293077,293077,0,2.726928473
15/04/2011 10:12,2010,2009,A,London Area Airports,STANSTED,BLACKPOOL,31,0,31,0,0,0,
15/04/2011 10:12,2010,2009,A,London Area Airports,STANSTED,BRISTOL,0,0,0,3,0,3,
15/04/2011 10:12,2010,2009,A,London Area Airports,STANSTED,CITY OF DERRY (EGLINTON),90107,90107,0,79891,79891,0,12.78742313
15/04/2011 10:12,2010,2009,A,London Area Airports,STANSTED,DURHAM TEES VALLEY,0,0,0,70,0,70,
15/04/2011 10:12,2010,2009,A,London Area Airports,STANSTED,EAST MIDLANDS INTERNATIONAL,0,0,0,179,112,67,
15/04/2011 10:12,2010,2009,A,London Area Airports,STANSTED,EDINBURGH,329874,329739,135,373714,373590,124,-11.730896
15/04/2011 10:12,2010,2009,A,London Area Airports,STANSTED,GLASGOW,301758,301490,268,305052,305052,0,-1.079815865
15/04/2011 10:12,2010,2009,A,London Area Airports,STANSTED,GUERNSEY,22077,22077,0,27276,27276,0,-19.06071281
15/04/2011 10:12,2010,2009,A,London Area Airports,STANSTED,JERSEY,27668,27668,0,20650,20650,0,33.98547363
15/04/2011 10:12,2010,2009,A,London Area Airports,STANSTED,LIVERPOOL (JOHN LENNON),28,0,28,425,0,425,-93.41176605
15/04/2011 10:12,2010,2009,A,London Area Airports,STANSTED,MANCHESTER,85,0,85,467,0,467,-81.79871368
15/04/2011 10:12,2010,2009,A,London Area Airports,STANSTED,MANSTON (KENT INT),0,0,0,4,0,4,
15/04/2011 10:12,2010,2009,A,London Area Airports,STANSTED,NEWCASTLE,121134,121010,124,140979,140975,4,-14.07656479
15/04/2011 10:12,2010,2009,A,London Area Airports,STANSTED,NEWQUAY,0,0,0,45967,45967,0,
15/04/2011 10:12,2010,2009,A,London Area Airports,STANSTED,PLYMOUTH,46,0,46,0,0,0,
15/04/2011 10:12,2010,2009,A,London Area Airports,STANSTED,PRESTWICK,224570,224570,0,278284,278284,0,-19.30186462
15/04/2011 10:12,2010,2009,B,Other Reporting Airports,ABERDEEN,BELFAST CITY (GEORGE BEST),18954,18954,0,24237,24237,0,-21.79725266
15/04/2011 10:12,2010,2009,B,Other Reporting Airports,ABERDEEN,BIRMINGHAM,89861,89861,0,111134,111084,50,-19.14175606
15/04/2011 10:12,2010,2009,B,Other Reporting Airports,ABERDEEN,BRISTOL,22668,22637,31,23229,23229,0,-2.4150846
15/04/2011 10:12,2010,2009,B,Other Reporting Airports,ABERDEEN,CARDIFF WALES,477,477,0,6937,6937,0,-93.12382507
15/04/2011 10:12,2010,2009,B,Other Reporting Airports,ABERDEEN,DUNDEE,0,0,0,39,0,39,
15/04/2011 10:12,2010,2009,B,Other Reporting Airports,ABERDEEN,DURHAM TEES VALLEY,29881,29881,0,31949,31949,0,-6.47281599
15/04/2011 10:12,2010,2009,B,Other Reporting Airports,ABERDEEN,EAST MIDLANDS INTERNATIONAL,18097,18005,92,19455,19417,38,-6.980210781
15/04/2011 10:12,2010,2009,B,Other Reporting Airports,ABERDEEN,EXETER,30102,30102,0,28127,28127,0,7.021722794
15/04/2011 10:12,2010,2009,B,Other Reporting Airports,ABERDEEN,HUMBERSIDE,27071,27053,18,31993,31913,80,-15.38461494
15/04/2011 10:12,2010,2009,B,Other Reporting Airports,ABERDEEN,INVERNESS,0,0,0,40,0,40,
15/04/2011 10:12,2010,2009,B,Other Reporting Airports,ABERDEEN,JERSEY,2219,2219,0,2024,2024,0,9.634387016
15/04/2011 10:12,2010,2009,B,Other Reporting Airports,ABERDEEN,KIRKWALL,38555,38482,73,39518,39482,36,-2.436864138
15/04/2011 10:12,2010,2009,B,Other Reporting Airports,ABERDEEN,LEEDS BRADFORD,8148,8116,32,15481,15481,0,-47.36774063
15/04/2011 10:12,2010,2009,B,Other Reporting Airports,ABERDEEN,LIVERPOOL (JOHN LENNON),21,21,0,0,0,0,
15/04/2011 10:12,2010,2009,B,Other Reporting Airports,ABERDEEN,MANCHESTER,93126,89981,3145,104620,101985,2635,-10.98642731
15/04/2011 10:12,2010,2009,B,Other Reporting Airports,ABERDEEN,NEWCASTLE,26446,26446,0,18451,18451,0,43.33098602
15/04/2011 10:12,2010,2009,B,Other Reporting Airports,ABERDEEN,NORWICH,59964,59964,0,60852,60852,0,-1.459278226
15/04/2011 10:12,2010,2009,B,Other Reporting Airports,ABERDEEN,PRESTWICK,0,0,0,98,0,98,
15/04/2011 10:12,2010,2009,B,Other Reporting Airports,ABERDEEN,SCATSTA,151370,91,151279,145094,0,145094,4.325471878
15/04/2011 10:12,2010,2009,B,Other Reporting Airports,ABERDEEN,SOUTHAMPTON,27920,27920,0,45174,45160,14,-38.19453812
15/04/2011 10:12,2010,2009,B,Other Reporting Airports,ABERDEEN,STORNOWAY,6338,6338,0,6350,6350,0,-0.188976377
15/04/2011 10:12,2010,2009,B,Other Reporting Airports,ABERDEEN,SUMBURGH,63542,60185,3357,63831,61605,2226,-0.452758074
15/04/2011 10:12,2010,2009,B,Other Reporting Airports,ABERDEEN,WICK,14722,14722,0,14497,14497,0,1.552045226
15/04/2011 10:12,2010,2009,B,Other Reporting Airports,ALDERNEY,BOURNEMOUTH,0,0,0,767,767,0,
15/04/2011 10:12,2010,2009,B,Other Reporting Airports,ALDERNEY,GUERNSEY,42837,42837,0,44510,44510,0,-3.758705854
15/04/2011 10:12,2010,2009,B,Other Reporting Airports,ALDERNEY,JERSEY,28,28,0,444,444,0,-93.69369507
15/04/2011 10:12,2010,2009,B,Other Reporting Airports,ALDERNEY,SOUTHAMPTON,27161,27161,0,29114,29114,0,-6.708112717
15/04/2011 10:12,2010,2009,B,Other Reporting Airports,ANGLESEY (VALLEY),CARDIFF WALES,7816,7816,0,11846,11846,0,-34.01992416
15/04/2011 10:12,2010,2009,B,Other Reporting Airports,ANGLESEY (VALLEY),ISLE OF MAN,230,230,0,0,0,0,
15/04/2011 10:12,2010,2009,B,Other Reporting Airports,BARRA,BENBECULA,1688,1688,0,1529,1529,0,10.39895344
15/04/2011 10:12,2010,2009,B,Other Reporting Airports,BARRA,GLASGOW,8555,8555,0,8703,8703,0,-1.700563073
15/04/2011 10:12,2010,2009,B,Other Reporting Airports,BARROW-IN-FURNESS,CARDIFF WALES,0,0,0,32,0,32,
15/04/2011 10:12,2010,2009,B,Other Reporting Airports,BELFAST CITY (GEORGE BEST),BIRMINGHAM,200497,200433,64,195383,195335,48,2.617423296
15/04/2011 10:12,2010,2009,B,Other Reporting Airports,BELFAST CITY (GEORGE BEST),BLACKPOOL,15232,15232,0,7943,7943,0,91.76633453
15/04/2011 10:12,2010,2009,B,Other Reporting Airports,BELFAST CITY (GEORGE BEST),BRISTOL,120414,120336,78,79014,79014,0,52.39577866
15/04/2011 10:12,2010,2009,B,Other Reporting Airports,BELFAST CITY (GEORGE BEST),CARDIFF WALES,41594,41594,0,32754,32754,0,26.98907089
15/04/2011 10:12,2010,2009,B,Other Reporting Airports,BELFAST CITY (GEORGE BEST),DONCASTER SHEFFIELD,20561,20561,0,23184,23184,0,-11.31383705
15/04/2011 10:12,2010,2009,B,Other Reporting Airports,BELFAST CITY (GEORGE BEST),DUNDEE,9639,9639,0,10397,10397,0,-7.290564537
15/04/2011 10:12,2010,2009,B,Other Reporting Airports,BELFAST CITY (GEORGE BEST),EAST MIDLANDS INTERNATIONAL,180313,180313,0,162271,162271,0,11.11843777
15/04/2011 10:12,2010,2009,B,Other Reporting Airports,BELFAST CITY (GEORGE BEST),EDINBURGH,111517,111517,0,119386,119386,0,-6.591225147
15/04/2011 10:12,2010,2009,B,Other Reporting Airports,BELFAST CITY (GEORGE BEST),EXETER,984,984,0,22606,22606,0,-95.64717102
15/04/2011 10:12,2010,2009,B,Other Reporting Airports,BELFAST CITY (GEORGE BEST),GLASGOW,96630,96630,0,100055,100055,0,-3.423117399
15/04/2011 10:12,2010,2009,B,Other Reporting Airports,BELFAST CITY (GEORGE BEST),GUERNSEY,600,600,0,0,0,0,
15/04/2011 10:12,2010,2009,B,Other Reporting Airports,BELFAST CITY (GEORGE BEST),INVERNESS,16811,16811,0,19320,19320,0,-12.9865427
15/04/2011 10:12,2010,2009,B,Other Reporting Airports,BELFAST CITY (GEORGE BEST),ISLE OF MAN,7082,7082,0,17662,17662,0,-59.90261459
15/04/2011 10:12,2010,2009,B,Other Reporting Airports,BELFAST CITY (GEORGE BEST),JERSEY,1728,1728,0,1680,1680,0,2.857142925
15/04/2011 10:12,2010,2009,B,Other Reporting Airports,BELFAST CITY (GEORGE BEST),LEEDS BRADFORD,71791,71791,0,78332,78332,0,-8.350355148
15/04/2011 10:12,2010,2009,B,Other Reporting Airports,BELFAST CITY (GEORGE BEST),LIVERPOOL (JOHN LENNON),194713,194713,0,158172,158172,0,23.10206604
15/04/2011 10:12,2010,2009,B,Other Reporting Airports,BELFAST CITY (GEORGE BEST),MANCHESTER,226516,226476,40,229875,229875,0,-1.461228967
15/04/2011 10:12,2010,2009,B,Other Reporting Airports,BELFAST CITY (GEORGE BEST),MANSTON (KENT INT),0,0,0,962,0,962,
15/04/2011 10:12,2010,2009,B,Other Reporting Airports,BELFAST CITY (GEORGE BEST),NEWCASTLE,44985,44985,0,41878,41878,0,7.419169903
15/04/2011 10:12,2010,2009,B,Other Reporting Airports,BELFAST CITY (GEORGE BEST),OXFORD (KIDLINGTON),69,0,69,0,0,0,
15/04/2011 10:12,2010,2009,B,Other Reporting Airports,BELFAST CITY (GEORGE BEST),PRESTWICK,61228,61228,0,91672,91672,0,-33.20970535
15/04/2011 10:12,2010,2009,B,Other Reporting Airports,BELFAST CITY (GEORGE BEST),SOUTHAMPTON,80689,80689,0,84051,84051,0,-3.999952316
15/04/2011 10:12,2010,2009,B,Other Reporting Airports,BELFAST CITY (GEORGE BEST),WICK,34,0,34,0,0,0,
15/04/2011 10:12,2010,2009,B,Other Reporting Airports,BELFAST INTERNATIONAL,BIRMINGHAM,101430,101430,0,130139,130054,85,-22.06025887
15/04/2011 10:12,2010,2009,B,Other Reporting Airports,BELFAST INTERNATIONAL,BLACKPOOL,24537,24537,0,26865,26865,0,-8.665550232
15/04/2011 10:12,2010,2009,B,Other Reporting Airports,BELFAST INTERNATIONAL,BRISTOL,150153,150153,0,163459,163459,0,-8.140267372
15/04/2011 10:12,2010,2009,B,Other Reporting Airports,BELFAST INTERNATIONAL,CARDIFF WALES,7566,7388,178,49806,49767,39,-84.80905914
15/04/2011 10:12,2010,2009,B,Other Reporting Airports,BELFAST INTERNATIONAL,EAST MIDLANDS INTERNATIONAL,78738,78557,181,94151,94151,0,-16.37051201
15/04/2011 10:12,2010,2009,B,Other Reporting Airports,BELFAST INTERNATIONAL,EDINBURGH,219669,219669,0,232121,232121,0,-5.364443779
15/04/2011 10:12,2010,2009,B,Other Reporting Airports,BELFAST INTERNATIONAL,GLASGOW,211573,211456,117,223844,223844,0,-5.481942654
15/04/2011 10:12,2010,2009,B,Other Reporting Airports,BELFAST INTERNATIONAL,ISLE OF MAN,6291,6291,0,10570,10570,0,-40.48249817
15/04/2011 10:12,2010,2009,B,Other Reporting Airports,BELFAST INTERNATIONAL,JERSEY,9626,9626,0,9213,9213,0,4.482796192
15/04/2011 10:12,2010,2009,B,Other Reporting Airports,BELFAST INTERNATIONAL,LEEDS BRADFORD,82469,82469,0,87838,87838,0,-6.112388611
15/04/2011 10:12,2010,2009,B,Other Reporting Airports,BELFAST INTERNATIONAL,LIVERPOOL (JOHN LENNON),329368,329368,0,397052,397052,0,-17.04663277
15/04/2011 10:12,2010,2009,B,Other Reporting Airports,BELFAST INTERNATIONAL,MANCHESTER,95098,94025,1073,121335,120960,375,-21.62360382
15/04/2011 10:12,2010,2009,B,Other Reporting Airports,BELFAST INTERNATIONAL,NEWCASTLE,172655,172655,0,192673,192593,80,-10.38962364
15/04/2011 10:12,2010,2009,B,Other Reporting Airports,BELFAST INTERNATIONAL,NEWQUAY,4781,4781,0,5013,5013,0,-4.627967358
15/04/2011 10:12,2010,2009,B,Other Reporting Airports,BENBECULA,GLASGOW,21902,21902,0,24703,24703,0,-11.33870411
15/04/2011 10:12,2010,2009,B,Other Reporting Airports,BENBECULA,STORNOWAY,7068,7068,0,6987,6987,0,1.159295797
15/04/2011 10:12,2010,2009,B,Other Reporting Airports,BIGGIN HILL,BIRMINGHAM,86,0,86,0,0,0,
15/04/2011 10:12,2010,2009,B,Other Reporting Airports,BIGGIN HILL,GUERNSEY,0,0,0,18,0,18,
15/04/2011 10:12,2010,2009,B,Other Reporting Airports,BIGGIN HILL,NEWCASTLE,0,0,0,64,0,64,
15/04/2011 10:12,2010,2009,B,Other Reporting Airports,BIGGIN HILL,WICK,94,0,94,101,0,101,-6.93069315
15/04/2011 10:12,2010,2009,B,Other Reporting Airports,BIRMINGHAM,BRISTOL,161,0,161,0,0,0,
15/04/2011 10:12,2010,2009,B,Other Reporting Airports,BIRMINGHAM,CITY OF DERRY (EGLINTON),49543,49543,0,67678,67678,0,-26.79600525
15/04/2011 10:12,2010,2009,B,Other Reporting Airports,BIRMINGHAM,DUNDEE,17582,17582,0,19067,19067,0,-7.78832531
15/04/2011 10:12,2010,2009,B,Other Reporting Airports,BIRMINGHAM,EDINBURGH,288035,288035,0,336150,335999,151,-14.31355095
15/04/2011 10:12,2010,2009,B,Other Reporting Airports,BIRMINGHAM,GLASGOW,212624,212624,0,269411,269371,40,-21.0782032
15/04/2011 10:12,2010,2009,B,Other Reporting Airports,BIRMINGHAM,GUERNSEY,32766,32671,95,32413,32139,274,1.089069247
15/04/2011 10:12,2010,2009,B,Other Reporting Airports,BIRMINGHAM,INVERNESS,30427,30427,0,30348,30130,218,0.26031369
15/04/2011 10:12,2010,2009,B,Other Reporting Airports,BIRMINGHAM,ISLE OF MAN,44514,44514,0,46932,46932,0,-5.152134895
15/04/2011 10:12,2010,2009,B,Other Reporting Airports,BIRMINGHAM,JERSEY,52988,52988,0,58737,58737,0,-9.787697792
15/04/2011 10:12,2010,2009,B,Other Reporting Airports,BIRMINGHAM,NEWCASTLE,11831,11831,0,16206,16176,30,-26.99617386
15/04/2011 10:12,2010,2009,B,Other Reporting Airports,BIRMINGHAM,NEWQUAY,0,0,0,7924,7924,0,
15/04/2011 10:12,2010,2009,B,Other Reporting Airports,BIRMINGHAM,WICK,102,0,102,0,0,0,
15/04/2011 10:12,2010,2009,B,Other Reporting Airports,BLACKPOOL,CARDIFF WALES,0,0,0,53,0,53,
15/04/2011 10:12,2010,2009,B,Other Reporting Airports,BLACKPOOL,CITY OF DERRY (EGLINTON),0,0,0,200,0,200,
15/04/2011 10:12,2010,2009,B,Other Reporting Airports,BLACKPOOL,ISLE OF MAN,23795,23795,0,29673,29530,143,-19.80925369
15/04/2011 10:12,2010,2009,B,Other Reporting Airports,BLACKPOOL,JERSEY,7998,7998,0,0,0,0,
15/04/2011 10:12,2010,2009,B,Other Reporting Airports,BLACKPOOL,NEWCASTLE,37,0,37,0,0,0,
15/04/2011 10:12,2010,2009,B,Other Reporting Airports,BLACKPOOL,PLYMOUTH,30,0,30,0,0,0,
15/04/2011 10:12,2010,2009,B,Other Reporting Airports,BLACKPOOL,SOUTH MARSTON,140,0,140,40,0,40,250
15/04/2011 10:12,2010,2009,B,Other Reporting Airports,BLACKPOOL,SOUTHAMPTON,0,0,0,112,0,112,
15/04/2011 10:12,2010,2009,B,Other Reporting Airports,BOURNEMOUTH,EAST MIDLANDS INTERNATIONAL,0,0,0,61,0,61,
15/04/2011 10:12,2010,2009,B,Other Reporting Airports,BOURNEMOUTH,EDINBURGH,17710,17710,0,88376,88376,0,-79.96062469
15/04/2011 10:12,2010,2009,B,Other Reporting Airports,BOURNEMOUTH,GLASGOW,0,0,0,134,0,134,
15/04/2011 10:12,2010,2009,B,Other Reporting Airports,BOURNEMOUTH,ISLE OF MAN,246,0,246,0,0,0,
15/04/2011 10:12,2010,2009,B,Other Reporting Airports,BOURNEMOUTH,JERSEY,4407,3134,1273,769,766,3,473.0819397
15/04/2011 10:12,2010,2009,B,Other Reporting Airports,BOURNEMOUTH,LIVERPOOL (JOHN LENNON),25,0,25,0,0,0,
15/04/2011 10:12,2010,2009,B,Other Reporting Airports,BOURNEMOUTH,MANCHESTER,8172,8172,0,0,0,0,
15/04/2011 10:12,2010,2009,B,Other Reporting Airports,BOURNEMOUTH,PRESTWICK,0,0,0,34270,34270,0,
15/04/2011 10:12,2010,2009,B,Other Reporting Airports,BRISTOL,CARDIFF WALES,2,0,2,0,0,0,
15/04/2011 10:12,2010,2009,B,Other Reporting Airports,BRISTOL,EAST MIDLANDS INTERNATIONAL,0,0,0,158,0,158,
15/04/2011 10:12,2010,2009,B,Other Reporting Airports,BRISTOL,EDINBURGH,227031,227031,0,235196,235196,0,-3.471572638
15/04/2011 10:12,2010,2009,B,Other Reporting Airports,BRISTOL,GLASGOW,201189,201189,0,212253,212253,0,-5.212646961
15/04/2011 10:12,2010,2009,B,Other Reporting Airports,BRISTOL,GUERNSEY,24327,24327,0,26976,26976,0,-9.819839478
15/04/2011 10:12,2010,2009,B,Other Reporting Airports,BRISTOL,HAWARDEN,137,0,137,0,0,0,
15/04/2011 10:12,2010,2009,B,Other Reporting Airports,BRISTOL,INVERNESS,69187,69187,0,73315,73315,0,-5.630498409
15/04/2011 10:12,2010,2009,B,Other Reporting Airports,BRISTOL,ISLE OF MAN,8700,8700,0,0,0,0,
15/04/2011 10:12,2010,2009,B,Other Reporting Airports,BRISTOL,ISLES OF SCILLY (ST.MARYS),3024,3024,0,3330,3330,0,-9.189188957
15/04/2011 10:12,2010,2009,B,Other Reporting Airports,BRISTOL,JERSEY,27120,27120,0,28042,27996,46,-3.287925243
15/04/2011 10:12,2010,2009,B,Other Reporting Airports,BRISTOL,LEEDS BRADFORD,22415,22415,0,28544,28544,0,-21.47211266
15/04/2011 10:12,2010,2009,B,Other Reporting Airports,BRISTOL,MANCHESTER,17242,17242,0,21798,21797,1,-20.90100098
15/04/2011 10:12,2010,2009,B,Other Reporting Airports,BRISTOL,MANSTON (KENT INT),0,0,0,48,0,48,
15/04/2011 10:12,2010,2009,B,Other Reporting Airports,BRISTOL,NEWCASTLE,165729,165729,0,187022,186934,88,-11.3852911
15/04/2011 10:12,2010,2009,B,Other Reporting Airports,BRISTOL,NEWQUAY,14370,14370,0,16589,16589,0,-13.37633419
15/04/2011 10:12,2010,2009,B,Other Reporting Airports,BRISTOL,NORWICH,24,0,24,0,0,0,
15/04/2011 10:12,2010,2009,B,Other Reporting Airports,BRISTOL,PLYMOUTH,9717,9717,0,10686,10686,0,-9.067939758
15/04/2011 10:12,2010,2009,B,Other Reporting Airports,CAMBRIDGE,CARDIFF WALES,40,0,40,0,0,0,
15/04/2011 10:12,2010,2009,B,Other Reporting Airports,CAMBRIDGE,NEWCASTLE,0,0,0,29,0,29,
15/04/2011 10:12,2010,2009,B,Other Reporting Airports,CAMBRIDGE,PLYMOUTH,0,0,0,62,0,62,
15/04/2011 10:12,2010,2009,B,Other Reporting Airports,CAMBRIDGE,PRESTWICK,30,0,30,0,0,0,
15/04/2011 10:12,2010,2009,B,Other Reporting Airports,CAMPBELTOWN,EDINBURGH,0,0,0,2,0,2,
15/04/2011 10:12,2010,2009,B,Other Reporting Airports,CAMPBELTOWN,GLASGOW,8682,8682,0,9334,9334,0,-6.985215187
15/04/2011 10:12,2010,2009,B,Other Reporting Airports,CAMPBELTOWN,ISLAY,0,0,0,40,40,0,
15/04/2011 10:12,2010,2009,B,Other Reporting Airports,CARDIFF WALES,DURHAM TEES VALLEY,134,0,134,0,0,0,
15/04/2011 10:12,2010,2009,B,Other Reporting Airports,CARDIFF WALES,EDINBURGH,111456,111192,264,161001,159376,1625,-30.7730999
15/04/2011 10:12,2010,2009,B,Other Reporting Airports,CARDIFF WALES,GLASGOW,52400,52241,159,56429,56309,120,-7.139945984
15/04/2011 10:12,2010,2009,B,Other Reporting Airports,CARDIFF WALES,JERSEY,22164,22164,0,25058,25058,0,-11.54920578
15/04/2011 10:12,2010,2009,B,Other Reporting Airports,CARDIFF WALES,NEWCASTLE,21339,21297,42,30436,29894,542,-29.88894653
15/04/2011 10:12,2010,2009,B,Other Reporting Airports,CARDIFF WALES,NEWQUAY,37,0,37,0,0,0,
15/04/2011 10:12,2010,2009,B,Other Reporting Airports,CARDIFF WALES,NORWICH,44,0,44,153,0,153,-71.24182892
15/04/2011 10:12,2010,2009,B,Other Reporting Airports,CARDIFF WALES,PLYMOUTH,43,0,43,1,0,1,4200
15/04/2011 10:12,2010,2009,B,Other Reporting Airports,CITY OF DERRY (EGLINTON),LIVERPOOL (JOHN LENNON),71997,71997,0,69103,69103,0,4.187951088
15/04/2011 10:12,2010,2009,B,Other Reporting Airports,CITY OF DERRY (EGLINTON),PRESTWICK,55031,55031,0,51310,51310,0,7.251997471
15/04/2011 10:12,2010,2009,B,Other Reporting Airports,DONCASTER SHEFFIELD,FARNBOROUGH,0,0,0,31,0,31,
15/04/2011 10:12,2010,2009,B,Other Reporting Airports,DONCASTER SHEFFIELD,JERSEY,16746,16746,0,14858,14858,0,12.70695877
15/04/2011 10:12,2010,2009,B,Other Reporting Airports,DONCASTER SHEFFIELD,NORWICH,0,0,0,102,0,102,
15/04/2011 10:12,2010,2009,B,Other Reporting Airports,DONCASTER SHEFFIELD,PLYMOUTH,79,0,79,0,0,0,
15/04/2011 10:12,2010,2009,B,Other Reporting Airports,DUNDEE,HUMBERSIDE,94,0,94,0,0,0,
15/04/2011 10:12,2010,2009,B,Other Reporting Airports,DUNDEE,JERSEY,2343,2343,0,2157,2157,0,8.623087883
15/04/2011 10:12,2010,2009,B,Other Reporting Airports,DUNDEE,LIVERPOOL (JOHN LENNON),0,0,0,27,0,27,
15/04/2011 10:12,2010,2009,B,Other Reporting Airports,DUNDEE,SCATSTA,45,0,45,10,0,10,350
15/04/2011 10:12,2010,2009,B,Other Reporting Airports,DURHAM TEES VALLEY,GLASGOW,8,0,8,0,0,0,
15/04/2011 10:12,2010,2009,B,Other Reporting Airports,DURHAM TEES VALLEY,JERSEY,1892,1892,0,0,0,0,
15/04/2011 10:12,2010,2009,B,Other Reporting Airports,DURHAM TEES VALLEY,LIVERPOOL (JOHN LENNON),0,0,0,31,0,31,
15/04/2011 10:12,2010,2009,B,Other Reporting Airports,DURHAM TEES VALLEY,PLYMOUTH,0,0,0,82,0,82,
15/04/2011 10:12,2010,2009,B,Other Reporting Airports,DURHAM TEES VALLEY,SOUTHAMPTON,5237,5237,0,661,576,85,692.2844238
15/04/2011 10:12,2010,2009,B,Other Reporting Airports,EAST MIDLANDS INTERNATIONAL,EDINBURGH,108700,108700,0,130205,130105,100,-16.51626205
15/04/2011 10:12,2010,2009,B,Other Reporting Airports,EAST MIDLANDS INTERNATIONAL,GLASGOW,99740,99640,100,115002,115002,0,-13.27107334
15/04/2011 10:12,2010,2009,B,Other Reporting Airports,EAST MIDLANDS INTERNATIONAL,GUERNSEY,26263,26263,0,20085,20085,0,30.75927353
15/04/2011 10:12,2010,2009,B,Other Reporting Airports,EAST MIDLANDS INTERNATIONAL,INVERNESS,0,0,0,20373,20373,0,
15/04/2011 10:12,2010,2009,B,Other Reporting Airports,EAST MIDLANDS INTERNATIONAL,ISLE OF MAN,2152,2152,0,6413,6413,0,-66.44316101
15/04/2011 10:12,2010,2009,B,Other Reporting Airports,EAST MIDLANDS INTERNATIONAL,JERSEY,53020,53020,0,61340,61340,0,-13.56374264
15/04/2011 10:12,2010,2009,B,Other Reporting Airports,EAST MIDLANDS INTERNATIONAL,NEWQUAY,7885,7885,0,0,0,0,
15/04/2011 10:12,2010,2009,B,Other Reporting Airports,EAST MIDLANDS INTERNATIONAL,PLYMOUTH,96,0,96,0,0,0,
15/04/2011 10:12,2010,2009,B,Other Reporting Airports,EDAY,KIRKWALL,371,371,0,536,536,0,-30.78358269
15/04/2011 10:12,2010,2009,B,Other Reporting Airports,EDINBURGH,EXETER,53776,53776,0,61095,61095,0,-11.9797039
15/04/2011 10:12,2010,2009,B,Other Reporting Airports,EDINBURGH,FARNBOROUGH,34,0,34,20,0,20,70
15/04/2011 10:12,2010,2009,B,Other Reporting Airports,EDINBURGH,GUERNSEY,1322,1322,0,0,0,0,
15/04/2011 10:12,2010,2009,B,Other Reporting Airports,EDINBURGH,HUMBERSIDE,19,0,19,0,0,0,
15/04/2011 10:12,2010,2009,B,Other Reporting Airports,EDINBURGH,INVERNESS,1016,1016,0,854,848,6,18.9695549
15/04/2011 10:12,2010,2009,B,Other Reporting Airports,EDINBURGH,ISLE OF MAN,11422,11422,0,11522,11522,0,-0.867904902
15/04/2011 10:12,2010,2009,B,Other Reporting Airports,EDINBURGH,JERSEY,17029,17029,0,23190,23190,0,-26.56748581
15/04/2011 10:12,2010,2009,B,Other Reporting Airports,EDINBURGH,KIRKWALL,35643,35643,0,39054,39054,0,-8.734060287
15/04/2011 10:12,2010,2009,B,Other Reporting Airports,EDINBURGH,LEEDS BRADFORD,13011,13011,0,18960,18960,0,-31.3765831
15/04/2011 10:12,2010,2009,B,Other Reporting Airports,EDINBURGH,MANCHESTER,126653,126653,0,158307,158292,15,-19.99532509
15/04/2011 10:12,2010,2009,B,Other Reporting Airports,EDINBURGH,MANSTON (KENT INT),17555,17555,0,0,0,0,
15/04/2011 10:12,2010,2009,B,Other Reporting Airports,EDINBURGH,NEWQUAY,13065,12969,96,12218,12218,0,6.932394981
15/04/2011 10:12,2010,2009,B,Other Reporting Airports,EDINBURGH,NORWICH,47846,47846,0,50365,50365,0,-5.001489162
15/04/2011 10:12,2010,2009,B,Other Reporting Airports,EDINBURGH,OXFORD (KIDLINGTON),33,0,33,0,0,0,
15/04/2011 10:12,2010,2009,B,Other Reporting Airports,EDINBURGH,SOUTHAMPTON,193994,193994,0,191511,191511,0,1.29653132
15/04/2011 10:12,2010,2009,B,Other Reporting Airports,EDINBURGH,STORNOWAY,21862,21862,0,31831,31831,0,-31.31852531
15/04/2011 10:12,2010,2009,B,Other Reporting Airports,EDINBURGH,SUMBURGH,32447,32447,0,32897,32897,0,-1.367905855
15/04/2011 10:12,2010,2009,B,Other Reporting Airports,EDINBURGH,WICK,7793,7793,0,7566,7566,0,3.000264406
15/04/2011 10:12,2010,2009,B,Other Reporting Airports,EXETER,GLASGOW,26469,26469,0,33359,33359,0,-20.6540966
15/04/2011 10:12,2010,2009,B,Other Reporting Airports,EXETER,GUERNSEY,22349,22349,0,24479,24479,0,-8.701335907
15/04/2011 10:12,2010,2009,B,Other Reporting Airports,EXETER,ISLES OF SCILLY (ST.MARYS),3062,3062,0,4223,4223,0,-27.49230385
15/04/2011 10:12,2010,2009,B,Other Reporting Airports,EXETER,JERSEY,31814,31814,0,33193,33193,0,-4.154490471
15/04/2011 10:12,2010,2009,B,Other Reporting Airports,EXETER,LEEDS BRADFORD,12445,12445,0,15357,15357,0,-18.96203613
15/04/2011 10:12,2010,2009,B,Other Reporting Airports,EXETER,MANCHESTER,41414,41414,0,48526,48526,0,-14.65606022
15/04/2011 10:12,2010,2009,B,Other Reporting Airports,EXETER,NEWCASTLE,27072,27072,0,39029,39029,0,-30.63619423
15/04/2011 10:12,2010,2009,B,Other Reporting Airports,EXETER,NORWICH,8102,8102,0,8992,8992,0,-9.897686958
15/04/2011 10:12,2010,2009,B,Other Reporting Airports,FAIR ISLE,LERWICK (TINGWALL),2783,2783,0,2645,2645,0,5.217391491
15/04/2011 10:12,2010,2009,B,Other Reporting Airports,FAIR ISLE,SUMBURGH,150,150,0,83,83,0,80.72289276
15/04/2011 10:12,2010,2009,B,Other Reporting Airports,FARNBOROUGH,GLASGOW,19,0,19,24,0,24,-20.83333397
15/04/2011 10:12,2010,2009,B,Other Reporting Airports,FARNBOROUGH,HUMBERSIDE,71,0,71,0,0,0,
15/04/2011 10:12,2010,2009,B,Other Reporting Airports,FARNBOROUGH,LIVERPOOL (JOHN LENNON),152,0,152,95,0,95,60
15/04/2011 10:12,2010,2009,B,Other Reporting Airports,FARNBOROUGH,MANCHESTER,201,0,201,361,0,361,-44.32133102
15/04/2011 10:12,2010,2009,B,Other Reporting Airports,FARNBOROUGH,NEWCASTLE,111,0,111,178,0,178,-37.64044952
15/04/2011 10:12,2010,2009,B,Other Reporting Airports,FILTON,MANCHESTER,17,0,17,19,0,19,-10.52631569
15/04/2011 10:12,2010,2009,B,Other Reporting Airports,FOULA,LERWICK (TINGWALL),1276,1276,0,1291,1291,0,-1.16189003
15/04/2011 10:12,2010,2009,B,Other Reporting Airports,GLASGOW,ISLAY,24808,24808,0,26242,26242,0,-5.464522362
15/04/2011 10:12,2010,2009,B,Other Reporting Airports,GLASGOW,ISLE OF MAN,10987,10987,0,13768,13768,0,-20.19901276
15/04/2011 10:12,2010,2009,B,Other Reporting Airports,GLASGOW,JERSEY,9226,9226,0,5415,5415,0,70.37857819
15/04/2011 10:12,2010,2009,B,Other Reporting Airports,GLASGOW,KIRKWALL,14872,14872,0,15366,15366,0,-3.214890003
15/04/2011 10:12,2010,2009,B,Other Reporting Airports,GLASGOW,LEEDS BRADFORD,14613,14613,0,19923,19923,0,-26.65261269
15/04/2011 10:12,2010,2009,B,Other Reporting Airports,GLASGOW,LIVERPOOL (JOHN LENNON),42,0,42,0,0,0,
15/04/2011 10:12,2010,2009,B,Other Reporting Airports,GLASGOW,MANCHESTER,68315,68050,265,100364,100275,89,-31.93276405
15/04/2011 10:12,2010,2009,B,Other Reporting Airports,GLASGOW,NEWCASTLE,0,0,0,239,0,239,
15/04/2011 10:12,2010,2009,B,Other Reporting Airports,GLASGOW,NEWQUAY,226,226,0,279,279,0,-18.99641609
15/04/2011 10:12,2010,2009,B,Other Reporting Airports,GLASGOW,PLYMOUTH,23300,23300,0,24370,24370,0,-4.390644073
15/04/2011 10:12,2010,2009,B,Other Reporting Airports,GLASGOW,SOUTHAMPTON,143384,143285,99,156293,156078,215,-8.259487152
15/04/2011 10:12,2010,2009,B,Other Reporting Airports,GLASGOW,STORNOWAY,51026,51026,0,53723,53723,0,-5.020195961
15/04/2011 10:12,2010,2009,B,Other Reporting Airports,GLASGOW,SUMBURGH,16821,16821,0,17406,17406,0,-3.360909939
15/04/2011 10:12,2010,2009,B,Other Reporting Airports,GLASGOW,TIREE,7171,7171,0,7305,7305,0,-1.834360003
15/04/2011 10:12,2010,2009,B,Other Reporting Airports,GLOUCESTERSHIRE,ISLE OF MAN,13723,13723,0,16872,16872,0,-18.66405869
15/04/2011 10:12,2010,2009,B,Other Reporting Airports,GLOUCESTERSHIRE,JERSEY,1924,1924,0,3297,3297,0,-41.64391708
15/04/2011 10:12,2010,2009,B,Other Reporting Airports,GLOUCESTERSHIRE,NEWCASTLE,68,0,68,0,0,0,
15/04/2011 10:12,2010,2009,B,Other Reporting Airports,GUERNSEY,ISLE OF MAN,3596,3596,0,3880,3841,39,-7.319587708
15/04/2011 10:12,2010,2009,B,Other Reporting Airports,GUERNSEY,JERSEY,143207,143199,8,139890,139890,0,2.371148825
15/04/2011 10:12,2010,2009,B,Other Reporting Airports,GUERNSEY,MANCHESTER,69530,69530,0,74865,74865,0,-7.126160622
15/04/2011 10:12,2010,2009,B,Other Reporting Airports,GUERNSEY,NEWCASTLE,1147,1147,0,0,0,0,
15/04/2011 10:12,2010,2009,B,Other Reporting Airports,GUERNSEY,NORWICH,1836,1836,0,0,0,0,
15/04/2011 10:12,2010,2009,B,Other Reporting Airports,GUERNSEY,PLYMOUTH,4240,4240,0,3152,3152,0,34.51776505
15/04/2011 10:12,2010,2009,B,Other Reporting Airports,GUERNSEY,SOUTHAMPTON,133592,133592,0,142402,142270,132,-6.186710835
15/04/2011 10:12,2010,2009,B,Other Reporting Airports,HUMBERSIDE,JERSEY,2257,2257,0,2244,2244,0,0.579322636
15/04/2011 10:12,2010,2009,B,Other Reporting Airports,HUMBERSIDE,LIVERPOOL (JOHN LENNON),0,0,0,56,0,56,
15/04/2011 10:12,2010,2009,B,Other Reporting Airports,HUMBERSIDE,NORWICH,1661,1661,0,209,140,69,694.7368164
15/04/2011 10:12,2010,2009,B,Other Reporting Airports,HUMBERSIDE,SOUTHAMPTON,0,0,0,209,0,209,
15/04/2011 10:12,2010,2009,B,Other Reporting Airports,INVERNESS,JERSEY,1331,1331,0,1232,1232,0,8.035714149
15/04/2011 10:12,2010,2009,B,Other Reporting Airports,INVERNESS,KIRKWALL,23056,23056,0,24795,24795,0,-7.013510704
15/04/2011 10:12,2010,2009,B,Other Reporting Airports,INVERNESS,MANCHESTER,46407,46407,0,50505,50505,0,-8.114048004
15/04/2011 10:12,2010,2009,B,Other Reporting Airports,INVERNESS,PRESTWICK,148,0,148,0,0,0,
15/04/2011 10:12,2010,2009,B,Other Reporting Airports,INVERNESS,SOUTHAMPTON,2387,2387,0,3903,3903,0,-38.84191513
15/04/2011 10:12,2010,2009,B,Other Reporting Airports,INVERNESS,STORNOWAY,29777,29777,0,33110,33110,0,-10.06644535
15/04/2011 10:12,2010,2009,B,Other Reporting Airports,INVERNESS,SUMBURGH,17,17,0,29,29,0,-41.37931061
15/04/2011 10:12,2010,2009,B,Other Reporting Airports,ISLE OF MAN,JERSEY,4436,4423,13,5721,5721,0,-22.46110725
15/04/2011 10:12,2010,2009,B,Other Reporting Airports,ISLE OF MAN,LEEDS BRADFORD,6474,6474,0,11892,11892,0,-45.56003952
15/04/2011 10:12,2010,2009,B,Other Reporting Airports,ISLE OF MAN,LIVERPOOL (JOHN LENNON),134489,134347,142,117492,117492,0,14.46651649
15/04/2011 10:12,2010,2009,B,Other Reporting Airports,ISLE OF MAN,MANCHESTER,125845,125845,0,142142,142074,68,-11.46529484
15/04/2011 10:12,2010,2009,B,Other Reporting Airports,ISLE OF MAN,NEWCASTLE,5918,5918,0,5553,5553,0,6.573023796
15/04/2011 10:12,2010,2009,B,Other Reporting Airports,ISLE OF MAN,NEWQUAY,0,0,0,1919,1919,0,
15/04/2011 10:12,2010,2009,B,Other Reporting Airports,ISLE OF MAN,OXFORD (KIDLINGTON),33,0,33,28,0,28,17.8571434
15/04/2011 10:12,2010,2009,B,Other Reporting Airports,ISLE OF MAN,SOUTHAMPTON,7508,7508,0,8207,8207,0,-8.517119408
15/04/2011 10:12,2010,2009,B,Other Reporting Airports,ISLES OF SCILLY (ST.MARYS),NEWQUAY,14629,14629,0,12212,12212,0,19.79200745
15/04/2011 10:12,2010,2009,B,Other Reporting Airports,ISLES OF SCILLY (ST.MARYS),SOUTHAMPTON,3084,3084,0,3081,3081,0,0.097370982
15/04/2011 10:12,2010,2009,B,Other Reporting Airports,JERSEY,LEEDS BRADFORD,17558,17558,0,18195,18195,0,-3.500961781
15/04/2011 10:12,2010,2009,B,Other Reporting Airports,JERSEY,LIVERPOOL (JOHN LENNON),57314,57314,0,54971,54971,0,4.262247562
15/04/2011 10:12,2010,2009,B,Other Reporting Airports,JERSEY,MANCHESTER,86684,86684,0,94734,94734,0,-8.497477531
15/04/2011 10:12,2010,2009,B,Other Reporting Airports,JERSEY,MANSTON (KENT INT),1529,0,1529,1896,1896,0,-19.35654068
15/04/2011 10:12,2010,2009,B,Other Reporting Airports,JERSEY,NEWCASTLE,12708,12708,0,13042,13042,0,-2.560956955
15/04/2011 10:12,2010,2009,B,Other Reporting Airports,JERSEY,NORWICH,8421,8421,0,7568,7568,0,11.27114201
15/04/2011 10:12,2010,2009,B,Other Reporting Airports,JERSEY,OXFORD (KIDLINGTON),1261,0,1261,832,0,832,51.5625
15/04/2011 10:12,2010,2009,B,Other Reporting Airports,JERSEY,PLYMOUTH,7111,7089,22,13434,13434,0,-47.06714249
15/04/2011 10:12,2010,2009,B,Other Reporting Airports,JERSEY,PRESTWICK,1356,618,738,0,0,0,
15/04/2011 10:12,2010,2009,B,Other Reporting Airports,JERSEY,SOUTHAMPTON,150127,150050,77,141830,141756,74,5.849961281
15/04/2011 10:12,2010,2009,B,Other Reporting Airports,KIRKWALL,NORTH RONALDSAY,6698,6698,0,7344,7344,0,-8.79629612
15/04/2011 10:12,2010,2009,B,Other Reporting Airports,KIRKWALL,PAPA WESTRAY,4062,4062,0,4269,4269,0,-4.848910809
15/04/2011 10:12,2010,2009,B,Other Reporting Airports,KIRKWALL,SANDAY,2517,2517,0,2968,2968,0,-15.1954174
15/04/2011 10:12,2010,2009,B,Other Reporting Airports,KIRKWALL,STRONSAY,2847,2847,0,3145,3145,0,-9.475358009
15/04/2011 10:12,2010,2009,B,Other Reporting Airports,KIRKWALL,SUMBURGH,8520,8520,0,8833,8833,0,-3.543529987
15/04/2011 10:12,2010,2009,B,Other Reporting Airports,KIRKWALL,WESTRAY,3557,3557,0,3565,3565,0,-0.224403933
15/04/2011 10:12,2010,2009,B,Other Reporting Airports,LANDS END (ST JUST),NEWQUAY,39,0,39,0,0,0,
15/04/2011 10:12,2010,2009,B,Other Reporting Airports,LEEDS BRADFORD,LIVERPOOL (JOHN LENNON),0,0,0,3,3,0,
15/04/2011 10:12,2010,2009,B,Other Reporting Airports,LEEDS BRADFORD,MANCHESTER,0,0,0,631,631,0,
15/04/2011 10:12,2010,2009,B,Other Reporting Airports,LEEDS BRADFORD,NEWQUAY,11244,11148,96,23941,23941,0,-53.03454208
15/04/2011 10:12,2010,2009,B,Other Reporting Airports,LEEDS BRADFORD,PLYMOUTH,9227,9083,144,8209,8209,0,12.40102291
15/04/2011 10:12,2010,2009,B,Other Reporting Airports,LEEDS BRADFORD,SOUTHAMPTON,70357,70261,96,79901,79901,0,-11.9447813
15/04/2011 10:12,2010,2009,B,Other Reporting Airports,LERWICK (TINGWALL),OUT SKERRIES,420,420,0,586,586,0,-28.32764435
15/04/2011 10:12,2010,2009,B,Other Reporting Airports,LERWICK (TINGWALL),PAPA STOUR,115,115,0,145,145,0,-20.6896553
15/04/2011 10:12,2010,2009,B,Other Reporting Airports,LIVERPOOL (JOHN LENNON),NEWCASTLE,0,0,0,54,0,54,
15/04/2011 10:12,2010,2009,B,Other Reporting Airports,LIVERPOOL (JOHN LENNON),NORWICH,72,0,72,0,0,0,
15/04/2011 10:12,2010,2009,B,Other Reporting Airports,LIVERPOOL (JOHN LENNON),SOUTHAMPTON,8240,8240,0,5236,5086,150,57.37203979
15/04/2011 10:12,2010,2009,B,Other Reporting Airports,MANCHESTER,MANSTON (KENT INT),3782,3782,0,57,0,57,6535.087891
15/04/2011 10:12,2010,2009,B,Other Reporting Airports,MANCHESTER,NEWCASTLE,242,0,242,0,0,0,
15/04/2011 10:12,2010,2009,B,Other Reporting Airports,MANCHESTER,NEWQUAY,40990,40990,0,51538,51353,185,-20.46645164
15/04/2011 10:12,2010,2009,B,Other Reporting Airports,MANCHESTER,NORWICH,29668,29668,0,34438,34376,62,-13.85097885
15/04/2011 10:12,2010,2009,B,Other Reporting Airports,MANCHESTER,PLYMOUTH,19765,19765,0,24307,24307,0,-18.68597603
15/04/2011 10:12,2010,2009,B,Other Reporting Airports,MANCHESTER,SOUTHAMPTON,112290,111711,579,132139,131416,723,-15.02130318
15/04/2011 10:12,2010,2009,B,Other Reporting Airports,NEWCASTLE,NORWICH,0,0,0,72,0,72,
15/04/2011 10:12,2010,2009,B,Other Reporting Airports,NEWCASTLE,PLYMOUTH,15126,15041,85,16722,16722,0,-9.544312477
15/04/2011 10:12,2010,2009,B,Other Reporting Airports,NEWCASTLE,SOUTHAMPTON,103261,103192,69,110338,110043,295,-6.413928032
15/04/2011 10:12,2010,2009,B,Other Reporting Airports,NEWQUAY,PLYMOUTH,978,978,0,725,725,0,34.89655304
15/04/2011 10:12,2010,2009,B,Other Reporting Airports,NEWQUAY,SOUTHAMPTON,0,0,0,23,0,23,
15/04/2011 10:12,2010,2009,B,Other Reporting Airports,NORWICH,PLYMOUTH,0,0,0,95,0,95,
15/04/2011 10:12,2010,2009,B,Other Reporting Airports,OBAN (NORTH CONNEL),TIREE,195,195,0,925,925,0,-78.91892242
15/04/2011 10:12,2010,2009,B,Other Reporting Airports,OXFORD (KIDLINGTON),WICK,103,0,103,0,0,0,
