rundate,this_period,last_period,grp_name,apt1_apt_name,apt2_apt_name,total_pax_tp,total_pax_shd_tp,total_pax_cht_tp,total_pax_lp,total_pax_shd_lp,total_pax_cht_lp,total_pax_pc
05/03/2007 13:30,2006,2005,London Area Airports,GATWICK,ABERDEEN,216677,216677,0,217287,217287,0,-0.280734688
05/03/2007 13:30,2006,2005,London Area Airports,GATWICK,BELFAST CITY,198079,197872,207,207748,207748,0,-4.654196262
05/03/2007 13:30,2006,2005,London Area Airports,GATWICK,BELFAST INTERNATIONAL,362388,362205,183,355023,355023,0,2.074513435
05/03/2007 13:30,2006,2005,London Area Airports,GATWICK,BIRMINGHAM,59,59,0,0,0,0,
05/03/2007 13:30,2006,2005,London Area Airports,GATWICK,BLACKPOOL,46,0,46,0,0,0,
05/03/2007 13:30,2006,2005,London Area Airports,GATWICK,BOURNEMOUTH,17,0,17,0,0,0,
05/03/2007 13:30,2006,2005,London Area Airports,GATWICK,BRISTOL,0,0,0,5,0,5,
05/03/2007 13:30,2006,2005,London Area Airports,GATWICK,CARDIFF WALES,2,0,2,90,0,90,-97.77777863
05/03/2007 13:30,2006,2005,London Area Airports,GATWICK,DURHAM TEES VALLEY,42439,40503,1936,6606,6606,0,542.4311523
05/03/2007 13:30,2006,2005,London Area Airports,GATWICK,EDINBURGH,754106,753746,360,753793,753793,0,0.041523337
05/03/2007 13:30,2006,2005,London Area Airports,GATWICK,GLASGOW,433003,433003,0,372263,372263,0,16.31642151
05/03/2007 13:30,2006,2005,London Area Airports,GATWICK,GUERNSEY,352752,352752,0,347934,347934,0,1.384745359
05/03/2007 13:30,2006,2005,London Area Airports,GATWICK,INVERNESS,240771,240771,0,235041,235041,0,2.437872648
05/03/2007 13:30,2006,2005,London Area Airports,GATWICK,ISLE OF MAN,117977,117843,134,114110,114110,0,3.38883543
05/03/2007 13:30,2006,2005,London Area Airports,GATWICK,JERSEY,538343,538343,0,521328,521328,0,3.263780117
05/03/2007 13:30,2006,2005,London Area Airports,GATWICK,LIVERPOOL,152,0,152,648,0,648,-76.54321289
05/03/2007 13:30,2006,2005,London Area Airports,GATWICK,MANCHESTER,472942,471978,964,479993,478063,1930,-1.468979716
05/03/2007 13:30,2006,2005,London Area Airports,GATWICK,NEWCASTLE,216544,216470,74,220687,220585,102,-1.877319455
05/03/2007 13:30,2006,2005,London Area Airports,GATWICK,NEWQUAY,43124,43124,0,40302,40177,125,7.002133846
05/03/2007 13:30,2006,2005,London Area Airports,GATWICK,PLYMOUTH,68742,68742,0,65984,65984,0,4.179800987
05/03/2007 13:30,2006,2005,London Area Airports,HEATHROW,ABERDEEN,673228,673228,0,664018,664018,0,1.387010574
05/03/2007 13:30,2006,2005,London Area Airports,HEATHROW,BELFAST CITY,665656,665656,0,730989,730989,0,-8.937617302
05/03/2007 13:30,2006,2005,London Area Airports,HEATHROW,BRIZE NORTON,8,0,8,0,0,0,
05/03/2007 13:30,2006,2005,London Area Airports,HEATHROW,CARDIFF WALES,33,0,33,144,0,144,-77.08333588
05/03/2007 13:30,2006,2005,London Area Airports,HEATHROW,DURHAM TEES VALLEY,110803,110803,0,152508,152508,0,-27.34610558
05/03/2007 13:30,2006,2005,London Area Airports,HEATHROW,EDINBURGH,1495042,1495034,8,1660261,1659781,480,-9.951387405
05/03/2007 13:30,2006,2005,London Area Airports,HEATHROW,GLASGOW,1284469,1284414,55,1427065,1427065,0,-9.992257118
05/03/2007 13:30,2006,2005,London Area Airports,HEATHROW,INVERNESS,50952,50940,12,65745,65745,0,-22.5005703
05/03/2007 13:30,2006,2005,London Area Airports,HEATHROW,LEEDS BRADFORD,147992,147992,0,178988,178988,0,-17.31736183
05/03/2007 13:30,2006,2005,London Area Airports,HEATHROW,LIVERPOOL,0,0,0,127,0,127,
05/03/2007 13:30,2006,2005,London Area Airports,HEATHROW,LUTON,0,0,0,13,0,13,
05/03/2007 13:30,2006,2005,London Area Airports,HEATHROW,MANCHESTER,1086918,1086906,12,1265160,1265126,34,-14.0884943
05/03/2007 13:30,2006,2005,London Area Airports,HEATHROW,NEWCASTLE,478505,478505,0,527579,527574,5,-9.301734924
05/03/2007 13:30,2006,2005,London Area Airports,HEATHROW,NOTTINGHAM EAST MIDLANDS INT'L,6,0,6,63,0,63,-90.47618866
05/03/2007 13:30,2006,2005,London Area Airports,HEATHROW,PRESTWICK,0,0,0,31,0,31,
05/03/2007 13:30,2006,2005,London Area Airports,LONDON CITY,ABERDEEN,0,0,0,23,0,23,
05/03/2007 13:30,2006,2005,London Area Airports,LONDON CITY,BELFAST CITY,0,0,0,448,448,0,
05/03/2007 13:30,2006,2005,London Area Airports,LONDON CITY,BLACKPOOL,0,0,0,20,0,20,
05/03/2007 13:30,2006,2005,London Area Airports,LONDON CITY,BOURNEMOUTH,0,0,0,36,0,36,
05/03/2007 13:30,2006,2005,London Area Airports,LONDON CITY,BRISTOL,0,0,0,32,0,32,
05/03/2007 13:30,2006,2005,London Area Airports,LONDON CITY,CARDIFF WALES,0,0,0,23,0,23,
05/03/2007 13:30,2006,2005,London Area Airports,LONDON CITY,COVENTRY,0,0,0,10,0,10,
05/03/2007 13:30,2006,2005,London Area Airports,LONDON CITY,DUNDEE,50015,50015,0,46832,46832,0,6.796634674
05/03/2007 13:30,2006,2005,London Area Airports,LONDON CITY,DURHAM TEES VALLEY,0,0,0,34,12,22,
05/03/2007 13:30,2006,2005,London Area Airports,LONDON CITY,EDINBURGH,313934,313934,0,236644,236590,54,32.66087341
05/03/2007 13:30,2006,2005,London Area Airports,LONDON CITY,EXETER,0,0,0,49,0,49,
05/03/2007 13:30,2006,2005,London Area Airports,LONDON CITY,GLASGOW,24,0,24,0,0,0,
05/03/2007 13:30,2006,2005,London Area Airports,LONDON CITY,GLOUCESTERSHIRE,0,0,0,37,0,37,
05/03/2007 13:30,2006,2005,London Area Airports,LONDON CITY,ISLE OF MAN,65200,65200,0,60387,60387,0,7.970258713
05/03/2007 13:30,2006,2005,London Area Airports,LONDON CITY,JERSEY,16034,16034,0,43081,43081,0,-62.78173828
05/03/2007 13:30,2006,2005,London Area Airports,LONDON CITY,LEEDS BRADFORD,0,0,0,6632,6575,57,
05/03/2007 13:30,2006,2005,London Area Airports,LONDON CITY,LIVERPOOL,47931,47931,0,72251,72248,3,-33.66043472
05/03/2007 13:30,2006,2005,London Area Airports,LONDON CITY,LUTON,0,0,0,69,69,0,
05/03/2007 13:30,2006,2005,London Area Airports,LONDON CITY,MANCHESTER,113310,113289,21,115105,115105,0,-1.559445739
05/03/2007 13:30,2006,2005,London Area Airports,LONDON CITY,NEWCASTLE,14575,14575,0,0,0,0,
05/03/2007 13:30,2006,2005,London Area Airports,LONDON CITY,NOTTINGHAM EAST MIDLANDS INT'L,0,0,0,26,0,26,
05/03/2007 13:30,2006,2005,London Area Airports,LONDON CITY,SANDOWN,56,56,0,0,0,0,
05/03/2007 13:30,2006,2005,London Area Airports,LUTON,ABERDEEN,148741,148741,0,156719,156719,0,-5.090640068
05/03/2007 13:30,2006,2005,London Area Airports,LUTON,BELFAST CITY,0,0,0,107,0,107,
05/03/2007 13:30,2006,2005,London Area Airports,LUTON,BELFAST INTERNATIONAL,366395,366395,0,382095,382083,12,-4.108925819
05/03/2007 13:30,2006,2005,London Area Airports,LUTON,BLACKPOOL,136,0,136,78,0,78,74.35897064
05/03/2007 13:30,2006,2005,London Area Airports,LUTON,CARDIFF WALES,71,0,71,1571,0,1571,-95.48058319
05/03/2007 13:30,2006,2005,London Area Airports,LUTON,DONCASTER SHEFFIELD,23,0,23,23,0,23,0
05/03/2007 13:30,2006,2005,London Area Airports,LUTON,DURHAM TEES VALLEY,336,0,336,101,0,101,232.6732635
05/03/2007 13:30,2006,2005,London Area Airports,LUTON,EDINBURGH,443996,443977,19,475882,475576,306,-6.700400352
05/03/2007 13:30,2006,2005,London Area Airports,LUTON,EXETER,71,0,71,0,0,0,
05/03/2007 13:30,2006,2005,London Area Airports,LUTON,GLASGOW,413876,413654,222,451679,451580,99,-8.369439125
05/03/2007 13:30,2006,2005,London Area Airports,LUTON,GUERNSEY,0,0,0,34,34,0,
05/03/2007 13:30,2006,2005,London Area Airports,LUTON,HUMBERSIDE,0,0,0,30,0,30,
05/03/2007 13:30,2006,2005,London Area Airports,LUTON,INVERNESS,100492,100354,138,102359,102347,12,-1.823972464
05/03/2007 13:30,2006,2005,London Area Airports,LUTON,ISLE OF MAN,55554,55554,0,31419,31419,0,76.8165741
05/03/2007 13:30,2006,2005,London Area Airports,LUTON,JERSEY,3707,3707,0,3283,3139,144,12.91501713
05/03/2007 13:30,2006,2005,London Area Airports,LUTON,KENT INTERNATIONAL,0,0,0,14,0,14,
05/03/2007 13:30,2006,2005,London Area Airports,LUTON,LEEDS BRADFORD,14,0,14,83,0,83,-83.13253021
05/03/2007 13:30,2006,2005,London Area Airports,LUTON,LIVERPOOL,154,0,154,26,0,26,492.3076782
05/03/2007 13:30,2006,2005,London Area Airports,LUTON,MANCHESTER,599,0,599,343,77,266,74.63556671
05/03/2007 13:30,2006,2005,London Area Airports,LUTON,NEWCASTLE,299,0,299,191,0,191,56.54450226
05/03/2007 13:30,2006,2005,London Area Airports,LUTON,NEWQUAY,2623,2623,0,0,0,0,
05/03/2007 13:30,2006,2005,London Area Airports,LUTON,NOTTINGHAM EAST MIDLANDS INT'L,0,0,0,55,0,55,
05/03/2007 13:30,2006,2005,London Area Airports,LUTON,PLYMOUTH,92,0,92,81,0,81,13.58024693
05/03/2007 13:30,2006,2005,London Area Airports,LUTON,PRESTWICK,17,0,17,0,0,0,
05/03/2007 13:30,2006,2005,London Area Airports,LUTON,SUMBURGH,0,0,0,147,0,147,
05/03/2007 13:30,2006,2005,London Area Airports,SOUTHEND,CARDIFF WALES,0,0,0,200,0,200,
05/03/2007 13:30,2006,2005,London Area Airports,SOUTHEND,JERSEY,2913,2763,150,2911,2911,0,0.068704911
05/03/2007 13:30,2006,2005,London Area Airports,SOUTHEND,MANCHESTER,67,0,67,0,0,0,
05/03/2007 13:30,2006,2005,London Area Airports,SOUTHEND,PLYMOUTH,49,0,49,0,0,0,
05/03/2007 13:30,2006,2005,London Area Airports,STANSTED,BELFAST CITY,62001,62001,0,55,0,55,112629.0938
05/03/2007 13:30,2006,2005,London Area Airports,STANSTED,BELFAST INTERNATIONAL,373931,373931,0,391027,391006,21,-4.372076511
05/03/2007 13:30,2006,2005,London Area Airports,STANSTED,BIGGIN HILL,8,0,8,0,0,0,
05/03/2007 13:30,2006,2005,London Area Airports,STANSTED,BIRMINGHAM,135,135,0,9,0,9,1400
05/03/2007 13:30,2006,2005,London Area Airports,STANSTED,BLACKPOOL,121716,121689,27,130768,130768,0,-6.92218256
05/03/2007 13:30,2006,2005,London Area Airports,STANSTED,CARDIFF WALES,992,0,992,1100,0,1100,-9.818181992
05/03/2007 13:30,2006,2005,London Area Airports,STANSTED,CITY OF DERRY (EGLINTON),153785,153785,0,106390,106390,0,44.54835892
05/03/2007 13:30,2006,2005,London Area Airports,STANSTED,DONCASTER SHEFFIELD,0,0,0,12,0,12,
05/03/2007 13:30,2006,2005,London Area Airports,STANSTED,EDINBURGH,470164,469942,222,520628,519913,715,-9.692909241
05/03/2007 13:30,2006,2005,London Area Airports,STANSTED,EXETER,75,0,75,0,0,0,
05/03/2007 13:30,2006,2005,London Area Airports,STANSTED,GLASGOW,461556,461556,0,436393,436325,68,5.766132832
05/03/2007 13:30,2006,2005,London Area Airports,STANSTED,GUERNSEY,30846,30846,0,33599,33599,0,-8.193696022
05/03/2007 13:30,2006,2005,London Area Airports,STANSTED,ISLE OF MAN,140,140,0,12948,12948,0,-98.91875458
05/03/2007 13:30,2006,2005,London Area Airports,STANSTED,JERSEY,19398,17657,1741,1720,0,1720,1027.790649
05/03/2007 13:30,2006,2005,London Area Airports,STANSTED,LIVERPOOL,3620,0,3620,0,0,0,
05/03/2007 13:30,2006,2005,London Area Airports,STANSTED,MANCHESTER,103699,103327,372,22066,21354,712,369.9492493
05/03/2007 13:30,2006,2005,London Area Airports,STANSTED,NEWCASTLE,303682,303682,0,319406,318760,646,-4.922888279
05/03/2007 13:30,2006,2005,London Area Airports,STANSTED,NEWQUAY,101585,101585,0,183847,183828,19,-44.74481583
05/03/2007 13:30,2006,2005,London Area Airports,STANSTED,NOTTINGHAM EAST MIDLANDS INT'L,0,0,0,22,0,22,
05/03/2007 13:30,2006,2005,London Area Airports,STANSTED,PRESTWICK,469623,469605,18,504844,504844,0,-6.976610661
05/03/2007 13:30,2006,2005,London Area Airports,STANSTED,SUMBURGH,69,69,0,0,0,0,
05/03/2007 13:30,2006,2005,London Area Airports,STANSTED,WICK,34,0,34,0,0,0,
05/03/2007 13:30,2006,2005,Other UK Airports,ABERDEEN,BELFAST CITY,29916,29916,0,24154,24154,0,23.85526276
05/03/2007 13:30,2006,2005,Other UK Airports,ABERDEEN,BELFAST INTERNATIONAL,0,0,0,2506,2506,0,
05/03/2007 13:30,2006,2005,Other UK Airports,ABERDEEN,BIRMINGHAM,77948,77948,0,60538,60538,0,28.75879669
05/03/2007 13:30,2006,2005,Other UK Airports,ABERDEEN,BLACKPOOL,0,0,0,1707,1707,0,
05/03/2007 13:30,2006,2005,Other UK Airports,ABERDEEN,BRISTOL,28686,28686,0,19535,19535,0,46.84412766
05/03/2007 13:30,2006,2005,Other UK Airports,ABERDEEN,CARDIFF WALES,1354,1354,0,13658,13658,0,-90.08639526
05/03/2007 13:30,2006,2005,Other UK Airports,ABERDEEN,DURHAM TEES VALLEY,33710,33452,258,24301,24301,0,38.71857071
05/03/2007 13:30,2006,2005,Other UK Airports,ABERDEEN,EDINBURGH,10,0,10,13,13,0,-23.07692337
05/03/2007 13:30,2006,2005,Other UK Airports,ABERDEEN,EXETER,3337,3337,0,0,0,0,
05/03/2007 13:30,2006,2005,Other UK Airports,ABERDEEN,GLASGOW,0,0,0,1131,1131,0,
05/03/2007 13:30,2006,2005,Other UK Airports,ABERDEEN,HUMBERSIDE,29607,29607,0,29917,29917,0,-1.036200166
05/03/2007 13:30,2006,2005,Other UK Airports,ABERDEEN,INVERNESS,0,0,0,1,1,0,
05/03/2007 13:30,2006,2005,Other UK Airports,ABERDEEN,JERSEY,1545,0,1545,1622,0,1622,-4.747225761
05/03/2007 13:30,2006,2005,Other UK Airports,ABERDEEN,KIRKWALL,42228,42228,0,39119,39119,0,7.947544575
05/03/2007 13:30,2006,2005,Other UK Airports,ABERDEEN,LEEDS BRADFORD,20895,20895,0,16637,16637,0,25.59355736
05/03/2007 13:30,2006,2005,Other UK Airports,ABERDEEN,LIVERPOOL,17717,17717,0,0,0,0,
05/03/2007 13:30,2006,2005,Other UK Airports,ABERDEEN,LYNEHAM,5,0,5,0,0,0,
05/03/2007 13:30,2006,2005,Other UK Airports,ABERDEEN,MANCHESTER,134665,134409,256,119370,119370,0,12.81310177
05/03/2007 13:30,2006,2005,Other UK Airports,ABERDEEN,NEWCASTLE,26707,26546,161,21152,21152,0,26.26229286
05/03/2007 13:30,2006,2005,Other UK Airports,ABERDEEN,NEWQUAY,0,0,0,9,0,9,
05/03/2007 13:30,2006,2005,Other UK Airports,ABERDEEN,NORWICH,68685,68685,0,57551,57551,0,19.3463192
05/03/2007 13:30,2006,2005,Other UK Airports,ABERDEEN,NOTTINGHAM EAST MIDLANDS INT'L,22525,22525,0,21163,21163,0,6.435760498
05/03/2007 13:30,2006,2005,Other UK Airports,ABERDEEN,SCATSTA,138439,0,138439,129898,0,129898,6.575159073
05/03/2007 13:30,2006,2005,Other UK Airports,ABERDEEN,SOUTHAMPTON,33176,33176,0,29968,29968,0,10.70475197
05/03/2007 13:30,2006,2005,Other UK Airports,ABERDEEN,STORNOWAY,5371,5305,66,0,0,0,
05/03/2007 13:30,2006,2005,Other UK Airports,ABERDEEN,SUMBURGH,68781,64680,4101,64286,63004,1282,6.992191315
05/03/2007 13:30,2006,2005,Other UK Airports,ABERDEEN,WICK,12724,12610,114,10051,9863,188,26.59436798
05/03/2007 13:30,2006,2005,Other UK Airports,ALDERNEY,GUERNSEY,28474,28474,0,28083,28083,0,1.39230144
05/03/2007 13:30,2006,2005,Other UK Airports,ALDERNEY,JERSEY,0,0,0,54,54,0,
05/03/2007 13:30,2006,2005,Other UK Airports,ALDERNEY,SOUTHAMPTON,27068,27068,0,25870,25870,0,4.6308465
05/03/2007 13:30,2006,2005,Other UK Airports,BARRA,BENBECULA,1731,1731,0,2042,2042,0,-15.23016644
05/03/2007 13:30,2006,2005,Other UK Airports,BARRA,GLASGOW,8077,8077,0,7424,7424,0,8.795797348
05/03/2007 13:30,2006,2005,Other UK Airports,BELFAST CITY,BIRMINGHAM,263934,263934,0,292097,292059,38,-9.641659737
05/03/2007 13:30,2006,2005,Other UK Airports,BELFAST CITY,BLACKPOOL,4840,4840,0,8909,8909,0,-45.67291641
05/03/2007 13:30,2006,2005,Other UK Airports,BELFAST CITY,BRISTOL,24923,24923,0,62641,62641,0,-60.21295929
05/03/2007 13:30,2006,2005,Other UK Airports,BELFAST CITY,CARDIFF WALES,24,24,0,83,17,66,-71.08433533
05/03/2007 13:30,2006,2005,Other UK Airports,BELFAST CITY,DONCASTER SHEFFIELD,7259,7259,0,0,0,0,
05/03/2007 13:30,2006,2005,Other UK Airports,BELFAST CITY,EDINBURGH,108923,108923,0,113136,113136,0,-3.723836899
05/03/2007 13:30,2006,2005,Other UK Airports,BELFAST CITY,EXETER,38337,38337,0,39545,39545,0,-3.05474782
05/03/2007 13:30,2006,2005,Other UK Airports,BELFAST CITY,FARNBOROUGH,0,0,0,19,0,19,
05/03/2007 13:30,2006,2005,Other UK Airports,BELFAST CITY,GLASGOW,116099,116033,66,124583,124505,78,-6.809917927
05/03/2007 13:30,2006,2005,Other UK Airports,BELFAST CITY,INVERNESS,903,903,0,0,0,0,
05/03/2007 13:30,2006,2005,Other UK Airports,BELFAST CITY,ISLE OF MAN,23644,23644,0,26739,26739,0,-11.57485294
05/03/2007 13:30,2006,2005,Other UK Airports,BELFAST CITY,JERSEY,6404,6372,32,7181,7181,0,-10.82021999
05/03/2007 13:30,2006,2005,Other UK Airports,BELFAST CITY,LEEDS BRADFORD,83741,83741,0,96428,96428,0,-13.15696716
05/03/2007 13:30,2006,2005,Other UK Airports,BELFAST CITY,LIVERPOOL,51424,51424,0,110334,110334,0,-53.39242554
05/03/2007 13:30,2006,2005,Other UK Airports,BELFAST CITY,MANCHESTER,243304,243304,0,129209,129138,71,88.30267334
05/03/2007 13:30,2006,2005,Other UK Airports,BELFAST CITY,NEWCASTLE,27858,27858,0,76578,76578,0,-63.62140656
05/03/2007 13:30,2006,2005,Other UK Airports,BELFAST CITY,NORTHOLT,0,0,0,13,0,13,
05/03/2007 13:30,2006,2005,Other UK Airports,BELFAST CITY,NORWICH,708,708,0,27397,27397,0,-97.41577911
05/03/2007 13:30,2006,2005,Other UK Airports,BELFAST CITY,PRESTWICK,26,0,26,0,0,0,
05/03/2007 13:30,2006,2005,Other UK Airports,BELFAST CITY,SOUTHAMPTON,97815,97815,0,111644,111644,0,-12.386693
05/03/2007 13:30,2006,2005,Other UK Airports,BELFAST INTERNATIONAL,BIRMINGHAM,176141,176141,0,125410,125203,207,40.45211792
05/03/2007 13:30,2006,2005,Other UK Airports,BELFAST INTERNATIONAL,BLACKPOOL,54392,54392,0,4955,4955,0,997.7194824
05/03/2007 13:30,2006,2005,Other UK Airports,BELFAST INTERNATIONAL,BOURNEMOUTH,52,0,52,27192,27016,176,-99.80876923
05/03/2007 13:30,2006,2005,Other UK Airports,BELFAST INTERNATIONAL,BRISTOL,242941,242941,0,233607,233607,0,3.995599508
05/03/2007 13:30,2006,2005,Other UK Airports,BELFAST INTERNATIONAL,CARDIFF WALES,63791,63697,94,42844,42844,0,48.8913269
05/03/2007 13:30,2006,2005,Other UK Airports,BELFAST INTERNATIONAL,DURHAM TEES VALLEY,0,0,0,6598,6598,0,
05/03/2007 13:30,2006,2005,Other UK Airports,BELFAST INTERNATIONAL,EDINBURGH,314353,314247,106,326040,325847,193,-3.5845294
05/03/2007 13:30,2006,2005,Other UK Airports,BELFAST INTERNATIONAL,EXETER,53,0,53,0,0,0,
05/03/2007 13:30,2006,2005,Other UK Airports,BELFAST INTERNATIONAL,GLASGOW,310003,310003,0,333294,333250,44,-6.988124371
05/03/2007 13:30,2006,2005,Other UK Airports,BELFAST INTERNATIONAL,INVERNESS,39801,39801,0,29228,29202,26,36.17421722
05/03/2007 13:30,2006,2005,Other UK Airports,BELFAST INTERNATIONAL,ISLE OF MAN,4959,4959,0,0,0,0,
05/03/2007 13:30,2006,2005,Other UK Airports,BELFAST INTERNATIONAL,JERSEY,889,0,889,1435,0,1435,-38.04878235
05/03/2007 13:30,2006,2005,Other UK Airports,BELFAST INTERNATIONAL,KENT INTERNATIONAL,0,0,0,4563,4563,0,
05/03/2007 13:30,2006,2005,Other UK Airports,BELFAST INTERNATIONAL,LEEDS BRADFORD,112134,112134,0,96055,96055,0,16.73936844
05/03/2007 13:30,2006,2005,Other UK Airports,BELFAST INTERNATIONAL,LIVERPOOL,475256,475256,0,524805,524805,0,-9.441411972
05/03/2007 13:30,2006,2005,Other UK Airports,BELFAST INTERNATIONAL,MANCHESTER,179718,179718,0,173329,173329,0,3.686053753
05/03/2007 13:30,2006,2005,Other UK Airports,BELFAST INTERNATIONAL,NEWCASTLE,230438,230438,0,199277,199251,26,15.63702774
05/03/2007 13:30,2006,2005,Other UK Airports,BELFAST INTERNATIONAL,NEWQUAY,0,0,0,11,0,11,
05/03/2007 13:30,2006,2005,Other UK Airports,BELFAST INTERNATIONAL,NORTHOLT,0,0,0,9,0,9,
05/03/2007 13:30,2006,2005,Other UK Airports,BELFAST INTERNATIONAL,NOTTINGHAM EAST MIDLANDS INT'L,165989,165989,0,165297,165205,92,0.418640375
05/03/2007 13:30,2006,2005,Other UK Airports,BELFAST INTERNATIONAL,PRESTWICK,0,0,0,20,0,20,
05/03/2007 13:30,2006,2005,Other UK Airports,BENBECULA,GLASGOW,22582,22582,0,20986,20986,0,7.605070114
05/03/2007 13:30,2006,2005,Other UK Airports,BENBECULA,INVERNESS,1071,1071,0,0,0,0,
05/03/2007 13:30,2006,2005,Other UK Airports,BENBECULA,STORNOWAY,8698,8698,0,9011,9011,0,-3.473532438
05/03/2007 13:30,2006,2005,Other UK Airports,BIGGIN HILL,EDINBURGH,0,0,0,17,17,0,
05/03/2007 13:30,2006,2005,Other UK Airports,BIGGIN HILL,JERSEY,0,0,0,24,24,0,
05/03/2007 13:30,2006,2005,Other UK Airports,BIGGIN HILL,LYDD,0,0,0,29,0,29,
05/03/2007 13:30,2006,2005,Other UK Airports,BIRMINGHAM,BRISTOL,0,0,0,106,0,106,
05/03/2007 13:30,2006,2005,Other UK Airports,BIRMINGHAM,CITY OF DERRY (EGLINTON),0,0,0,9172,9172,0,
05/03/2007 13:30,2006,2005,Other UK Airports,BIRMINGHAM,EDINBURGH,495309,494741,568,471139,470333,806,5.130120754
05/03/2007 13:30,2006,2005,Other UK Airports,BIRMINGHAM,GLASGOW,326470,325912,558,324281,323492,789,0.675031841
05/03/2007 13:30,2006,2005,Other UK Airports,BIRMINGHAM,GUERNSEY,47127,47086,41,50831,50705,126,-7.286891937
05/03/2007 13:30,2006,2005,Other UK Airports,BIRMINGHAM,INVERNESS,18216,18107,109,15309,15309,0,18.98883057
05/03/2007 13:30,2006,2005,Other UK Airports,BIRMINGHAM,ISLE OF MAN,56072,56072,0,63923,63923,0,-12.2819643
05/03/2007 13:30,2006,2005,Other UK Airports,BIRMINGHAM,JERSEY,37930,37822,108,58320,56766,1554,-34.96227646
05/03/2007 13:30,2006,2005,Other UK Airports,BIRMINGHAM,KINLOSS,109,0,109,101,0,101,7.920792103
05/03/2007 13:30,2006,2005,Other UK Airports,BIRMINGHAM,NEWCASTLE,25189,25189,0,25333,24893,440,-0.568428516
05/03/2007 13:30,2006,2005,Other UK Airports,BIRMINGHAM,NEWQUAY,0,0,0,21770,21770,0,
05/03/2007 13:30,2006,2005,Other UK Airports,BIRMINGHAM,SOUTHAMPTON,40,40,0,0,0,0,
05/03/2007 13:30,2006,2005,Other UK Airports,BLACKPOOL,CARDIFF WALES,0,0,0,592,0,592,
05/03/2007 13:30,2006,2005,Other UK Airports,BLACKPOOL,CITY OF DERRY (EGLINTON),0,0,0,46,0,46,
05/03/2007 13:30,2006,2005,Other UK Airports,BLACKPOOL,ISLE OF MAN,17134,16988,146,16588,16588,0,3.291536093
05/03/2007 13:30,2006,2005,Other UK Airports,BLACKPOOL,JERSEY,105,0,105,153,0,153,-31.37254906
05/03/2007 13:30,2006,2005,Other UK Airports,BLACKPOOL,SOUTH MARSTON,23,0,23,0,0,0,
05/03/2007 13:30,2006,2005,Other UK Airports,BOURNEMOUTH,GUERNSEY,231,0,231,130,130,0,77.69230652
05/03/2007 13:30,2006,2005,Other UK Airports,BOURNEMOUTH,INVERNESS,0,0,0,246,0,246,
05/03/2007 13:30,2006,2005,Other UK Airports,BOURNEMOUTH,ISLE OF MAN,258,0,258,492,0,492,-47.56097412
05/03/2007 13:30,2006,2005,Other UK Airports,BOURNEMOUTH,JERSEY,2459,0,2459,3407,136,3271,-27.82506561
05/03/2007 13:30,2006,2005,Other UK Airports,BOURNEMOUTH,LIVERPOOL,78,0,78,34,0,34,129.4117584
05/03/2007 13:30,2006,2005,Other UK Airports,BOURNEMOUTH,PRESTWICK,93294,93294,0,97539,97539,0,-4.352105141
05/03/2007 13:30,2006,2005,Other UK Airports,BRISTOL,CARDIFF WALES,0,0,0,109,109,0,
05/03/2007 13:30,2006,2005,Other UK Airports,BRISTOL,DUNDEE,2,2,0,0,0,0,
05/03/2007 13:30,2006,2005,Other UK Airports,BRISTOL,DURHAM TEES VALLEY,3288,3288,0,1625,1625,0,102.3384628
05/03/2007 13:30,2006,2005,Other UK Airports,BRISTOL,EDINBURGH,318169,318169,0,329745,329745,0,-3.510591507
05/03/2007 13:30,2006,2005,Other UK Airports,BRISTOL,GLASGOW,279870,279870,0,299271,299271,0,-6.482753277
05/03/2007 13:30,2006,2005,Other UK Airports,BRISTOL,GUERNSEY,28783,28783,0,28290,28290,0,1.742665291
05/03/2007 13:30,2006,2005,Other UK Airports,BRISTOL,INVERNESS,82487,82487,0,41298,41298,0,99.7360611
05/03/2007 13:30,2006,2005,Other UK Airports,BRISTOL,ISLE OF MAN,11577,11577,0,13070,12999,71,-11.42310619
05/03/2007 13:30,2006,2005,Other UK Airports,BRISTOL,ISLES OF SCILLY (ST.MARYS),4673,4673,0,4638,4638,0,0.754635632
05/03/2007 13:30,2006,2005,Other UK Airports,BRISTOL,JERSEY,42418,42418,0,34085,34085,0,24.44770432
05/03/2007 13:30,2006,2005,Other UK Airports,BRISTOL,LEEDS BRADFORD,33449,33449,0,26393,26385,8,26.73436165
05/03/2007 13:30,2006,2005,Other UK Airports,BRISTOL,MANCHESTER,33006,33006,0,44520,44272,248,-25.86253357
05/03/2007 13:30,2006,2005,Other UK Airports,BRISTOL,NEWCASTLE,246253,246253,0,252970,252957,13,-2.655255556
05/03/2007 13:30,2006,2005,Other UK Airports,BRISTOL,NEWQUAY,8619,8619,0,11052,11052,0,-22.01411438
05/03/2007 13:30,2006,2005,Other UK Airports,BRISTOL,NORWICH,13043,13043,0,0,0,0,
05/03/2007 13:30,2006,2005,Other UK Airports,BRISTOL,PLYMOUTH,7951,7951,0,12951,12951,0,-38.60705566
05/03/2007 13:30,2006,2005,Other UK Airports,BRISTOL,PRESTWICK,22,0,22,0,0,0,
05/03/2007 13:30,2006,2005,Other UK Airports,BRISTOL,WICK,7,0,7,0,0,0,
05/03/2007 13:30,2006,2005,Other UK Airports,CAMBRIDGE,JERSEY,0,0,0,41,0,41,
05/03/2007 13:30,2006,2005,Other UK Airports,CAMBRIDGE,PRESTWICK,0,0,0,4,0,4,
05/03/2007 13:30,2006,2005,Other UK Airports,CAMPBELTOWN,GLASGOW,8773,8773,0,8736,8736,0,0.423534811
05/03/2007 13:30,2006,2005,Other UK Airports,CAMPBELTOWN,ISLAY,132,132,0,45,45,0,193.3333282
05/03/2007 13:30,2006,2005,Other UK Airports,CARDIFF WALES,EDINBURGH,156332,156272,60,159513,152806,6707,-1.994194865
05/03/2007 13:30,2006,2005,Other UK Airports,CARDIFF WALES,GLASGOW,82460,82342,118,84,0,84,98066.66406
05/03/2007 13:30,2006,2005,Other UK Airports,CARDIFF WALES,JERSEY,16170,16070,100,17300,17184,116,-6.531791687
05/03/2007 13:30,2006,2005,Other UK Airports,CARDIFF WALES,LIVERPOOL,371,0,371,6382,6288,94,-94.18677521
05/03/2007 13:30,2006,2005,Other UK Airports,CARDIFF WALES,MANCHESTER,12757,11869,888,1151,0,1151,1008.340576
05/03/2007 13:30,2006,2005,Other UK Airports,CARDIFF WALES,NEWCASTLE,19219,19112,107,25697,20921,4776,-25.20916748
05/03/2007 13:30,2006,2005,Other UK Airports,CARDIFF WALES,NEWQUAY,8095,8095,0,0,0,0,
05/03/2007 13:30,2006,2005,Other UK Airports,CARDIFF WALES,NORWICH,97,0,97,645,564,81,-84.96124268
05/03/2007 13:30,2006,2005,Other UK Airports,CARDIFF WALES,PLYMOUTH,190,190,0,2727,2727,0,-93.03263855
05/03/2007 13:30,2006,2005,Other UK Airports,CARDIFF WALES,PRESTWICK,4873,4848,25,32800,32800,0,-85.14329529
05/03/2007 13:30,2006,2005,Other UK Airports,CITY OF DERRY (EGLINTON),EDINBURGH,102,0,102,0,0,0,
05/03/2007 13:30,2006,2005,Other UK Airports,CITY OF DERRY (EGLINTON),GLASGOW,15858,15858,0,14273,14273,0,11.10488319
05/03/2007 13:30,2006,2005,Other UK Airports,CITY OF DERRY (EGLINTON),LIVERPOOL,69533,69533,0,64,0,64,108545.3125
05/03/2007 13:30,2006,2005,Other UK Airports,CITY OF DERRY (EGLINTON),MANCHESTER,287,287,0,17319,17319,0,-98.34285736
05/03/2007 13:30,2006,2005,Other UK Airports,CITY OF DERRY (EGLINTON),NOTTINGHAM EAST MIDLANDS INT'L,51008,51008,0,0,0,0,
05/03/2007 13:30,2006,2005,Other UK Airports,CITY OF DERRY (EGLINTON),PRESTWICK,2783,2783,0,0,0,0,
05/03/2007 13:30,2006,2005,Other UK Airports,CITY OF DERRY (EGLINTON),STORNOWAY,95,0,95,0,0,0,
05/03/2007 13:30,2006,2005,Other UK Airports,COVENTRY,DONCASTER SHEFFIELD,130,130,0,0,0,0,
05/03/2007 13:30,2006,2005,Other UK Airports,COVENTRY,DURHAM TEES VALLEY,0,0,0,42,0,42,
05/03/2007 13:30,2006,2005,Other UK Airports,COVENTRY,GUERNSEY,153,0,153,103,0,103,48.54368973
05/03/2007 13:30,2006,2005,Other UK Airports,COVENTRY,ISLE OF MAN,279,0,279,0,0,0,
05/03/2007 13:30,2006,2005,Other UK Airports,COVENTRY,JERSEY,60071,60071,0,58813,58813,0,2.138982773
05/03/2007 13:30,2006,2005,Other UK Airports,COVENTRY,KIRKWALL,50,0,50,51,0,51,-1.960784316
05/03/2007 13:30,2006,2005,Other UK Airports,COVENTRY,NEWCASTLE,132,0,132,0,0,0,
05/03/2007 13:30,2006,2005,Other UK Airports,DONCASTER SHEFFIELD,FARNBOROUGH,70,0,70,0,0,0,
05/03/2007 13:30,2006,2005,Other UK Airports,DONCASTER SHEFFIELD,GLASGOW,18,0,18,0,0,0,
05/03/2007 13:30,2006,2005,Other UK Airports,DONCASTER SHEFFIELD,JERSEY,57215,57215,0,42390,42390,0,34.97286987
05/03/2007 13:30,2006,2005,Other UK Airports,DONCASTER SHEFFIELD,PLYMOUTH,0,0,0,38,0,38,
05/03/2007 13:30,2006,2005,Other UK Airports,DUNDEE,DURHAM TEES VALLEY,0,0,0,54,0,54,
05/03/2007 13:30,2006,2005,Other UK Airports,DUNDEE,EDINBURGH,4,0,4,0,0,0,
05/03/2007 13:30,2006,2005,Other UK Airports,DUNDEE,GUERNSEY,1007,0,1007,0,0,0,
05/03/2007 13:30,2006,2005,Other UK Airports,DUNDEE,HUMBERSIDE,16,16,0,0,0,0,
05/03/2007 13:30,2006,2005,Other UK Airports,DUNDEE,JERSEY,625,0,625,1691,0,1691,-63.03962326
05/03/2007 13:30,2006,2005,Other UK Airports,DUNDEE,MANCHESTER,14,14,0,110,0,110,-87.27272797
05/03/2007 13:30,2006,2005,Other UK Airports,DUNKESWELL,JERSEY,1,0,1,0,0,0,
05/03/2007 13:30,2006,2005,Other UK Airports,DURHAM TEES VALLEY,EDINBURGH,30,0,30,0,0,0,
05/03/2007 13:30,2006,2005,Other UK Airports,DURHAM TEES VALLEY,FAIRFORD,96,0,96,0,0,0,
05/03/2007 13:30,2006,2005,Other UK Airports,DURHAM TEES VALLEY,FARNBOROUGH,0,0,0,17,0,17,
05/03/2007 13:30,2006,2005,Other UK Airports,DURHAM TEES VALLEY,FILTON,0,0,0,92,0,92,
05/03/2007 13:30,2006,2005,Other UK Airports,DURHAM TEES VALLEY,GLASGOW,243,0,243,0,0,0,
05/03/2007 13:30,2006,2005,Other UK Airports,DURHAM TEES VALLEY,HUMBERSIDE,0,0,0,9,0,9,
05/03/2007 13:30,2006,2005,Other UK Airports,DURHAM TEES VALLEY,JERSEY,22751,22751,0,17279,17279,0,31.66849899
05/03/2007 13:30,2006,2005,Other UK Airports,DURHAM TEES VALLEY,MANCHESTER,0,0,0,29,0,29,
05/03/2007 13:30,2006,2005,Other UK Airports,DURHAM TEES VALLEY,NEWQUAY,24019,24019,0,12886,12886,0,86.39608765
05/03/2007 13:30,2006,2005,Other UK Airports,DURHAM TEES VALLEY,NORTHOLT,0,0,0,7,0,7,
05/03/2007 13:30,2006,2005,Other UK Airports,DURHAM TEES VALLEY,PLYMOUTH,98,0,98,0,0,0,
05/03/2007 13:30,2006,2005,Other UK Airports,DURHAM TEES VALLEY,SOUTHAMPTON,0,0,0,66,0,66,
05/03/2007 13:30,2006,2005,Other UK Airports,DURHAM TEES VALLEY,WICK,1,0,1,0,0,0,
05/03/2007 13:30,2006,2005,Other UK Airports,EDAY,KIRKWALL,471,471,0,527,527,0,-10.62618637
05/03/2007 13:30,2006,2005,Other UK Airports,EDINBURGH,EXETER,82910,82910,0,70887,70887,0,16.96079636
05/03/2007 13:30,2006,2005,Other UK Airports,EDINBURGH,FARNBOROUGH,16,0,16,30,0,30,-46.66666794
05/03/2007 13:30,2006,2005,Other UK Airports,EDINBURGH,INVERNESS,15315,15315,0,17130,17130,0,-10.59544659
05/03/2007 13:30,2006,2005,Other UK Airports,EDINBURGH,ISLE OF MAN,5971,5971,0,0,0,0,
05/03/2007 13:30,2006,2005,Other UK Airports,EDINBURGH,JERSEY,26549,25694,855,9181,8273,908,189.1732941
05/03/2007 13:30,2006,2005,Other UK Airports,EDINBURGH,KENT INTERNATIONAL,0,0,0,32259,32259,0,
05/03/2007 13:30,2006,2005,Other UK Airports,EDINBURGH,KIRKWALL,23226,23226,0,20423,20423,0,13.72472191
05/03/2007 13:30,2006,2005,Other UK Airports,EDINBURGH,LEEDS BRADFORD,50771,50771,0,51811,51811,0,-2.007295847
05/03/2007 13:30,2006,2005,Other UK Airports,EDINBURGH,LIVERPOOL,0,0,0,17714,17714,0,
05/03/2007 13:30,2006,2005,Other UK Airports,EDINBURGH,MANCHESTER,257595,257595,0,285943,285927,16,-9.913864136
05/03/2007 13:30,2006,2005,Other UK Airports,EDINBURGH,NEWCASTLE,0,0,0,9,0,9,
05/03/2007 13:30,2006,2005,Other UK Airports,EDINBURGH,NEWQUAY,5443,5443,0,0,0,0,
05/03/2007 13:30,2006,2005,Other UK Airports,EDINBURGH,NORWICH,64043,64043,0,52652,52652,0,21.63450623
05/03/2007 13:30,2006,2005,Other UK Airports,EDINBURGH,NOTTINGHAM EAST MIDLANDS INT'L,175810,175002,808,240443,240408,35,-26.88079834
05/03/2007 13:30,2006,2005,Other UK Airports,EDINBURGH,SOUTHAMPTON,237463,237463,0,221361,221361,0,7.274090767
05/03/2007 13:30,2006,2005,Other UK Airports,EDINBURGH,STORNOWAY,27136,27136,0,29755,29755,0,-8.80188179
05/03/2007 13:30,2006,2005,Other UK Airports,EDINBURGH,SUMBURGH,23297,23297,0,21901,21901,0,6.374138355
05/03/2007 13:30,2006,2005,Other UK Airports,EDINBURGH,WICK,4796,4761,35,4895,4895,0,-2.022471905
05/03/2007 13:30,2006,2005,Other UK Airports,EXETER,GLASGOW,53111,53111,0,41950,41950,0,26.6054821
05/03/2007 13:30,2006,2005,Other UK Airports,EXETER,GUERNSEY,27936,27936,0,31719,31719,0,-11.92660522
05/03/2007 13:30,2006,2005,Other UK Airports,EXETER,ISLES OF SCILLY (ST.MARYS),4199,4199,0,4392,4392,0,-4.39435339
05/03/2007 13:30,2006,2005,Other UK Airports,EXETER,JERSEY,34554,34554,0,39008,39008,0,-11.41817093
05/03/2007 13:30,2006,2005,Other UK Airports,EXETER,LEEDS BRADFORD,33797,33797,0,23235,23235,0,45.45728302
05/03/2007 13:30,2006,2005,Other UK Airports,EXETER,LIVERPOOL,1356,1356,0,15547,15547,0,-91.27806091
05/03/2007 13:30,2006,2005,Other UK Airports,EXETER,MANCHESTER,49499,49499,0,0,0,0,
05/03/2007 13:30,2006,2005,Other UK Airports,EXETER,NEWCASTLE,54249,54249,0,46295,46295,0,17.18112183
05/03/2007 13:30,2006,2005,Other UK Airports,EXETER,NORWICH,19985,19924,61,0,0,0,
05/03/2007 13:30,2006,2005,Other UK Airports,FAIR ISLE,LERWICK (TINGWALL),2327,2327,0,2316,2316,0,0.47495681
05/03/2007 13:30,2006,2005,Other UK Airports,FAIR ISLE,SUMBURGH,94,94,0,434,434,0,-78.34101105
05/03/2007 13:30,2006,2005,Other UK Airports,FARNBOROUGH,GLASGOW,67,0,67,48,0,48,39.58333206
05/03/2007 13:30,2006,2005,Other UK Airports,FARNBOROUGH,INVERNESS,47,0,47,0,0,0,
05/03/2007 13:30,2006,2005,Other UK Airports,FARNBOROUGH,ISLE OF MAN,0,0,0,60,0,60,
05/03/2007 13:30,2006,2005,Other UK Airports,FARNBOROUGH,LIVERPOOL,110,0,110,39,0,39,182.0512848
05/03/2007 13:30,2006,2005,Other UK Airports,FARNBOROUGH,MANCHESTER,53,0,53,95,0,95,-44.21052551
05/03/2007 13:30,2006,2005,Other UK Airports,FARNBOROUGH,NEWCASTLE,67,0,67,0,0,0,
05/03/2007 13:30,2006,2005,Other UK Airports,FARNBOROUGH,PRESTWICK,39,0,39,0,0,0,
05/03/2007 13:30,2006,2005,Other UK Airports,FOULA,LERWICK (TINGWALL),1342,1342,0,1107,1107,0,21.22854614
05/03/2007 13:30,2006,2005,Other UK Airports,GLASGOW,INVERNESS,1943,1897,46,5640,5640,0,-65.54964447
05/03/2007 13:30,2006,2005,Other UK Airports,GLASGOW,ISLAY,26073,25993,80,21819,21819,0,19.49676895
05/03/2007 13:30,2006,2005,Other UK Airports,GLASGOW,ISLE OF MAN,21840,21840,0,29713,29713,0,-26.49682045
05/03/2007 13:30,2006,2005,Other UK Airports,GLASGOW,JERSEY,7449,6546,903,10334,7701,2633,-27.91755295
05/03/2007 13:30,2006,2005,Other UK Airports,GLASGOW,KENT INTERNATIONAL,0,0,0,2200,2200,0,
05/03/2007 13:30,2006,2005,Other UK Airports,GLASGOW,KIRKWALL,11649,11649,0,6940,6940,0,67.85302734
05/03/2007 13:30,2006,2005,Other UK Airports,GLASGOW,LEEDS BRADFORD,40959,40959,0,42776,42776,0,-4.247708797
05/03/2007 13:30,2006,2005,Other UK Airports,GLASGOW,LIVERPOOL,0,0,0,12401,12401,0,
05/03/2007 13:30,2006,2005,Other UK Airports,GLASGOW,MANCHESTER,171150,170375,775,169929,169895,34,0.718535364
05/03/2007 13:30,2006,2005,Other UK Airports,GLASGOW,NEWCASTLE,13,13,0,0,0,0,
05/03/2007 13:30,2006,2005,Other UK Airports,GLASGOW,NEWQUAY,0,0,0,11,0,11,
05/03/2007 13:30,2006,2005,Other UK Airports,GLASGOW,NORWICH,30012,30012,0,17502,17502,0,71.47754669
05/03/2007 13:30,2006,2005,Other UK Airports,GLASGOW,NOTTINGHAM EAST MIDLANDS INT'L,184030,184030,0,170076,170061,15,8.204566956
05/03/2007 13:30,2006,2005,Other UK Airports,GLASGOW,PRESTWICK,23,23,0,0,0,0,
05/03/2007 13:30,2006,2005,Other UK Airports,GLASGOW,SOUTHAMPTON,202642,202597,45,192591,192591,0,5.218831539
05/03/2007 13:30,2006,2005,Other UK Airports,GLASGOW,STORNOWAY,50238,50238,0,45853,45853,0,9.563169479
05/03/2007 13:30,2006,2005,Other UK Airports,GLASGOW,SUMBURGH,15104,15104,0,15157,14989,168,-0.34967342
05/03/2007 13:30,2006,2005,Other UK Airports,GLASGOW,TIREE,7015,7015,0,6745,6745,0,4.002964973
05/03/2007 13:30,2006,2005,Other UK Airports,GLASGOW,WICK,46,0,46,22,22,0,109.0909119
05/03/2007 13:30,2006,2005,Other UK Airports,GUERNSEY,JERSEY,98919,98887,32,104227,104061,166,-5.092730522
05/03/2007 13:30,2006,2005,Other UK Airports,GUERNSEY,MANCHESTER,65657,65657,0,65894,65894,0,-0.359668553
05/03/2007 13:30,2006,2005,Other UK Airports,GUERNSEY,NEWQUAY,108,0,108,0,0,0,
05/03/2007 13:30,2006,2005,Other UK Airports,GUERNSEY,NORWICH,8731,8731,0,0,0,0,
05/03/2007 13:30,2006,2005,Other UK Airports,GUERNSEY,NOTTINGHAM EAST MIDLANDS INT'L,0,0,0,110,110,0,
05/03/2007 13:30,2006,2005,Other UK Airports,GUERNSEY,SOUTHAMPTON,124705,124705,0,129835,129833,2,-3.951168776
05/03/2007 13:30,2006,2005,Other UK Airports,GUERNSEY,SUMBURGH,0,0,0,500,0,500,
05/03/2007 13:30,2006,2005,Other UK Airports,HUMBERSIDE,ISLE OF MAN,0,0,0,100,0,100,
05/03/2007 13:30,2006,2005,Other UK Airports,HUMBERSIDE,JERSEY,1607,0,1607,1796,0,1796,-10.52338505
05/03/2007 13:30,2006,2005,Other UK Airports,HUMBERSIDE,KENT INTERNATIONAL,0,0,0,4,0,4,
05/03/2007 13:30,2006,2005,Other UK Airports,HUMBERSIDE,NORWICH,16,0,16,0,0,0,
05/03/2007 13:30,2006,2005,Other UK Airports,HUMBERSIDE,SOUTHAMPTON,210,0,210,125,0,125,68
05/03/2007 13:30,2006,2005,Other UK Airports,INVERNESS,KIRKWALL,22014,22014,0,18506,18506,0,18.95601463
05/03/2007 13:30,2006,2005,Other UK Airports,INVERNESS,LEEDS BRADFORD,4685,4685,0,0,0,0,
05/03/2007 13:30,2006,2005,Other UK Airports,INVERNESS,LIVERPOOL,14464,14464,0,0,0,0,
05/03/2007 13:30,2006,2005,Other UK Airports,INVERNESS,MANCHESTER,20630,20630,0,18065,18065,0,14.19872665
05/03/2007 13:30,2006,2005,Other UK Airports,INVERNESS,NEWCASTLE,1137,916,221,0,0,0,
05/03/2007 13:30,2006,2005,Other UK Airports,INVERNESS,NORTHOLT,0,0,0,11,0,11,
05/03/2007 13:30,2006,2005,Other UK Airports,INVERNESS,STORNOWAY,32385,32385,0,33025,33025,0,-1.937925816
05/03/2007 13:30,2006,2005,Other UK Airports,INVERNESS,SUMBURGH,158,158,0,97,97,0,62.88659668
05/03/2007 13:30,2006,2005,Other UK Airports,INVERNESS,WICK,0,0,0,183,183,0,
05/03/2007 13:30,2006,2005,Other UK Airports,ISLE OF MAN,LEEDS BRADFORD,1460,1460,0,5972,5972,0,-75.55258179
05/03/2007 13:30,2006,2005,Other UK Airports,ISLE OF MAN,LIVERPOOL,169755,169755,0,209967,209967,0,-19.15158081
05/03/2007 13:30,2006,2005,Other UK Airports,ISLE OF MAN,LYDD,100,100,0,0,0,0,
05/03/2007 13:30,2006,2005,Other UK Airports,ISLE OF MAN,MANCHESTER,166570,166570,0,143175,143175,0,16.3401432
05/03/2007 13:30,2006,2005,Other UK Airports,ISLE OF MAN,NEWCASTLE,7084,7084,0,7739,7739,0,-8.463625908
05/03/2007 13:30,2006,2005,Other UK Airports,ISLE OF MAN,NEWQUAY,100,0,100,55,0,55,81.8181839
05/03/2007 13:30,2006,2005,Other UK Airports,ISLE OF MAN,NOTTINGHAM EAST MIDLANDS INT'L,0,0,0,116,0,116,
05/03/2007 13:30,2006,2005,Other UK Airports,ISLE OF MAN,SOUTHAMPTON,8284,8284,0,10769,10769,0,-23.07549477
05/03/2007 13:30,2006,2005,Other UK Airports,ISLE OF MAN,SUMBURGH,0,0,0,446,0,446,
05/03/2007 13:30,2006,2005,Other UK Airports,ISLES OF SCILLY (ST.MARYS),NEWQUAY,16324,16324,0,17212,17212,0,-5.159191132
05/03/2007 13:30,2006,2005,Other UK Airports,ISLES OF SCILLY (ST.MARYS),SOUTHAMPTON,2544,2544,0,2225,2225,0,14.33707905
05/03/2007 13:30,2006,2005,Other UK Airports,JERSEY,LEEDS BRADFORD,1815,180,1635,13834,13834,0,-86.88014984
05/03/2007 13:30,2006,2005,Other UK Airports,JERSEY,LIVERPOOL,4320,4320,0,5118,4418,700,-15.59202766
05/03/2007 13:30,2006,2005,Other UK Airports,JERSEY,MANCHESTER,113557,107690,5867,114009,107188,6821,-0.396459937
05/03/2007 13:30,2006,2005,Other UK Airports,JERSEY,NEWCASTLE,3212,3212,0,12191,12191,0,-73.6526947
05/03/2007 13:30,2006,2005,Other UK Airports,JERSEY,NORWICH,18357,18357,0,15988,15988,0,14.81736279
05/03/2007 13:30,2006,2005,Other UK Airports,JERSEY,NOTTINGHAM EAST MIDLANDS INT'L,69210,68350,860,60698,60549,149,14.02352619
05/03/2007 13:30,2006,2005,Other UK Airports,JERSEY,PLYMOUTH,17925,17925,0,17136,17136,0,4.604341507
05/03/2007 13:30,2006,2005,Other UK Airports,JERSEY,SOUTHAMPTON,150752,150628,124,157800,157604,196,-4.466413021
05/03/2007 13:30,2006,2005,Other UK Airports,JERSEY,SUMBURGH,0,0,0,321,0,321,
05/03/2007 13:30,2006,2005,Other UK Airports,KENT INTERNATIONAL,MANCHESTER,0,0,0,15091,15091,0,
05/03/2007 13:30,2006,2005,Other UK Airports,KENT INTERNATIONAL,NEWCASTLE,0,0,0,5118,5118,0,
05/03/2007 13:30,2006,2005,Other UK Airports,KIRKWALL,MANCHESTER,44,0,44,0,0,0,
05/03/2007 13:30,2006,2005,Other UK Airports,KIRKWALL,NORTH RONALDSAY,5846,5846,0,5895,5895,0,-0.831212878
05/03/2007 13:30,2006,2005,Other UK Airports,KIRKWALL,PAPA WESTRAY,3835,3835,0,3744,3744,0,2.430555582
05/03/2007 13:30,2006,2005,Other UK Airports,KIRKWALL,SANDAY,2733,2733,0,2955,2955,0,-7.512690544
05/03/2007 13:30,2006,2005,Other UK Airports,KIRKWALL,STRONSAY,2907,2907,0,2965,2965,0,-1.956155181
05/03/2007 13:30,2006,2005,Other UK Airports,KIRKWALL,SUMBURGH,7045,7045,0,6230,6230,0,13.0818615
05/03/2007 13:30,2006,2005,Other UK Airports,KIRKWALL,WESTRAY,3210,3210,0,3002,3002,0,6.928714275
05/03/2007 13:30,2006,2005,Other UK Airports,KIRKWALL,WICK,4962,4962,0,27,27,0,18277.77734
05/03/2007 13:30,2006,2005,Other UK Airports,LANDS END (ST JUST),NEWQUAY,107,107,0,27,27,0,296.2962952
05/03/2007 13:30,2006,2005,Other UK Airports,LEEDS BRADFORD,NEWQUAY,27415,27415,0,25668,25653,15,6.806139946
05/03/2007 13:30,2006,2005,Other UK Airports,LEEDS BRADFORD,NORTHOLT,0,0,0,35,0,35,
05/03/2007 13:30,2006,2005,Other UK Airports,LEEDS BRADFORD,PLYMOUTH,10875,10875,0,0,0,0,
05/03/2007 13:30,2006,2005,Other UK Airports,LEEDS BRADFORD,SOUTH MARSTON,0,0,0,35,0,35,
05/03/2007 13:30,2006,2005,Other UK Airports,LEEDS BRADFORD,SOUTHAMPTON,77720,77720,0,56029,56029,0,38.71387863
05/03/2007 13:30,2006,2005,Other UK Airports,LERWICK (TINGWALL),OUT SKERRIES,486,486,0,425,425,0,14.35294151
05/03/2007 13:30,2006,2005,Other UK Airports,LERWICK (TINGWALL),PAPA STOUR,225,225,0,183,183,0,22.95081902
05/03/2007 13:30,2006,2005,Other UK Airports,LERWICK (TINGWALL),PAPA WESTRAY,0,0,0,7,7,0,
05/03/2007 13:30,2006,2005,Other UK Airports,LERWICK (TINGWALL),SUMBURGH,0,0,0,4,4,0,
05/03/2007 13:30,2006,2005,Other UK Airports,LEUCHARS,PRESTWICK,0,0,0,108,0,108,
05/03/2007 13:30,2006,2005,Other UK Airports,LIVERPOOL,MANCHESTER,338,128,210,0,0,0,
05/03/2007 13:30,2006,2005,Other UK Airports,LIVERPOOL,PLYMOUTH,0,0,0,56,0,56,
05/03/2007 13:30,2006,2005,Other UK Airports,LIVERPOOL,PRESTWICK,0,0,0,22,22,0,
05/03/2007 13:30,2006,2005,Other UK Airports,LIVERPOOL,SOUTHAMPTON,33158,33128,30,24915,24772,143,33.08448792
05/03/2007 13:30,2006,2005,Other UK Airports,LYDD,WICK,37,0,37,0,0,0,
05/03/2007 13:30,2006,2005,Other UK Airports,MANCHESTER,NEWCASTLE,21,0,21,0,0,0,
05/03/2007 13:30,2006,2005,Other UK Airports,MANCHESTER,NEWQUAY,65000,64961,39,0,0,0,
05/03/2007 13:30,2006,2005,Other UK Airports,MANCHESTER,NORWICH,39142,39142,0,17819,17819,0,119.6644058
05/03/2007 13:30,2006,2005,Other UK Airports,MANCHESTER,NOTTINGHAM EAST MIDLANDS INT'L,84,84,0,0,0,0,
05/03/2007 13:30,2006,2005,Other UK Airports,MANCHESTER,PLYMOUTH,26915,26915,0,43342,43342,0,-37.90088272
05/03/2007 13:30,2006,2005,Other UK Airports,MANCHESTER,SOUTHAMPTON,199476,199141,335,180182,179832,350,10.70806217
05/03/2007 13:30,2006,2005,Other UK Airports,MANCHESTER,WICK,63,0,63,0,0,0,
05/03/2007 13:30,2006,2005,Other UK Airports,NEWCASTLE,NORWICH,0,0,0,15,15,0,
05/03/2007 13:30,2006,2005,Other UK Airports,NEWCASTLE,PLYMOUTH,1725,1725,0,26602,26602,0,-93.51552582
05/03/2007 13:30,2006,2005,Other UK Airports,NEWCASTLE,SOUTHAMPTON,123451,123336,115,100083,100083,0,23.34862137
05/03/2007 13:30,2006,2005,Other UK Airports,NEWQUAY,PLYMOUTH,18432,18432,0,4729,4729,0,289.7652893
05/03/2007 13:30,2006,2005,Other UK Airports,NEWQUAY,SOUTHAMPTON,0,0,0,45,45,0,
05/03/2007 13:30,2006,2005,Other UK Airports,NORWICH,PLYMOUTH,0,0,0,84,0,84,
05/03/2007 13:30,2006,2005,Other UK Airports,NOTTINGHAM EAST MIDLANDS INT'L,PLYMOUTH,0,0,0,39,0,39,
05/03/2007 13:30,2006,2005,Other UK Airports,NOTTINGHAM EAST MIDLANDS INT'L,SOUTHAMPTON,26,0,26,0,0,0,
05/03/2007 13:30,2006,2005,Other UK Airports,OUT SKERRIES,SUMBURGH,0,0,0,24,24,0,
05/03/2007 13:30,2006,2005,Other UK Airports,SOUTH MARSTON,WICK,38,0,38,0,0,0,
05/03/2007 13:30,2006,2005,Other UK Airports,SOUTHAMPTON,STORNOWAY,0,0,0,23,0,23,
05/03/2007 13:30,2006,2005,Other UK Airports,STORNOWAY,SUMBURGH,0,0,0,61,0,61,
05/03/2007 13:30,2006,2005,Other UK Airports,SUMBURGH,WICK,3393,3393,0,9146,9146,0,-62.90181351
