rundate,this_period,last_period,grp_cd,grp_name,apt1_apt_name,apt2_apt_name,total_pax_tp,total_pax_shd_tp,total_pax_cht_tp,total_pax_lp,total_pax_shd_lp,total_pax_cht_lp,total_pax_pc
9/23/2008 12:41,1996,1995,A,London Area Airports,GATWICK,ABERDEEN,174820,174820,0,162630,162478,152,7.495542049
9/23/2008 12:41,1996,1995,A,London Area Airports,GATWICK,BELFAST CITY (GEORGE BEST),224046,224046,0,224700,224626,74,-0.291054726
9/23/2008 12:41,1996,1995,A,London Area Airports,GATWICK,BELFAST INTERNATIONAL,892,692,200,2647,2181,466,-66.30147552
9/23/2008 12:41,1996,1995,A,London Area Airports,GATWICK,BIRMINGHAM,74,0,74,74,0,74,0
9/23/2008 12:41,1996,1995,A,London Area Airports,GATWICK,BOURNEMOUTH,21,0,21,249,0,249,-91.56626129
9/23/2008 12:41,1996,1995,A,London Area Airports,GATWICK,CARDIFF WALES,1,0,1,0,0,0,
9/23/2008 12:41,1996,1995,A,London Area Airports,GATWICK,COVENTRY,0,0,0,199,0,199,
9/23/2008 12:41,1996,1995,A,London Area Airports,GATWICK,DURHAM TEES VALLEY,0,0,0,234,0,234,
9/23/2008 12:41,1996,1995,A,London Area Airports,GATWICK,EAST MIDLANDS INTERNATIONAL,2485,2484,1,1192,966,226,108.4731522
9/23/2008 12:41,1996,1995,A,London Area Airports,GATWICK,EDINBURGH,312699,312332,367,221762,220622,1140,41.00657272
9/23/2008 12:41,1996,1995,A,London Area Airports,GATWICK,GLASGOW,254510,253801,709,224369,223809,560,13.43367386
9/23/2008 12:41,1996,1995,A,London Area Airports,GATWICK,GUERNSEY,214512,212672,1840,194289,192353,1936,10.40872097
9/23/2008 12:41,1996,1995,A,London Area Airports,GATWICK,INVERNESS,246,0,246,78,0,78,215.384613
9/23/2008 12:41,1996,1995,A,London Area Airports,GATWICK,JERSEY,349668,348965,703,295617,293318,2299,18.284132
9/23/2008 12:41,1996,1995,A,London Area Airports,GATWICK,LEEDS BRADFORD,41010,40822,188,26606,26346,260,54.13816452
9/23/2008 12:41,1996,1995,A,London Area Airports,GATWICK,LEUCHARS,0,0,0,30,0,30,
9/23/2008 12:41,1996,1995,A,London Area Airports,GATWICK,LIVERPOOL,2973,2809,164,59,0,59,4938.98291
9/23/2008 12:41,1996,1995,A,London Area Airports,GATWICK,LUTON,31,0,31,32,0,32,-3.125
9/23/2008 12:41,1996,1995,A,London Area Airports,GATWICK,MANCHESTER,374976,371448,3528,335703,332426,3277,11.69873333
9/23/2008 12:41,1996,1995,A,London Area Airports,GATWICK,NEWCASTLE,116945,116765,180,88903,88556,347,31.54224205
9/23/2008 12:41,1996,1995,A,London Area Airports,GATWICK,PRESTWICK,0,0,0,13,0,13,
9/23/2008 12:41,1996,1995,A,London Area Airports,GATWICK,STANSTED,0,0,0,4,0,4,
9/23/2008 12:41,1996,1995,A,London Area Airports,HEATHROW,ABERDEEN,515959,515879,80,511031,511031,0,0.96432507
9/23/2008 12:41,1996,1995,A,London Area Airports,HEATHROW,BELFAST INTERNATIONAL,1134658,1134658,0,1082996,1082943,53,4.770285606
9/23/2008 12:41,1996,1995,A,London Area Airports,HEATHROW,BIRMINGHAM,398,0,398,300,0,300,32.66666794
9/23/2008 12:41,1996,1995,A,London Area Airports,HEATHROW,BLACKPOOL,42,0,42,0,0,0,
9/23/2008 12:41,1996,1995,A,London Area Airports,HEATHROW,BOURNEMOUTH,400,0,400,0,0,0,
9/23/2008 12:41,1996,1995,A,London Area Airports,HEATHROW,BRISTOL,501,0,501,300,0,300,67
9/23/2008 12:41,1996,1995,A,London Area Airports,HEATHROW,CARDIFF WALES,399,0,399,99,0,99,303.030304
9/23/2008 12:41,1996,1995,A,London Area Airports,HEATHROW,DURHAM TEES VALLEY,188146,188146,0,186566,186566,0,0.846885264
9/23/2008 12:41,1996,1995,A,London Area Airports,HEATHROW,EAST MIDLANDS INTERNATIONAL,400,0,400,342,46,296,16.95906448
9/23/2008 12:41,1996,1995,A,London Area Airports,HEATHROW,EDINBURGH,1595321,1595321,0,1541421,1541420,1,3.496773481
9/23/2008 12:41,1996,1995,A,London Area Airports,HEATHROW,EXETER,100,0,100,400,0,400,-75
9/23/2008 12:41,1996,1995,A,London Area Airports,HEATHROW,FAIRFORD,200,0,200,200,0,200,0
9/23/2008 12:41,1996,1995,A,London Area Airports,HEATHROW,FARNBOROUGH,200,0,200,0,0,0,
9/23/2008 12:41,1996,1995,A,London Area Airports,HEATHROW,FILTON,0,0,0,300,0,300,
9/23/2008 12:41,1996,1995,A,London Area Airports,HEATHROW,GLASGOW,1516997,1516724,273,1511213,1511047,166,0.382738888
9/23/2008 12:41,1996,1995,A,London Area Airports,HEATHROW,GUERNSEY,98517,98517,0,93711,93667,44,5.128533363
9/23/2008 12:41,1996,1995,A,London Area Airports,HEATHROW,HUMBERSIDE,400,0,400,181,0,181,120.9944763
9/23/2008 12:41,1996,1995,A,London Area Airports,HEATHROW,INVERNESS,212025,212025,0,209274,209274,0,1.314544559
9/23/2008 12:41,1996,1995,A,London Area Airports,HEATHROW,ISLE OF MAN,121448,121448,0,117186,117186,0,3.636953115
9/23/2008 12:41,1996,1995,A,London Area Airports,HEATHROW,JERSEY,247129,246315,814,245519,245480,39,0.655753732
9/23/2008 12:41,1996,1995,A,London Area Airports,HEATHROW,KENT INTERNATIONAL,400,0,400,400,0,400,0
9/23/2008 12:41,1996,1995,A,London Area Airports,HEATHROW,KINROSS,0,0,0,94,0,94,
9/23/2008 12:41,1996,1995,A,London Area Airports,HEATHROW,LEEDS BRADFORD,194245,193546,699,193327,192727,600,0.474843144
9/23/2008 12:41,1996,1995,A,London Area Airports,HEATHROW,LEUCHARS,112,0,112,152,0,152,-26.31579018
9/23/2008 12:41,1996,1995,A,London Area Airports,HEATHROW,LIVERPOOL,235,0,235,238,0,238,-1.260504246
9/23/2008 12:41,1996,1995,A,London Area Airports,HEATHROW,MANCHESTER,1082885,1081507,1378,1073747,1072747,1000,0.851038456
9/23/2008 12:41,1996,1995,A,London Area Airports,HEATHROW,NEWCASTLE,440545,440545,0,436332,436332,0,0.965549171
9/23/2008 12:41,1996,1995,A,London Area Airports,HEATHROW,NEWQUAY,35838,35838,0,30834,30834,0,16.22883797
9/23/2008 12:41,1996,1995,A,London Area Airports,HEATHROW,NORWICH,0,0,0,111,0,111,
9/23/2008 12:41,1996,1995,A,London Area Airports,HEATHROW,PLYMOUTH,67368,67368,0,64347,64347,0,4.694857597
9/23/2008 12:41,1996,1995,A,London Area Airports,HEATHROW,STANSTED,43,0,43,0,0,0,
9/23/2008 12:41,1996,1995,A,London Area Airports,LONDON CITY,ABERDEEN,0,0,0,37,0,37,
9/23/2008 12:41,1996,1995,A,London Area Airports,LONDON CITY,BIGGIN HILL,2,0,2,0,0,0,
9/23/2008 12:41,1996,1995,A,London Area Airports,LONDON CITY,EDINBURGH,22405,22372,33,41,0,41,54546.33984
9/23/2008 12:41,1996,1995,A,London Area Airports,LONDON CITY,HUMBERSIDE,0,0,0,521,521,0,
9/23/2008 12:41,1996,1995,A,London Area Airports,LONDON CITY,JERSEY,0,0,0,1162,0,1162,
9/23/2008 12:41,1996,1995,A,London Area Airports,LONDON CITY,LEEDS BRADFORD,27,0,27,0,0,0,
9/23/2008 12:41,1996,1995,A,London Area Airports,LONDON CITY,MANCHESTER,23,0,23,0,0,0,
9/23/2008 12:41,1996,1995,A,London Area Airports,LONDON CITY,PRESTWICK,36,0,36,0,0,0,
9/23/2008 12:41,1996,1995,A,London Area Airports,LONDON CITY,SOUTHAMPTON,0,0,0,79,0,79,
9/23/2008 12:41,1996,1995,A,London Area Airports,LUTON,ABERDEEN,57529,57529,0,28,0,28,205360.7188
9/23/2008 12:41,1996,1995,A,London Area Airports,LUTON,BELFAST CITY (GEORGE BEST),35804,35803,1,40403,40223,180,-11.38281822
9/23/2008 12:41,1996,1995,A,London Area Airports,LUTON,BELFAST INTERNATIONAL,0,0,0,12866,12657,209,
9/23/2008 12:41,1996,1995,A,London Area Airports,LUTON,BIRMINGHAM,0,0,0,148,0,148,
9/23/2008 12:41,1996,1995,A,London Area Airports,LUTON,DURHAM TEES VALLEY,0,0,0,86,0,86,
9/23/2008 12:41,1996,1995,A,London Area Airports,LUTON,EAST MIDLANDS INTERNATIONAL,79,0,79,4,0,4,1875
9/23/2008 12:41,1996,1995,A,London Area Airports,LUTON,EDINBURGH,169611,169578,33,15752,14842,910,976.7584839
9/23/2008 12:41,1996,1995,A,London Area Airports,LUTON,GLASGOW,139501,139501,0,23587,23287,300,491.4317322
9/23/2008 12:41,1996,1995,A,London Area Airports,LUTON,INVERNESS,4892,4892,0,0,0,0,
9/23/2008 12:41,1996,1995,A,London Area Airports,LUTON,ISLE OF MAN,22248,22248,0,21362,21362,0,4.147551537
9/23/2008 12:41,1996,1995,A,London Area Airports,LUTON,JERSEY,8918,8918,0,10239,8300,1939,-12.90165043
9/23/2008 12:41,1996,1995,A,London Area Airports,LUTON,LEEDS BRADFORD,30,0,30,255,0,255,-88.23529053
9/23/2008 12:41,1996,1995,A,London Area Airports,LUTON,MANCHESTER,26,0,26,132,0,132,-80.30303192
9/23/2008 12:41,1996,1995,A,London Area Airports,LUTON,NEWCASTLE,12536,12404,132,179,0,179,6903.352051
9/23/2008 12:41,1996,1995,A,London Area Airports,LUTON,NORWICH,19,19,0,0,0,0,
9/23/2008 12:41,1996,1995,A,London Area Airports,LUTON,WICK,159,0,159,0,0,0,
9/23/2008 12:41,1996,1995,A,London Area Airports,SOUTHEND,EDINBURGH,77,0,77,13,0,13,492.3076782
9/23/2008 12:41,1996,1995,A,London Area Airports,SOUTHEND,HUMBERSIDE,0,0,0,30,0,30,
9/23/2008 12:41,1996,1995,A,London Area Airports,SOUTHEND,JERSEY,2588,0,2588,327,0,327,691.4373169
9/23/2008 12:41,1996,1995,A,London Area Airports,SOUTHEND,LYDD,148,0,148,0,0,0,
9/23/2008 12:41,1996,1995,A,London Area Airports,STANSTED,ABERDEEN,111146,111138,8,88802,88802,0,25.1615963
9/23/2008 12:41,1996,1995,A,London Area Airports,STANSTED,BELFAST CITY (GEORGE BEST),149235,149181,54,166381,166286,95,-10.30526352
9/23/2008 12:41,1996,1995,A,London Area Airports,STANSTED,BELFAST INTERNATIONAL,111778,111743,35,116212,115990,222,-3.815440655
9/23/2008 12:41,1996,1995,A,London Area Airports,STANSTED,BIRMINGHAM,0,0,0,1,0,1,
9/23/2008 12:41,1996,1995,A,London Area Airports,STANSTED,BOURNEMOUTH,0,0,0,283,0,283,
9/23/2008 12:41,1996,1995,A,London Area Airports,STANSTED,CITY OF DERRY (EGLINTON),18866,18866,0,496,408,88,3703.62915
9/23/2008 12:41,1996,1995,A,London Area Airports,STANSTED,DURHAM TEES VALLEY,0,0,0,1518,1285,233,
9/23/2008 12:41,1996,1995,A,London Area Airports,STANSTED,EAST MIDLANDS INTERNATIONAL,0,0,0,80,0,80,
9/23/2008 12:41,1996,1995,A,London Area Airports,STANSTED,EDINBURGH,182213,182012,201,154100,153119,981,18.24334908
9/23/2008 12:41,1996,1995,A,London Area Airports,STANSTED,EXETER,3,0,3,11,0,11,-72.72727203
9/23/2008 12:41,1996,1995,A,London Area Airports,STANSTED,GLASGOW,134672,134672,0,114879,114879,0,17.22943306
9/23/2008 12:41,1996,1995,A,London Area Airports,STANSTED,GUERNSEY,18555,18378,177,18471,18203,268,0.454766929
9/23/2008 12:41,1996,1995,A,London Area Airports,STANSTED,HAWARDEN,64,0,64,0,0,0,
9/23/2008 12:41,1996,1995,A,London Area Airports,STANSTED,HUMBERSIDE,0,0,0,168,0,168,
9/23/2008 12:41,1996,1995,A,London Area Airports,STANSTED,INVERNESS,4666,4532,134,117,0,117,3888.03418
9/23/2008 12:41,1996,1995,A,London Area Airports,STANSTED,ISLE OF MAN,291,0,291,0,0,0,
9/23/2008 12:41,1996,1995,A,London Area Airports,STANSTED,JERSEY,41913,41467,446,52005,49713,2292,-19.40582657
9/23/2008 12:41,1996,1995,A,London Area Airports,STANSTED,LEEDS BRADFORD,284,0,284,633,0,633,-55.13428116
9/23/2008 12:41,1996,1995,A,London Area Airports,STANSTED,LEUCHARS,0,0,0,660,0,660,
9/23/2008 12:41,1996,1995,A,London Area Airports,STANSTED,LIVERPOOL,2,0,2,442,0,442,-99.54750824
9/23/2008 12:41,1996,1995,A,London Area Airports,STANSTED,MANCHESTER,26133,26030,103,23040,22225,815,13.42447948
9/23/2008 12:41,1996,1995,A,London Area Airports,STANSTED,NEWCASTLE,39903,38479,1424,38323,37963,360,4.122850418
9/23/2008 12:41,1996,1995,A,London Area Airports,STANSTED,PLYMOUTH,0,0,0,71,0,71,
9/23/2008 12:41,1996,1995,A,London Area Airports,STANSTED,PRESTWICK,216188,216183,5,33373,33343,30,547.7931519
9/23/2008 12:41,1996,1995,A,London Area Airports,STANSTED,STANSTED,0,0,0,171,0,171,
9/23/2008 12:41,1996,1995,B,Other UK Airports,ABERDEEN,BELFAST CITY (GEORGE BEST),13446,13446,0,0,0,0,
9/23/2008 12:41,1996,1995,B,Other UK Airports,ABERDEEN,BELFAST INTERNATIONAL,13479,13479,0,17529,17529,0,-23.10457039
9/23/2008 12:41,1996,1995,B,Other UK Airports,ABERDEEN,BIRMINGHAM,45913,45913,0,46998,46998,0,-2.30860877
9/23/2008 12:41,1996,1995,B,Other UK Airports,ABERDEEN,BLACKPOOL,66,0,66,0,0,0,
9/23/2008 12:41,1996,1995,B,Other UK Airports,ABERDEEN,BRISTOL,30860,30860,0,26260,26260,0,17.51713562
9/23/2008 12:41,1996,1995,B,Other UK Airports,ABERDEEN,CARDIFF WALES,3305,3127,178,8299,8299,0,-60.17592621
9/23/2008 12:41,1996,1995,B,Other UK Airports,ABERDEEN,COVENTRY,111,0,111,237,0,237,-53.16455841
9/23/2008 12:41,1996,1995,B,Other UK Airports,ABERDEEN,DUNDEE,0,0,0,19,19,0,
9/23/2008 12:41,1996,1995,B,Other UK Airports,ABERDEEN,DURHAM TEES VALLEY,105,22,83,0,0,0,
9/23/2008 12:41,1996,1995,B,Other UK Airports,ABERDEEN,EAST MIDLANDS INTERNATIONAL,22608,22282,326,23146,22947,199,-2.324375629
9/23/2008 12:41,1996,1995,B,Other UK Airports,ABERDEEN,EDINBURGH,2354,2354,0,775,527,248,203.7419281
9/23/2008 12:41,1996,1995,B,Other UK Airports,ABERDEEN,EXETER,0,0,0,22,22,0,
9/23/2008 12:41,1996,1995,B,Other UK Airports,ABERDEEN,GLASGOW,14487,14484,3,9769,9764,5,48.29562759
9/23/2008 12:41,1996,1995,B,Other UK Airports,ABERDEEN,HUMBERSIDE,40392,40392,0,39852,39852,0,1.355013609
9/23/2008 12:41,1996,1995,B,Other UK Airports,ABERDEEN,INVERNESS,0,0,0,511,511,0,
9/23/2008 12:41,1996,1995,B,Other UK Airports,ABERDEEN,ISLE OF MAN,667,667,0,1793,1793,0,-62.79977798
9/23/2008 12:41,1996,1995,B,Other UK Airports,ABERDEEN,JERSEY,4045,470,3575,3766,0,3766,7.408390999
9/23/2008 12:41,1996,1995,B,Other UK Airports,ABERDEEN,KIRKWALL,34801,34801,0,31566,31346,220,10.24836826
9/23/2008 12:41,1996,1995,B,Other UK Airports,ABERDEEN,LEEDS BRADFORD,9717,9717,0,4717,4717,0,105.9995728
9/23/2008 12:41,1996,1995,B,Other UK Airports,ABERDEEN,MANCHESTER,123510,123432,78,111281,111281,0,10.98929691
9/23/2008 12:41,1996,1995,B,Other UK Airports,ABERDEEN,NEWCASTLE,20849,20768,81,23527,23497,30,-11.38266659
9/23/2008 12:41,1996,1995,B,Other UK Airports,ABERDEEN,NORWICH,47791,47791,0,50319,50319,0,-5.023947239
9/23/2008 12:41,1996,1995,B,Other UK Airports,ABERDEEN,SCATSTA,41082,0,41082,0,0,0,
9/23/2008 12:41,1996,1995,B,Other UK Airports,ABERDEEN,SOUTHAMPTON,5252,5252,0,2834,2834,0,85.32109833
9/23/2008 12:41,1996,1995,B,Other UK Airports,ABERDEEN,SUMBURGH,230853,96406,134447,262334,93114,169220,-12.00035095
9/23/2008 12:41,1996,1995,B,Other UK Airports,ABERDEEN,UNST,8037,0,8037,35803,0,35803,-77.55216217
9/23/2008 12:41,1996,1995,B,Other UK Airports,ABERDEEN,WICK,10558,10558,0,11189,11189,0,-5.639467239
9/23/2008 12:41,1996,1995,B,Other UK Airports,ALDERNEY,GUERNSEY,36919,36919,0,36935,36935,0,-0.043319345
9/23/2008 12:41,1996,1995,B,Other UK Airports,ALDERNEY,JERSEY,14680,14680,0,15544,15544,0,-5.558414936
9/23/2008 12:41,1996,1995,B,Other UK Airports,ALDERNEY,SOUTHAMPTON,32316,32316,0,32334,32334,0,-0.055668954
9/23/2008 12:41,1996,1995,B,Other UK Airports,BARRA,BENBECULA,3126,3126,0,2466,2466,0,26.7639904
9/23/2008 12:41,1996,1995,B,Other UK Airports,BARRA,GLASGOW,5078,5078,0,4511,4511,0,12.5692749
9/23/2008 12:41,1996,1995,B,Other UK Airports,BARRA,STORNOWAY,0,0,0,630,630,0,
9/23/2008 12:41,1996,1995,B,Other UK Airports,BARRA,TIREE,0,0,0,82,82,0,
9/23/2008 12:41,1996,1995,B,Other UK Airports,BELFAST CITY (GEORGE BEST),BIRMINGHAM,149481,149481,0,147633,147604,29,1.251752615
9/23/2008 12:41,1996,1995,B,Other UK Airports,BELFAST CITY (GEORGE BEST),BLACKPOOL,57828,57828,0,49761,49761,0,16.21149063
9/23/2008 12:41,1996,1995,B,Other UK Airports,BELFAST CITY (GEORGE BEST),BRISTOL,48124,48124,0,43275,43245,30,11.20508385
9/23/2008 12:41,1996,1995,B,Other UK Airports,BELFAST CITY (GEORGE BEST),CARDIFF WALES,12719,12719,0,14752,14752,0,-13.78118229
9/23/2008 12:41,1996,1995,B,Other UK Airports,BELFAST CITY (GEORGE BEST),CITY OF DERRY (EGLINTON),27296,27296,0,25416,25416,0,7.396915436
9/23/2008 12:41,1996,1995,B,Other UK Airports,BELFAST CITY (GEORGE BEST),DURHAM TEES VALLEY,0,0,0,1131,1131,0,
9/23/2008 12:41,1996,1995,B,Other UK Airports,BELFAST CITY (GEORGE BEST),EAST MIDLANDS INTERNATIONAL,18263,18263,0,2424,2424,0,653.4240723
9/23/2008 12:41,1996,1995,B,Other UK Airports,BELFAST CITY (GEORGE BEST),EDINBURGH,66742,66742,0,65450,65450,0,1.974025965
9/23/2008 12:41,1996,1995,B,Other UK Airports,BELFAST CITY (GEORGE BEST),EXETER,14893,14893,0,15872,15872,0,-6.168094635
9/23/2008 12:41,1996,1995,B,Other UK Airports,BELFAST CITY (GEORGE BEST),GLASGOW,81414,81414,0,74878,74878,0,8.728865623
9/23/2008 12:41,1996,1995,B,Other UK Airports,BELFAST CITY (GEORGE BEST),GUERNSEY,1356,1356,0,0,0,0,
9/23/2008 12:41,1996,1995,B,Other UK Airports,BELFAST CITY (GEORGE BEST),ISLE OF MAN,8381,8265,116,4563,4560,3,83.67301941
9/23/2008 12:41,1996,1995,B,Other UK Airports,BELFAST CITY (GEORGE BEST),JERSEY,7939,5826,2113,14719,12153,2566,-46.06291199
9/23/2008 12:41,1996,1995,B,Other UK Airports,BELFAST CITY (GEORGE BEST),LEEDS BRADFORD,81731,81731,0,82211,82211,0,-0.583863497
9/23/2008 12:41,1996,1995,B,Other UK Airports,BELFAST CITY (GEORGE BEST),LIVERPOOL,60346,60346,0,65012,65012,0,-7.177136421
9/23/2008 12:41,1996,1995,B,Other UK Airports,BELFAST CITY (GEORGE BEST),MANCHESTER,125067,125067,0,128336,128135,201,-2.547219753
9/23/2008 12:41,1996,1995,B,Other UK Airports,BELFAST CITY (GEORGE BEST),NEWCASTLE,54486,54486,0,52366,52366,0,4.048428535
9/23/2008 12:41,1996,1995,B,Other UK Airports,BELFAST CITY (GEORGE BEST),PRESTWICK,65966,65966,0,27683,27683,0,138.2906494
9/23/2008 12:41,1996,1995,B,Other UK Airports,BELFAST CITY (GEORGE BEST),SOUTHAMPTON,20032,20032,0,16912,16912,0,18.44843864
9/23/2008 12:41,1996,1995,B,Other UK Airports,BELFAST CITY (GEORGE BEST),WICK,2231,2231,0,0,0,0,
9/23/2008 12:41,1996,1995,B,Other UK Airports,BELFAST INTERNATIONAL,BIRMINGHAM,140165,140034,131,129010,128885,125,8.646616936
9/23/2008 12:41,1996,1995,B,Other UK Airports,BELFAST INTERNATIONAL,BRISTOL,0,0,0,21,0,21,
9/23/2008 12:41,1996,1995,B,Other UK Airports,BELFAST INTERNATIONAL,DURHAM TEES VALLEY,0,0,0,919,919,0,
9/23/2008 12:41,1996,1995,B,Other UK Airports,BELFAST INTERNATIONAL,EAST MIDLANDS INTERNATIONAL,68525,68479,46,67752,67547,205,1.140925765
9/23/2008 12:41,1996,1995,B,Other UK Airports,BELFAST INTERNATIONAL,EDINBURGH,0,0,0,65,0,65,
9/23/2008 12:41,1996,1995,B,Other UK Airports,BELFAST INTERNATIONAL,FILTON,0,0,0,4,0,4,
9/23/2008 12:41,1996,1995,B,Other UK Airports,BELFAST INTERNATIONAL,GLASGOW,58496,58494,2,48310,48232,78,21.08466148
9/23/2008 12:41,1996,1995,B,Other UK Airports,BELFAST INTERNATIONAL,JERSEY,17776,16978,798,17996,17967,29,-1.222493887
9/23/2008 12:41,1996,1995,B,Other UK Airports,BELFAST INTERNATIONAL,LEEDS BRADFORD,666,619,47,6851,6851,0,-90.27879333
9/23/2008 12:41,1996,1995,B,Other UK Airports,BELFAST INTERNATIONAL,LIVERPOOL,447,446,1,0,0,0,
9/23/2008 12:41,1996,1995,B,Other UK Airports,BELFAST INTERNATIONAL,MANCHESTER,123013,122825,188,128475,128446,29,-4.251410961
9/23/2008 12:41,1996,1995,B,Other UK Airports,BELFAST INTERNATIONAL,NEWCASTLE,113,0,113,13,0,13,769.2307739
9/23/2008 12:41,1996,1995,B,Other UK Airports,BELFAST INTERNATIONAL,NORWICH,0,0,0,46,0,46,
9/23/2008 12:41,1996,1995,B,Other UK Airports,BELFAST INTERNATIONAL,SOUTHAMPTON,4981,4981,0,0,0,0,
9/23/2008 12:41,1996,1995,B,Other UK Airports,BENBECULA,GLASGOW,21307,21307,0,21591,21591,0,-1.31536293
9/23/2008 12:41,1996,1995,B,Other UK Airports,BENBECULA,STORNOWAY,11994,11994,0,13375,13375,0,-10.32523346
9/23/2008 12:41,1996,1995,B,Other UK Airports,BIRMINGHAM,BLACKPOOL,92,0,92,0,0,0,
9/23/2008 12:41,1996,1995,B,Other UK Airports,BIRMINGHAM,BRISTOL,0,0,0,92,0,92,
9/23/2008 12:41,1996,1995,B,Other UK Airports,BIRMINGHAM,CARDIFF WALES,0,0,0,335,0,335,
9/23/2008 12:41,1996,1995,B,Other UK Airports,BIRMINGHAM,CITY OF DERRY (EGLINTON),1629,1573,56,344,344,0,373.5465088
9/23/2008 12:41,1996,1995,B,Other UK Airports,BIRMINGHAM,EAST MIDLANDS INTERNATIONAL,129,86,43,361,260,101,-64.26593018
9/23/2008 12:41,1996,1995,B,Other UK Airports,BIRMINGHAM,EDINBURGH,213792,213792,0,206652,205995,657,3.455083847
9/23/2008 12:41,1996,1995,B,Other UK Airports,BIRMINGHAM,EXETER,0,0,0,40,0,40,
9/23/2008 12:41,1996,1995,B,Other UK Airports,BIRMINGHAM,GLASGOW,231328,231160,168,233934,233417,517,-1.113989472
9/23/2008 12:41,1996,1995,B,Other UK Airports,BIRMINGHAM,GUERNSEY,21753,21753,0,32764,32764,0,-33.60700607
9/23/2008 12:41,1996,1995,B,Other UK Airports,BIRMINGHAM,INVERNESS,0,0,0,196,0,196,
9/23/2008 12:41,1996,1995,B,Other UK Airports,BIRMINGHAM,ISLE OF MAN,45811,45811,0,44356,44332,24,3.280277729
9/23/2008 12:41,1996,1995,B,Other UK Airports,BIRMINGHAM,JERSEY,84413,74382,10031,65118,53805,11313,29.63082314
9/23/2008 12:41,1996,1995,B,Other UK Airports,BIRMINGHAM,KINLOSS,216,0,216,106,0,106,103.7735825
9/23/2008 12:41,1996,1995,B,Other UK Airports,BIRMINGHAM,KIRKWALL,17053,17053,0,21417,21417,0,-20.37633705
9/23/2008 12:41,1996,1995,B,Other UK Airports,BIRMINGHAM,LIVERPOOL,316,232,84,0,0,0,
9/23/2008 12:41,1996,1995,B,Other UK Airports,BIRMINGHAM,MANCHESTER,100,0,100,303,126,177,-66.99669647
9/23/2008 12:41,1996,1995,B,Other UK Airports,BIRMINGHAM,NEWCASTLE,22519,22519,0,21239,21158,81,6.026648998
9/23/2008 12:41,1996,1995,B,Other UK Airports,BIRMINGHAM,NEWQUAY,42,0,42,0,0,0,
9/23/2008 12:41,1996,1995,B,Other UK Airports,BLACKPOOL,CITY OF DERRY (EGLINTON),14114,14114,0,445,445,0,3071.685303
9/23/2008 12:41,1996,1995,B,Other UK Airports,BLACKPOOL,EDINBURGH,44,44,0,0,0,0,
9/23/2008 12:41,1996,1995,B,Other UK Airports,BLACKPOOL,ISLE OF MAN,95,95,0,3570,3570,0,-97.33893585
9/23/2008 12:41,1996,1995,B,Other UK Airports,BLACKPOOL,JERSEY,1831,1831,0,3391,1626,1765,-46.0041275
9/23/2008 12:41,1996,1995,B,Other UK Airports,BLACKPOOL,LEEDS BRADFORD,0,0,0,388,0,388,
9/23/2008 12:41,1996,1995,B,Other UK Airports,BLACKPOOL,LYDD,0,0,0,17,0,17,
9/23/2008 12:41,1996,1995,B,Other UK Airports,BLACKPOOL,PRESTWICK,126,0,126,0,0,0,
9/23/2008 12:41,1996,1995,B,Other UK Airports,BOURNEMOUTH,BRISTOL,105,0,105,337,0,337,-68.84272766
9/23/2008 12:41,1996,1995,B,Other UK Airports,BOURNEMOUTH,EAST MIDLANDS INTERNATIONAL,3,0,3,0,0,0,
9/23/2008 12:41,1996,1995,B,Other UK Airports,BOURNEMOUTH,EXETER,0,0,0,209,0,209,
9/23/2008 12:41,1996,1995,B,Other UK Airports,BOURNEMOUTH,GUERNSEY,687,0,687,526,0,526,30.60836411
9/23/2008 12:41,1996,1995,B,Other UK Airports,BOURNEMOUTH,HUMBERSIDE,208,0,208,0,0,0,
9/23/2008 12:41,1996,1995,B,Other UK Airports,BOURNEMOUTH,JERSEY,5692,0,5692,3693,0,3693,54.12943268
9/23/2008 12:41,1996,1995,B,Other UK Airports,BRISTOL,CARDIFF WALES,0,0,0,1,0,1,
9/23/2008 12:41,1996,1995,B,Other UK Airports,BRISTOL,EDINBURGH,69390,69347,43,59984,59593,391,15.68084812
9/23/2008 12:41,1996,1995,B,Other UK Airports,BRISTOL,EXETER,0,0,0,174,0,174,
9/23/2008 12:41,1996,1995,B,Other UK Airports,BRISTOL,GLASGOW,69607,69607,0,62347,62325,22,11.6445055
9/23/2008 12:41,1996,1995,B,Other UK Airports,BRISTOL,GUERNSEY,7496,7400,96,7676,7474,202,-2.344971418
9/23/2008 12:41,1996,1995,B,Other UK Airports,BRISTOL,ISLES OF SCILLY (ST.MARYS),2368,2368,0,2038,2038,0,16.19234467
9/23/2008 12:41,1996,1995,B,Other UK Airports,BRISTOL,JERSEY,30586,28555,2031,35786,33278,2508,-14.5308218
9/23/2008 12:41,1996,1995,B,Other UK Airports,BRISTOL,KENT INTERNATIONAL,138,0,138,0,0,0,
9/23/2008 12:41,1996,1995,B,Other UK Airports,BRISTOL,LEEDS BRADFORD,75,0,75,0,0,0,
9/23/2008 12:41,1996,1995,B,Other UK Airports,BRISTOL,MANCHESTER,0,0,0,174,0,174,
9/23/2008 12:41,1996,1995,B,Other UK Airports,BRISTOL,NEWCASTLE,2002,2002,0,2447,2239,208,-18.18553352
9/23/2008 12:41,1996,1995,B,Other UK Airports,BRISTOL,PLYMOUTH,11247,11247,0,8939,8939,0,25.81944275
9/23/2008 12:41,1996,1995,B,Other UK Airports,BRISTOL,PRESTWICK,44,0,44,0,0,0,
9/23/2008 12:41,1996,1995,B,Other UK Airports,CAMBRIDGE,FARNBOROUGH,2,0,2,0,0,0,
9/23/2008 12:41,1996,1995,B,Other UK Airports,CAMBRIDGE,JERSEY,1820,0,1820,3141,2528,613,-42.05667114
9/23/2008 12:41,1996,1995,B,Other UK Airports,CAMBRIDGE,MANCHESTER,6309,6309,0,6998,6989,9,-9.845669746
9/23/2008 12:41,1996,1995,B,Other UK Airports,CAMPBELTOWN,GLASGOW,6033,6033,0,32,32,0,18753.125
9/23/2008 12:41,1996,1995,B,Other UK Airports,CAMPBELTOWN,ISLAY,448,448,0,0,0,0,
9/23/2008 12:41,1996,1995,B,Other UK Airports,CARDIFF WALES,EDINBURGH,15631,15293,338,15543,5225,10318,0.566171288
9/23/2008 12:41,1996,1995,B,Other UK Airports,CARDIFF WALES,GLASGOW,21552,21119,433,20678,20678,0,4.226714611
9/23/2008 12:41,1996,1995,B,Other UK Airports,CARDIFF WALES,GUERNSEY,2504,2504,0,1427,1359,68,75.47302246
9/23/2008 12:41,1996,1995,B,Other UK Airports,CARDIFF WALES,ISLE OF MAN,3021,3021,0,2611,2611,0,15.70279598
9/23/2008 12:41,1996,1995,B,Other UK Airports,CARDIFF WALES,JERSEY,22716,22716,0,19946,19946,0,13.88749599
9/23/2008 12:41,1996,1995,B,Other UK Airports,CARDIFF WALES,MANCHESTER,7859,7852,7,1452,1452,0,441.2534485
9/23/2008 12:41,1996,1995,B,Other UK Airports,CARDIFF WALES,NEWCASTLE,443,443,0,0,0,0,
9/23/2008 12:41,1996,1995,B,Other UK Airports,CARDIFF WALES,SOUTHAMPTON,0,0,0,12,12,0,
9/23/2008 12:41,1996,1995,B,Other UK Airports,CARLISLE,EAST MIDLANDS INTERNATIONAL,0,0,0,96,0,96,
9/23/2008 12:41,1996,1995,B,Other UK Airports,CARLISLE,MANCHESTER,0,0,0,59,0,59,
9/23/2008 12:41,1996,1995,B,Other UK Airports,CITY OF DERRY (EGLINTON),GLASGOW,17,17,0,0,0,0,
9/23/2008 12:41,1996,1995,B,Other UK Airports,COVENTRY,GLASGOW,0,0,0,2,0,2,
9/23/2008 12:41,1996,1995,B,Other UK Airports,COVENTRY,NEWCASTLE,60,0,60,0,0,0,
9/23/2008 12:41,1996,1995,B,Other UK Airports,CRANFIELD,NEWCASTLE,48,0,48,0,0,0,
9/23/2008 12:41,1996,1995,B,Other UK Airports,DUNDEE,MANCHESTER,18,18,0,17,17,0,5.882352829
9/23/2008 12:41,1996,1995,B,Other UK Airports,DURHAM TEES VALLEY,EDINBURGH,86,0,86,0,0,0,
9/23/2008 12:41,1996,1995,B,Other UK Airports,DURHAM TEES VALLEY,GLASGOW,0,0,0,76,0,76,
9/23/2008 12:41,1996,1995,B,Other UK Airports,DURHAM TEES VALLEY,HUMBERSIDE,465,465,0,425,425,0,9.411765099
9/23/2008 12:41,1996,1995,B,Other UK Airports,DURHAM TEES VALLEY,JERSEY,12322,8958,3364,11403,8851,2552,8.059282303
9/23/2008 12:41,1996,1995,B,Other UK Airports,DURHAM TEES VALLEY,LEEDS BRADFORD,35,0,35,200,0,200,-82.5
9/23/2008 12:41,1996,1995,B,Other UK Airports,DURHAM TEES VALLEY,MANCHESTER,71,0,71,112,0,112,-36.6071434
9/23/2008 12:41,1996,1995,B,Other UK Airports,DURHAM TEES VALLEY,NORWICH,2206,2206,0,2108,2108,0,4.648956299
9/23/2008 12:41,1996,1995,B,Other UK Airports,DURHAM TEES VALLEY,SOUTHAMPTON,99,0,99,196,0,196,-49.48979568
9/23/2008 12:41,1996,1995,B,Other UK Airports,EAST MIDLANDS INTERNATIONAL,EDINBURGH,82370,82143,227,68213,67786,427,20.75410843
9/23/2008 12:41,1996,1995,B,Other UK Airports,EAST MIDLANDS INTERNATIONAL,GLASGOW,103398,103285,113,93073,92869,204,11.09344292
9/23/2008 12:41,1996,1995,B,Other UK Airports,EAST MIDLANDS INTERNATIONAL,GUERNSEY,17339,17339,0,18053,17957,96,-3.955021381
9/23/2008 12:41,1996,1995,B,Other UK Airports,EAST MIDLANDS INTERNATIONAL,INVERNESS,0,0,0,208,0,208,
9/23/2008 12:41,1996,1995,B,Other UK Airports,EAST MIDLANDS INTERNATIONAL,JERSEY,68688,66447,2241,60149,58078,2071,14.19641209
9/23/2008 12:41,1996,1995,B,Other UK Airports,EAST MIDLANDS INTERNATIONAL,LEEDS BRADFORD,132,0,132,169,0,169,-21.89349174
9/23/2008 12:41,1996,1995,B,Other UK Airports,EAST MIDLANDS INTERNATIONAL,LIVERPOOL,80,0,80,4,0,4,1900
9/23/2008 12:41,1996,1995,B,Other UK Airports,EAST MIDLANDS INTERNATIONAL,MANCHESTER,100,0,100,279,0,279,-64.15770721
9/23/2008 12:41,1996,1995,B,Other UK Airports,EAST MIDLANDS INTERNATIONAL,NEWCASTLE,177,0,177,82,0,82,115.8536606
9/23/2008 12:41,1996,1995,B,Other UK Airports,EAST MIDLANDS INTERNATIONAL,SUMBURGH,1040,1040,0,1270,1270,0,-18.11023712
9/23/2008 12:41,1996,1995,B,Other UK Airports,EDAY,KIRKWALL,440,440,0,365,365,0,20.54794502
9/23/2008 12:41,1996,1995,B,Other UK Airports,EDINBURGH,EDINBURGH,95,0,95,0,0,0,
9/23/2008 12:41,1996,1995,B,Other UK Airports,EDINBURGH,GLASGOW,0,0,0,163,163,0,
9/23/2008 12:41,1996,1995,B,Other UK Airports,EDINBURGH,HUMBERSIDE,0,0,0,31,0,31,
9/23/2008 12:41,1996,1995,B,Other UK Airports,EDINBURGH,INVERNESS,32,0,32,0,0,0,
9/23/2008 12:41,1996,1995,B,Other UK Airports,EDINBURGH,ISLAY,38,0,38,0,0,0,
9/23/2008 12:41,1996,1995,B,Other UK Airports,EDINBURGH,JERSEY,9490,6702,2788,10970,7028,3942,-13.49133968
9/23/2008 12:41,1996,1995,B,Other UK Airports,EDINBURGH,KIRKWALL,11511,11327,184,9670,9670,0,19.03826332
9/23/2008 12:41,1996,1995,B,Other UK Airports,EDINBURGH,LEEDS BRADFORD,19812,19812,0,18233,18123,110,8.660121918
9/23/2008 12:41,1996,1995,B,Other UK Airports,EDINBURGH,MANCHESTER,128404,128404,0,119687,119332,355,7.283163548
9/23/2008 12:41,1996,1995,B,Other UK Airports,EDINBURGH,NEWCASTLE,24,0,24,7,0,7,242.8571472
9/23/2008 12:41,1996,1995,B,Other UK Airports,EDINBURGH,NORWICH,17015,17015,0,16188,16188,0,5.108722687
9/23/2008 12:41,1996,1995,B,Other UK Airports,EDINBURGH,PLYMOUTH,1991,1991,0,2160,2160,0,-7.824074268
9/23/2008 12:41,1996,1995,B,Other UK Airports,EDINBURGH,SOUTHAMPTON,32726,32726,0,29341,28944,397,11.53675747
9/23/2008 12:41,1996,1995,B,Other UK Airports,EDINBURGH,SUMBURGH,21466,21466,0,20143,20143,0,6.568038464
9/23/2008 12:41,1996,1995,B,Other UK Airports,EDINBURGH,UNST,0,0,0,72,0,72,
9/23/2008 12:41,1996,1995,B,Other UK Airports,EDINBURGH,WICK,206,206,0,57,57,0,261.4035034
9/23/2008 12:41,1996,1995,B,Other UK Airports,ENNISKILLEN,JERSEY,527,0,527,721,0,721,-26.90707397
9/23/2008 12:41,1996,1995,B,Other UK Airports,EXETER,GLASGOW,72,0,72,182,0,182,-60.43955994
9/23/2008 12:41,1996,1995,B,Other UK Airports,EXETER,GUERNSEY,25831,25831,0,20939,20939,0,23.36310196
9/23/2008 12:41,1996,1995,B,Other UK Airports,EXETER,ISLES OF SCILLY (ST.MARYS),6832,6832,0,6524,6524,0,4.721030235
9/23/2008 12:41,1996,1995,B,Other UK Airports,EXETER,JERSEY,33472,33431,41,31385,31385,0,6.649673462
9/23/2008 12:41,1996,1995,B,Other UK Airports,EXETER,LEEDS BRADFORD,40,0,40,0,0,0,
9/23/2008 12:41,1996,1995,B,Other UK Airports,EXETER,MANCHESTER,118,116,2,0,0,0,
9/23/2008 12:41,1996,1995,B,Other UK Airports,EXETER,NEWCASTLE,846,846,0,0,0,0,
9/23/2008 12:41,1996,1995,B,Other UK Airports,EXETER,NORWICH,0,0,0,84,0,84,
9/23/2008 12:41,1996,1995,B,Other UK Airports,EXETER,SOUTHAMPTON,27,27,0,0,0,0,
9/23/2008 12:41,1996,1995,B,Other UK Airports,FAIR ISLE,KIRKWALL,82,82,0,123,123,0,-33.33333206
9/23/2008 12:41,1996,1995,B,Other UK Airports,FAIR ISLE,LERWICK (TINGWALL),8,8,0,8,8,0,0
9/23/2008 12:41,1996,1995,B,Other UK Airports,FAIR ISLE,SUMBURGH,119,119,0,80,80,0,48.75
9/23/2008 12:41,1996,1995,B,Other UK Airports,FARNBOROUGH,HUMBERSIDE,150,0,150,0,0,0,
9/23/2008 12:41,1996,1995,B,Other UK Airports,FILTON,LIVERPOOL,135,0,135,130,0,130,3.846153736
9/23/2008 12:41,1996,1995,B,Other UK Airports,GLASGOW,GUERNSEY,2307,2307,0,2385,2385,0,-3.27044034
9/23/2008 12:41,1996,1995,B,Other UK Airports,GLASGOW,INVERNESS,6281,6281,0,447,447,0,1305.145386
9/23/2008 12:41,1996,1995,B,Other UK Airports,GLASGOW,ISLAY,15703,15667,36,16027,16027,0,-2.021588564
9/23/2008 12:41,1996,1995,B,Other UK Airports,GLASGOW,ISLE OF MAN,20251,20251,0,18436,18436,0,9.84486866
9/23/2008 12:41,1996,1995,B,Other UK Airports,GLASGOW,JERSEY,28313,23344,4969,29283,24180,5103,-3.312502146
9/23/2008 12:41,1996,1995,B,Other UK Airports,GLASGOW,KINLOSS,0,0,0,38,0,38,
9/23/2008 12:41,1996,1995,B,Other UK Airports,GLASGOW,KIRKWALL,2545,2545,0,10549,10549,0,-75.87448883
9/23/2008 12:41,1996,1995,B,Other UK Airports,GLASGOW,LEEDS BRADFORD,27874,27874,0,30605,30595,10,-8.923378944
9/23/2008 12:41,1996,1995,B,Other UK Airports,GLASGOW,LOSSIEMOUTH,38,0,38,0,0,0,
9/23/2008 12:41,1996,1995,B,Other UK Airports,GLASGOW,LYNEHAM,66,0,66,0,0,0,
9/23/2008 12:41,1996,1995,B,Other UK Airports,GLASGOW,MANCHESTER,141138,140907,231,133489,133209,280,5.730060101
9/23/2008 12:41,1996,1995,B,Other UK Airports,GLASGOW,NEWCASTLE,35,0,35,214,0,214,-83.64485931
9/23/2008 12:41,1996,1995,B,Other UK Airports,GLASGOW,SOUTHAMPTON,31988,31988,0,27174,27174,0,17.71546364
9/23/2008 12:41,1996,1995,B,Other UK Airports,GLASGOW,STORNOWAY,49738,49738,0,48581,48581,0,2.381589413
9/23/2008 12:41,1996,1995,B,Other UK Airports,GLASGOW,SUMBURGH,16815,16815,0,19195,19195,0,-12.39906216
9/23/2008 12:41,1996,1995,B,Other UK Airports,GLASGOW,TIREE,5276,5276,0,4200,4200,0,25.61904716
9/23/2008 12:41,1996,1995,B,Other UK Airports,GLOUCESTERSHIRE,JERSEY,76,0,76,1688,0,1688,-95.49762726
9/23/2008 12:41,1996,1995,B,Other UK Airports,GUERNSEY,JERSEY,185051,184753,298,189959,189955,4,-2.583715439
9/23/2008 12:41,1996,1995,B,Other UK Airports,GUERNSEY,LEEDS BRADFORD,10987,10987,0,6512,6471,41,68.71928406
9/23/2008 12:41,1996,1995,B,Other UK Airports,GUERNSEY,MANCHESTER,35125,33486,1639,34678,33070,1608,1.289001703
9/23/2008 12:41,1996,1995,B,Other UK Airports,GUERNSEY,NEWCASTLE,0,0,0,1079,1079,0,
9/23/2008 12:41,1996,1995,B,Other UK Airports,GUERNSEY,NORWICH,2019,2019,0,1834,1834,0,10.08724117
9/23/2008 12:41,1996,1995,B,Other UK Airports,GUERNSEY,PLYMOUTH,338,313,25,0,0,0,
9/23/2008 12:41,1996,1995,B,Other UK Airports,GUERNSEY,SOUTHAMPTON,106422,106422,0,102428,102428,0,3.899324417
9/23/2008 12:41,1996,1995,B,Other UK Airports,HAWARDEN,LIVERPOOL,18,0,18,0,0,0,
9/23/2008 12:41,1996,1995,B,Other UK Airports,HUMBERSIDE,JERSEY,5213,2964,2249,5384,2117,3267,-3.176077366
9/23/2008 12:41,1996,1995,B,Other UK Airports,HUMBERSIDE,LEEDS BRADFORD,0,0,0,26,0,26,
9/23/2008 12:41,1996,1995,B,Other UK Airports,HUMBERSIDE,MANCHESTER,209,0,209,0,0,0,
9/23/2008 12:41,1996,1995,B,Other UK Airports,HUMBERSIDE,NORWICH,343,343,0,358,358,0,-4.189944267
9/23/2008 12:41,1996,1995,B,Other UK Airports,INVERNESS,JERSEY,1705,0,1705,1335,0,1335,27.71535492
9/23/2008 12:41,1996,1995,B,Other UK Airports,INVERNESS,KIRKWALL,5017,5017,0,4874,4874,0,2.933935165
9/23/2008 12:41,1996,1995,B,Other UK Airports,INVERNESS,MANCHESTER,0,0,0,2600,2544,56,
9/23/2008 12:41,1996,1995,B,Other UK Airports,INVERNESS,STORNOWAY,31718,31718,0,32969,32969,0,-3.794473648
9/23/2008 12:41,1996,1995,B,Other UK Airports,INVERNESS,SUMBURGH,5919,5919,0,6649,6649,0,-10.97909451
9/23/2008 12:41,1996,1995,B,Other UK Airports,INVERNESS,WICK,0,0,0,32,32,0,
9/23/2008 12:41,1996,1995,B,Other UK Airports,ISLE OF MAN,JERSEY,4428,4428,0,5476,5476,0,-19.13805771
9/23/2008 12:41,1996,1995,B,Other UK Airports,ISLE OF MAN,LEEDS BRADFORD,12760,12457,303,11650,11650,0,9.527896881
9/23/2008 12:41,1996,1995,B,Other UK Airports,ISLE OF MAN,LIVERPOOL,199534,199026,508,139896,139896,0,42.63024139
9/23/2008 12:41,1996,1995,B,Other UK Airports,ISLE OF MAN,MANCHESTER,77589,77552,37,78462,78155,307,-1.1126405
9/23/2008 12:41,1996,1995,B,Other UK Airports,ISLE OF MAN,NEWCASTLE,1072,880,192,1100,910,190,-2.545454502
9/23/2008 12:41,1996,1995,B,Other UK Airports,ISLE OF MAN,NORWICH,16,0,16,0,0,0,
9/23/2008 12:41,1996,1995,B,Other UK Airports,ISLE OF MAN,SOUTHAMPTON,3335,3335,0,2363,2363,0,41.13415146
9/23/2008 12:41,1996,1995,B,Other UK Airports,JERSEY,KENT INTERNATIONAL,76,0,76,1733,0,1733,-95.6145401
9/23/2008 12:41,1996,1995,B,Other UK Airports,JERSEY,LEEDS BRADFORD,23333,23333,0,26296,24199,2097,-11.26787376
9/23/2008 12:41,1996,1995,B,Other UK Airports,JERSEY,LIVERPOOL,8541,3824,4717,8712,3072,5640,-1.96280992
9/23/2008 12:41,1996,1995,B,Other UK Airports,JERSEY,MANCHESTER,106038,85330,20708,105230,83944,21286,0.767841876
9/23/2008 12:41,1996,1995,B,Other UK Airports,JERSEY,NEWCASTLE,11520,2321,9199,14722,4040,10682,-21.74976158
9/23/2008 12:41,1996,1995,B,Other UK Airports,JERSEY,NEWQUAY,39,0,39,0,0,0,
9/23/2008 12:41,1996,1995,B,Other UK Airports,JERSEY,NORWICH,6843,6843,0,6930,6930,0,-1.255411267
9/23/2008 12:41,1996,1995,B,Other UK Airports,JERSEY,PLYMOUTH,4178,4168,10,3259,3259,0,28.19883347
9/23/2008 12:41,1996,1995,B,Other UK Airports,JERSEY,PRESTWICK,1375,0,1375,1934,0,1934,-28.90382576
9/23/2008 12:41,1996,1995,B,Other UK Airports,JERSEY,SOUTHAMPTON,144240,141806,2434,151679,144976,6703,-4.904436111
9/23/2008 12:41,1996,1995,B,Other UK Airports,KIRKWALL,NORTH RONALDSAY,3570,3570,0,3593,3593,0,-0.640133619
9/23/2008 12:41,1996,1995,B,Other UK Airports,KIRKWALL,PAPA WESTRAY,3065,3065,0,3100,3100,0,-1.129032254
9/23/2008 12:41,1996,1995,B,Other UK Airports,KIRKWALL,SANDAY,2623,2623,0,2625,2625,0,-0.076190479
9/23/2008 12:41,1996,1995,B,Other UK Airports,KIRKWALL,STRONSAY,1664,1664,0,2142,2142,0,-22.31559372
9/23/2008 12:41,1996,1995,B,Other UK Airports,KIRKWALL,SUMBURGH,9427,9427,0,9207,9143,64,2.389486313
9/23/2008 12:41,1996,1995,B,Other UK Airports,KIRKWALL,WESTRAY,2394,2394,0,2485,2485,0,-3.661971807
9/23/2008 12:41,1996,1995,B,Other UK Airports,KIRKWALL,WICK,4609,4609,0,3585,3585,0,28.5634594
9/23/2008 12:41,1996,1995,B,Other UK Airports,LEEDS BRADFORD,LIVERPOOL,30,0,30,0,0,0,
9/23/2008 12:41,1996,1995,B,Other UK Airports,LEEDS BRADFORD,NEWCASTLE,197,0,197,0,0,0,
9/23/2008 12:41,1996,1995,B,Other UK Airports,LEEDS BRADFORD,NORWICH,0,0,0,259,0,259,
9/23/2008 12:41,1996,1995,B,Other UK Airports,LEEDS BRADFORD,SOUTHAMPTON,8917,8917,0,6772,6747,25,31.67454147
9/23/2008 12:41,1996,1995,B,Other UK Airports,LIVERPOOL,MANCHESTER,34,0,34,42,0,42,-19.04761887
9/23/2008 12:41,1996,1995,B,Other UK Airports,LIVERPOOL,NEWCASTLE,0,0,0,426,0,426,
9/23/2008 12:41,1996,1995,B,Other UK Airports,LIVERPOOL,NORWICH,0,0,0,102,0,102,
9/23/2008 12:41,1996,1995,B,Other UK Airports,LIVERPOOL,PRESTWICK,248,0,248,178,0,178,39.32584381
9/23/2008 12:41,1996,1995,B,Other UK Airports,MANCHESTER,NEWCASTLE,13278,13200,78,15186,15082,104,-12.56420422
9/23/2008 12:41,1996,1995,B,Other UK Airports,MANCHESTER,NORWICH,4882,4882,0,739,0,739,560.6224365
9/23/2008 12:41,1996,1995,B,Other UK Airports,MANCHESTER,PRESTWICK,0,0,0,170,0,170,
9/23/2008 12:41,1996,1995,B,Other UK Airports,MANCHESTER,SOUTHAMPTON,40880,40802,78,32471,32009,462,25.89695358
9/23/2008 12:41,1996,1995,B,Other UK Airports,MANCHESTER,SUMBURGH,29873,29873,0,28417,28417,0,5.123693466
9/23/2008 12:41,1996,1995,B,Other UK Airports,NEWCASTLE,NORTHOLT,0,0,0,24,0,24,
9/23/2008 12:41,1996,1995,B,Other UK Airports,NEWCASTLE,NORWICH,0,0,0,1,1,0,
9/23/2008 12:41,1996,1995,B,Other UK Airports,NEWCASTLE,PRESTWICK,8616,8616,0,0,0,0,
9/23/2008 12:41,1996,1995,B,Other UK Airports,NEWCASTLE,SOUTHAMPTON,17288,17171,117,11150,10996,154,55.04932785
9/23/2008 12:41,1996,1995,B,Other UK Airports,NEWCASTLE,WICK,13030,13030,0,17265,17265,0,-24.52939415
9/23/2008 12:41,1996,1995,B,Other UK Airports,PRESTWICK,WOODFORD,21,0,21,0,0,0,
9/23/2008 12:41,1996,1995,B,Other UK Airports,SOUTH MARSTON,WICK,0,0,0,53,0,53,
9/23/2008 12:41,1996,1995,B,Other UK Airports,SUMBURGH,SUMBURGH,17,17,0,0,0,0,
9/23/2008 12:41,1996,1995,B,Other UK Airports,SUMBURGH,UNST,1707,1707,0,1748,1748,0,-2.345537663
9/23/2008 12:41,1996,1995,B,Other UK Airports,SUMBURGH,WICK,78,8,70,0,0,0,
9/23/2008 12:41,1996,1995,B,Other UK Airports,UNST,WICK,0,0,0,1,1,0,
