rundate,this_period,last_period,grp_name,apt1_apt_name,apt2_apt_name,total_pax_tp,total_pax_shd_2002,total_pax_cht_2002,total_pax_2001,total_pax_shd_2001,total_pax_cht_2001,total_pax_percent_change
31/03/2003 10:37,2002,2001,London Area Airports,GATWICK,ABERDEEN,241050,241050,0,235825,235777,48,2.215626001
31/03/2003 10:37,2002,2001,London Area Airports,GATWICK,BELFAST CITY,286971,286971,0,240891,240891,0,19.12898445
31/03/2003 10:37,2002,2001,London Area Airports,GATWICK,BIRMINGHAM,0,0,0,155,0,155,
31/03/2003 10:37,2002,2001,London Area Airports,GATWICK,BLACKPOOL,47,0,47,0,0,0,
31/03/2003 10:37,2002,2001,London Area Airports,GATWICK,BOURNEMOUTH,15,0,15,8,0,8,87.5
31/03/2003 10:37,2002,2001,London Area Airports,GATWICK,BRISTOL,5253,5253,0,14014,13979,35,-62.51605606
31/03/2003 10:37,2002,2001,London Area Airports,GATWICK,BRIZE NORTON,0,0,0,9,0,9,
31/03/2003 10:37,2002,2001,London Area Airports,GATWICK,CARDIFF WALES,1568,0,1568,0,0,0,
31/03/2003 10:37,2002,2001,London Area Airports,GATWICK,EDINBURGH,679439,679428,11,376614,376598,16,80.40725708
31/03/2003 10:37,2002,2001,London Area Airports,GATWICK,EXETER,0,0,0,24,24,0,
31/03/2003 10:37,2002,2001,London Area Airports,GATWICK,GLASGOW,338463,337315,1148,356450,356450,0,-5.046149731
31/03/2003 10:37,2002,2001,London Area Airports,GATWICK,GUERNSEY,314017,314017,0,307659,307659,0,2.06657362
31/03/2003 10:37,2002,2001,London Area Airports,GATWICK,INVERNESS,158929,158852,77,150897,150883,14,5.322835922
31/03/2003 10:37,2002,2001,London Area Airports,GATWICK,ISLE OF MAN,85979,85979,0,71,0,71,120997.1797
31/03/2003 10:37,2002,2001,London Area Airports,GATWICK,JERSEY,534081,533672,409,509363,509220,143,4.85272789
31/03/2003 10:37,2002,2001,London Area Airports,GATWICK,LEEDS BRADFORD,35955,35931,24,4480,4480,0,702.5669556
31/03/2003 10:37,2002,2001,London Area Airports,GATWICK,LIVERPOOL,0,0,0,27,0,27,
31/03/2003 10:37,2002,2001,London Area Airports,GATWICK,LUTON,1,0,1,0,0,0,
31/03/2003 10:37,2002,2001,London Area Airports,GATWICK,MANCHESTER,426083,421914,4169,471446,470450,996,-9.622098923
31/03/2003 10:37,2002,2001,London Area Airports,GATWICK,NEWCASTLE,210832,210561,271,199665,199637,28,5.592867851
31/03/2003 10:37,2002,2001,London Area Airports,GATWICK,NEWQUAY,47637,47637,0,59079,59079,0,-19.36728859
31/03/2003 10:37,2002,2001,London Area Airports,GATWICK,PLYMOUTH,58553,58553,0,52428,52428,0,11.68268871
31/03/2003 10:37,2002,2001,London Area Airports,GATWICK,STANSTED,166,166,0,0,0,0,
31/03/2003 10:37,2002,2001,London Area Airports,GATWICK,TEESSIDE,0,0,0,23,0,23,
31/03/2003 10:37,2002,2001,London Area Airports,GATWICK,WADDINGTON,47,0,47,0,0,0,
31/03/2003 10:37,2002,2001,London Area Airports,GATWICK,WATTISHAM,82,0,82,0,0,0,
31/03/2003 10:37,2002,2001,London Area Airports,HEATHROW,ABERDEEN,514703,514703,0,476933,476933,0,7.919351578
31/03/2003 10:37,2002,2001,London Area Airports,HEATHROW,BELFAST CITY,670837,670837,0,99096,99096,0,576.956665
31/03/2003 10:37,2002,2001,London Area Airports,HEATHROW,BELFAST INTERNATIONAL,305043,304787,256,876083,876083,0,-65.1810379
31/03/2003 10:37,2002,2001,London Area Airports,HEATHROW,BLACKPOOL,0,0,0,60,0,60,
31/03/2003 10:37,2002,2001,London Area Airports,HEATHROW,CARDIFF WALES,736,0,736,0,0,0,
31/03/2003 10:37,2002,2001,London Area Airports,HEATHROW,DUNDEE,1,0,1,0,0,0,
31/03/2003 10:37,2002,2001,London Area Airports,HEATHROW,EDINBURGH,1603397,1603385,12,1576686,1576586,100,1.69412303
31/03/2003 10:37,2002,2001,London Area Airports,HEATHROW,FAIRFORD,680,0,680,0,0,0,
31/03/2003 10:37,2002,2001,London Area Airports,HEATHROW,FAIROAKS,14,0,14,0,0,0,
31/03/2003 10:37,2002,2001,London Area Airports,HEATHROW,GLASGOW,1448294,1448294,0,1388375,1388375,0,4.315764904
31/03/2003 10:37,2002,2001,London Area Airports,HEATHROW,INVERNESS,0,0,0,33,0,33,
31/03/2003 10:37,2002,2001,London Area Airports,HEATHROW,ISLE OF MAN,27635,27635,0,112959,112959,0,-75.53536987
31/03/2003 10:37,2002,2001,London Area Airports,HEATHROW,JERSEY,2,0,2,676,576,100,-99.70413971
31/03/2003 10:37,2002,2001,London Area Airports,HEATHROW,LEEDS BRADFORD,181697,181697,0,203931,203871,60,-10.9027071
31/03/2003 10:37,2002,2001,London Area Airports,HEATHROW,LIVERPOOL,64,0,64,0,0,0,
31/03/2003 10:37,2002,2001,London Area Airports,HEATHROW,LONDONDERRY,0,0,0,158,0,158,
31/03/2003 10:37,2002,2001,London Area Airports,HEATHROW,MANCHESTER,1305072,1304956,116,1283733,1283733,0,1.662261486
31/03/2003 10:37,2002,2001,London Area Airports,HEATHROW,NEWCASTLE,464033,463963,70,459660,459660,0,0.951355338
31/03/2003 10:37,2002,2001,London Area Airports,HEATHROW,TEESSIDE,152929,152929,0,156079,156079,0,-2.018208742
31/03/2003 10:37,2002,2001,London Area Airports,LONDON CITY,ABERDEEN,106,104,2,42002,42002,0,-99.74762726
31/03/2003 10:37,2002,2001,London Area Airports,LONDON CITY,BELFAST CITY,81902,81902,0,52208,52208,0,56.87633896
31/03/2003 10:37,2002,2001,London Area Airports,LONDON CITY,BIGGIN HILL,0,0,0,10,10,0,
31/03/2003 10:37,2002,2001,London Area Airports,LONDON CITY,BIRMINGHAM,0,0,0,32,0,32,
31/03/2003 10:37,2002,2001,London Area Airports,LONDON CITY,BOURNEMOUTH,0,0,0,24,0,24,
31/03/2003 10:37,2002,2001,London Area Airports,LONDON CITY,BRISTOL,0,0,0,28,0,28,
31/03/2003 10:37,2002,2001,London Area Airports,LONDON CITY,CARDIFF WALES,0,0,0,28,0,28,
31/03/2003 10:37,2002,2001,London Area Airports,LONDON CITY,DUNDEE,45667,45667,0,46757,46757,0,-2.331201792
31/03/2003 10:37,2002,2001,London Area Airports,LONDON CITY,EDINBURGH,137042,136962,80,163261,163250,11,-16.05956078
31/03/2003 10:37,2002,2001,London Area Airports,LONDON CITY,EXETER,0,0,0,49,0,49,
31/03/2003 10:37,2002,2001,London Area Airports,LONDON CITY,GLASGOW,1098,1098,0,32918,32918,0,-96.66443634
31/03/2003 10:37,2002,2001,London Area Airports,LONDON CITY,GLOUCESTERSHIRE,0,0,0,27,0,27,
31/03/2003 10:37,2002,2001,London Area Airports,LONDON CITY,GUERNSEY,56,0,56,0,0,0,
31/03/2003 10:37,2002,2001,London Area Airports,LONDON CITY,INVERNESS,49,49,0,1115,1115,0,-95.60538483
31/03/2003 10:37,2002,2001,London Area Airports,LONDON CITY,ISLE OF MAN,41725,41725,0,29903,29851,52,39.53449631
31/03/2003 10:37,2002,2001,London Area Airports,LONDON CITY,JERSEY,88094,88094,0,88142,88142,0,-0.054457579
31/03/2003 10:37,2002,2001,London Area Airports,LONDON CITY,LEEDS BRADFORD,0,0,0,35,0,35,
31/03/2003 10:37,2002,2001,London Area Airports,LONDON CITY,LIVERPOOL,0,0,0,113,0,113,
31/03/2003 10:37,2002,2001,London Area Airports,LONDON CITY,MANCHESTER,22652,22652,0,0,0,0,
31/03/2003 10:37,2002,2001,London Area Airports,LONDON CITY,NEWQUAY,127,0,127,80,0,80,58.75
31/03/2003 10:37,2002,2001,London Area Airports,LONDON CITY,NORWICH,32,0,32,0,0,0,
31/03/2003 10:37,2002,2001,London Area Airports,LONDON CITY,PLYMOUTH,35,0,35,0,0,0,
31/03/2003 10:37,2002,2001,London Area Airports,LONDON CITY,WICK,0,0,0,23,0,23,
31/03/2003 10:37,2002,2001,London Area Airports,LUTON,ABERDEEN,163732,163732,0,159301,159301,0,2.781526804
31/03/2003 10:37,2002,2001,London Area Airports,LUTON,BELFAST INTERNATIONAL,407997,407997,0,377795,377677,118,7.994282722
31/03/2003 10:37,2002,2001,London Area Airports,LUTON,BIRMINGHAM,47,0,47,0,0,0,
31/03/2003 10:37,2002,2001,London Area Airports,LUTON,BLACKPOOL,28,0,28,27,0,27,3.703703642
31/03/2003 10:37,2002,2001,London Area Airports,LUTON,BOURNEMOUTH,0,0,0,6,0,6,
31/03/2003 10:37,2002,2001,London Area Airports,LUTON,BRIZE NORTON,1,0,1,0,0,0,
31/03/2003 10:37,2002,2001,London Area Airports,LUTON,CAMBRIDGE,1,0,1,0,0,0,
31/03/2003 10:37,2002,2001,London Area Airports,LUTON,CARDIFF WALES,1626,0,1626,381,0,381,326.7716675
31/03/2003 10:37,2002,2001,London Area Airports,LUTON,EAST MIDLANDS,11,0,11,0,0,0,
31/03/2003 10:37,2002,2001,London Area Airports,LUTON,EDINBURGH,502140,502011,129,486404,486287,117,3.235170841
31/03/2003 10:37,2002,2001,London Area Airports,LUTON,EXETER,0,0,0,191,155,36,
31/03/2003 10:37,2002,2001,London Area Airports,LUTON,GLASGOW,509827,509775,52,490658,489231,1427,3.906794548
31/03/2003 10:37,2002,2001,London Area Airports,LUTON,GUERNSEY,14,0,14,0,0,0,
31/03/2003 10:37,2002,2001,London Area Airports,LUTON,INVERNESS,111775,111743,32,112581,112581,0,-0.715928972
31/03/2003 10:37,2002,2001,London Area Airports,LUTON,ISLE OF MAN,37107,36878,229,40909,40748,161,-9.293798447
31/03/2003 10:37,2002,2001,London Area Airports,LUTON,JERSEY,8967,8712,255,40263,40101,162,-77.72893524
31/03/2003 10:37,2002,2001,London Area Airports,LUTON,LEEDS BRADFORD,128,0,128,68,0,68,88.23529053
31/03/2003 10:37,2002,2001,London Area Airports,LUTON,LEUCHARS,0,0,0,4,0,4,
31/03/2003 10:37,2002,2001,London Area Airports,LUTON,LIVERPOOL,529,343,186,48983,48647,336,-98.92003632
31/03/2003 10:37,2002,2001,London Area Airports,LUTON,MANCHESTER,1117,0,1117,1054,115,939,5.977229595
31/03/2003 10:37,2002,2001,London Area Airports,LUTON,NEWCASTLE,110,0,110,171,0,171,-35.67251587
31/03/2003 10:37,2002,2001,London Area Airports,LUTON,NEWQUAY,58,0,58,0,0,0,
31/03/2003 10:37,2002,2001,London Area Airports,LUTON,STANSTED,372,0,372,28,0,28,1228.571411
31/03/2003 10:37,2002,2001,London Area Airports,LUTON,TEESSIDE,0,0,0,38,0,38,
31/03/2003 10:37,2002,2001,London Area Airports,LUTON,WICK,117,0,117,0,0,0,
31/03/2003 10:37,2002,2001,London Area Airports,SOUTHEND,GUERNSEY,1482,0,1482,0,0,0,
31/03/2003 10:37,2002,2001,London Area Airports,SOUTHEND,JERSEY,2245,0,2245,3073,0,3073,-26.9443531
31/03/2003 10:37,2002,2001,London Area Airports,SOUTHEND,TEESSIDE,30,0,30,0,0,0,
31/03/2003 10:37,2002,2001,London Area Airports,STANSTED,ABERDEEN,6,0,6,91,0,91,-93.40659332
31/03/2003 10:37,2002,2001,London Area Airports,STANSTED,BELFAST CITY,16,0,16,53048,53048,0,-99.969841
31/03/2003 10:37,2002,2001,London Area Airports,STANSTED,BELFAST INTERNATIONAL,391480,391480,0,253157,253157,0,54.63921738
31/03/2003 10:37,2002,2001,London Area Airports,STANSTED,BIRMINGHAM,47,0,47,23,0,23,104.3478241
31/03/2003 10:37,2002,2001,London Area Airports,STANSTED,BLACKPOOL,51,0,51,331,0,331,-84.59214783
31/03/2003 10:37,2002,2001,London Area Airports,STANSTED,BRISTOL,0,0,0,189,189,0,
31/03/2003 10:37,2002,2001,London Area Airports,STANSTED,CARDIFF WALES,2532,0,2532,1311,0,1311,93.13500977
31/03/2003 10:37,2002,2001,London Area Airports,STANSTED,EAST MIDLANDS,0,0,0,20,0,20,
31/03/2003 10:37,2002,2001,London Area Airports,STANSTED,EDINBURGH,513380,513232,148,487449,486916,533,5.319736004
31/03/2003 10:37,2002,2001,London Area Airports,STANSTED,FAIROAKS,188,0,188,0,0,0,
31/03/2003 10:37,2002,2001,London Area Airports,STANSTED,GLASGOW,334497,334497,0,287301,286694,607,16.42737007
31/03/2003 10:37,2002,2001,London Area Airports,STANSTED,GUERNSEY,47749,47749,0,50271,50271,0,-5.016808987
31/03/2003 10:37,2002,2001,London Area Airports,STANSTED,INVERNESS,2255,0,2255,2562,0,2562,-11.98282623
31/03/2003 10:37,2002,2001,London Area Airports,STANSTED,ISLE OF MAN,0,0,0,56,0,56,
31/03/2003 10:37,2002,2001,London Area Airports,STANSTED,JERSEY,4358,0,4358,5584,0,5584,-21.95558739
31/03/2003 10:37,2002,2001,London Area Airports,STANSTED,KINLOSS,69,0,69,0,0,0,
31/03/2003 10:37,2002,2001,London Area Airports,STANSTED,LEEDS BRADFORD,35,0,35,77,0,77,-54.54545593
31/03/2003 10:37,2002,2001,London Area Airports,STANSTED,LIVERPOOL,467,0,467,776,0,776,-39.81958771
31/03/2003 10:37,2002,2001,London Area Airports,STANSTED,LONDONDERRY,134475,134475,0,131198,131198,0,2.497751474
31/03/2003 10:37,2002,2001,London Area Airports,STANSTED,MANCHESTER,33624,31138,2486,45591,42517,3074,-26.24860191
31/03/2003 10:37,2002,2001,London Area Airports,STANSTED,NEWCASTLE,221569,220857,712,71922,70648,1274,208.0684662
31/03/2003 10:37,2002,2001,London Area Airports,STANSTED,NEWQUAY,76477,76477,0,0,0,0,
31/03/2003 10:37,2002,2001,London Area Airports,STANSTED,PLYMOUTH,0,0,0,24,0,24,
31/03/2003 10:37,2002,2001,London Area Airports,STANSTED,PRESTWICK,694224,694224,0,627519,627519,0,10.6299572
31/03/2003 10:37,2002,2001,London Area Airports,STANSTED,TEESSIDE,304,0,304,279,0,279,8.960573196
31/03/2003 10:37,2002,2001,London Area Airports,STANSTED,WARTON,0,0,0,98,0,98,
31/03/2003 10:37,2002,2001,Other UK Airports,ABERDEEN,BELFAST CITY,8616,8616,0,1734,1734,0,396.8858032
31/03/2003 10:37,2002,2001,Other UK Airports,ABERDEEN,BELFAST INTERNATIONAL,0,0,0,7335,7335,0,
31/03/2003 10:37,2002,2001,Other UK Airports,ABERDEEN,BIRMINGHAM,52324,52324,0,58513,58504,9,-10.57713699
31/03/2003 10:37,2002,2001,Other UK Airports,ABERDEEN,BRISTOL,24774,24774,0,50026,50026,0,-50.47775269
31/03/2003 10:37,2002,2001,Other UK Airports,ABERDEEN,CARDIFF WALES,3393,3393,0,3823,3791,32,-11.24771118
31/03/2003 10:37,2002,2001,Other UK Airports,ABERDEEN,COVENTRY,73,0,73,0,0,0,
31/03/2003 10:37,2002,2001,Other UK Airports,ABERDEEN,EDINBURGH,80,0,80,316,147,169,-74.68354797
31/03/2003 10:37,2002,2001,Other UK Airports,ABERDEEN,FARNBOROUGH,5,0,5,7,0,7,-28.5714283
31/03/2003 10:37,2002,2001,Other UK Airports,ABERDEEN,GLASGOW,3922,3922,0,4975,4890,85,-21.1658287
31/03/2003 10:37,2002,2001,Other UK Airports,ABERDEEN,HUMBERSIDE,28931,28925,6,28981,28981,0,-0.172526821
31/03/2003 10:37,2002,2001,Other UK Airports,ABERDEEN,INVERNESS,0,0,0,74,0,74,
31/03/2003 10:37,2002,2001,Other UK Airports,ABERDEEN,JERSEY,1761,0,1761,1673,0,1673,5.26001215
31/03/2003 10:37,2002,2001,Other UK Airports,ABERDEEN,KIRKWALL,40287,40287,0,36979,36979,0,8.945617676
31/03/2003 10:37,2002,2001,Other UK Airports,ABERDEEN,LEEDS BRADFORD,12825,12825,0,15384,15384,0,-16.63416481
31/03/2003 10:37,2002,2001,Other UK Airports,ABERDEEN,MANCHESTER,150674,150674,0,152071,152030,41,-0.918649852
31/03/2003 10:37,2002,2001,Other UK Airports,ABERDEEN,NEWCASTLE,46254,46254,0,46515,45986,529,-0.561109304
31/03/2003 10:37,2002,2001,Other UK Airports,ABERDEEN,PLYMOUTH,1184,1184,0,286,286,0,313.9860229
31/03/2003 10:37,2002,2001,Other UK Airports,ABERDEEN,SCATSTA,139370,0,139370,133777,0,133777,4.180838108
31/03/2003 10:37,2002,2001,Other UK Airports,ABERDEEN,SOUTHAMPTON,10021,10021,0,26946,26946,0,-62.81080627
31/03/2003 10:37,2002,2001,Other UK Airports,ABERDEEN,STORNOWAY,191,0,191,48,0,48,297.9166565
31/03/2003 10:37,2002,2001,Other UK Airports,ABERDEEN,SUMBURGH,75731,71079,4652,78421,74046,4375,-3.430203676
31/03/2003 10:37,2002,2001,Other UK Airports,ALDERNEY,BOURNEMOUTH,7260,7260,0,0,0,0,
31/03/2003 10:37,2002,2001,Other UK Airports,ALDERNEY,GUERNSEY,31059,31059,0,34061,34061,0,-8.813599586
31/03/2003 10:37,2002,2001,Other UK Airports,ALDERNEY,JERSEY,9136,9136,0,9224,9224,0,-0.954032958
31/03/2003 10:37,2002,2001,Other UK Airports,ALDERNEY,SOUTHAMPTON,25462,25462,0,28830,28830,0,-11.68227577
31/03/2003 10:37,2002,2001,Other UK Airports,BARRA,BENBECULA,2767,2767,0,3021,3021,0,-8.407812119
31/03/2003 10:37,2002,2001,Other UK Airports,BARRA,GLASGOW,5547,5547,0,5586,5586,0,-0.698174
31/03/2003 10:37,2002,2001,Other UK Airports,BELFAST CITY,BIRMINGHAM,194203,194173,30,164959,164959,0,17.7280407
31/03/2003 10:37,2002,2001,Other UK Airports,BELFAST CITY,BLACKPOOL,3531,3512,19,9885,9829,56,-64.27921295
31/03/2003 10:37,2002,2001,Other UK Airports,BELFAST CITY,BRISTOL,66363,66363,0,59324,59324,0,11.86534977
31/03/2003 10:37,2002,2001,Other UK Airports,BELFAST CITY,CARDIFF WALES,10823,10823,0,2236,2236,0,384.0339966
31/03/2003 10:37,2002,2001,Other UK Airports,BELFAST CITY,DUNDEE,0,0,0,26,0,26,
31/03/2003 10:37,2002,2001,Other UK Airports,BELFAST CITY,EAST MIDLANDS,78425,78357,68,12300,12300,0,537.6016235
31/03/2003 10:37,2002,2001,Other UK Airports,BELFAST CITY,EDINBURGH,42827,42797,30,62951,62951,0,-31.96772003
31/03/2003 10:37,2002,2001,Other UK Airports,BELFAST CITY,EXETER,1756,1756,0,1950,1950,0,-9.948718071
31/03/2003 10:37,2002,2001,Other UK Airports,BELFAST CITY,GLASGOW,49040,49040,0,83985,83591,394,-41.60861969
31/03/2003 10:37,2002,2001,Other UK Airports,BELFAST CITY,INVERNESS,0,0,0,68,0,68,
31/03/2003 10:37,2002,2001,Other UK Airports,BELFAST CITY,ISLE OF MAN,39913,39847,66,22632,22628,4,76.35648346
31/03/2003 10:37,2002,2001,Other UK Airports,BELFAST CITY,JERSEY,10363,10363,0,0,0,0,
31/03/2003 10:37,2002,2001,Other UK Airports,BELFAST CITY,LEEDS BRADFORD,93764,93715,49,76455,76455,0,22.63946152
31/03/2003 10:37,2002,2001,Other UK Airports,BELFAST CITY,LIVERPOOL,0,0,0,4554,4554,0,
31/03/2003 10:37,2002,2001,Other UK Airports,BELFAST CITY,MANCHESTER,143618,143618,0,106189,106189,0,35.24753189
31/03/2003 10:37,2002,2001,Other UK Airports,BELFAST CITY,NEWCASTLE,103372,103372,0,102042,102015,27,1.3033849
31/03/2003 10:37,2002,2001,Other UK Airports,BELFAST CITY,PRESTWICK,0,0,0,96,0,96,
31/03/2003 10:37,2002,2001,Other UK Airports,BELFAST CITY,SHEFFIELD CITY,10409,10409,0,21750,21750,0,-52.14252853
31/03/2003 10:37,2002,2001,Other UK Airports,BELFAST CITY,SOUTHAMPTON,20293,20293,0,24853,24853,0,-18.34788513
31/03/2003 10:37,2002,2001,Other UK Airports,BELFAST INTERNATIONAL,BIRMINGHAM,112689,112473,216,145130,145122,8,-22.35306358
31/03/2003 10:37,2002,2001,Other UK Airports,BELFAST INTERNATIONAL,BRISTOL,163812,163812,0,31401,31401,0,421.6776428
31/03/2003 10:37,2002,2001,Other UK Airports,BELFAST INTERNATIONAL,CARDIFF WALES,10253,10051,202,12909,12711,198,-20.57479286
31/03/2003 10:37,2002,2001,Other UK Airports,BELFAST INTERNATIONAL,EAST MIDLANDS,18970,18941,29,61200,61200,0,-69.00326538
31/03/2003 10:37,2002,2001,Other UK Airports,BELFAST INTERNATIONAL,EDINBURGH,336981,336891,90,157119,156448,671,114.4750137
31/03/2003 10:37,2002,2001,Other UK Airports,BELFAST INTERNATIONAL,GLASGOW,379706,379558,148,163476,163073,403,132.2701874
31/03/2003 10:37,2002,2001,Other UK Airports,BELFAST INTERNATIONAL,JERSEY,1343,0,1343,11534,11534,0,-88.35616302
31/03/2003 10:37,2002,2001,Other UK Airports,BELFAST INTERNATIONAL,LEEDS BRADFORD,82,0,82,0,0,0,
31/03/2003 10:37,2002,2001,Other UK Airports,BELFAST INTERNATIONAL,LIVERPOOL,544907,544801,106,446849,446849,0,21.9443264
31/03/2003 10:37,2002,2001,Other UK Airports,BELFAST INTERNATIONAL,MANCHESTER,450,0,450,63744,63744,0,-99.29405212
31/03/2003 10:37,2002,2001,Other UK Airports,BELFAST INTERNATIONAL,SOUTH MARSTON,0,0,0,4,0,4,
31/03/2003 10:37,2002,2001,Other UK Airports,BENBECULA,GLASGOW,19642,19642,0,21301,21301,0,-7.788366795
31/03/2003 10:37,2002,2001,Other UK Airports,BENBECULA,STORNOWAY,9141,9141,0,9684,9684,0,-5.607187271
31/03/2003 10:37,2002,2001,Other UK Airports,BIGGIN HILL,BLACKPOOL,0,0,0,982,982,0,
31/03/2003 10:37,2002,2001,Other UK Airports,BIGGIN HILL,LEEDS BRADFORD,22,0,22,0,0,0,
31/03/2003 10:37,2002,2001,Other UK Airports,BIGGIN HILL,LIVERPOOL,0,0,0,29,0,29,
31/03/2003 10:37,2002,2001,Other UK Airports,BIGGIN HILL,NEWCASTLE,80,0,80,38,0,38,110.5263138
31/03/2003 10:37,2002,2001,Other UK Airports,BIGGIN HILL,TEESSIDE,56,0,56,80,0,80,-30
31/03/2003 10:37,2002,2001,Other UK Airports,BIGGIN HILL,WOODFORD,42,0,42,0,0,0,
31/03/2003 10:37,2002,2001,Other UK Airports,BIRMINGHAM,BRISTOL,0,0,0,63,0,63,
31/03/2003 10:37,2002,2001,Other UK Airports,BIRMINGHAM,EDINBURGH,334934,334199,735,288505,287623,882,16.09296227
31/03/2003 10:37,2002,2001,Other UK Airports,BIRMINGHAM,EXETER,0,0,0,28088,28034,54,
31/03/2003 10:37,2002,2001,Other UK Airports,BIRMINGHAM,GLASGOW,315997,315483,514,277728,277639,89,13.77930927
31/03/2003 10:37,2002,2001,Other UK Airports,BIRMINGHAM,GUERNSEY,46914,46914,0,37341,37341,0,25.63669968
31/03/2003 10:37,2002,2001,Other UK Airports,BIRMINGHAM,INVERNESS,0,0,0,67,0,67,
31/03/2003 10:37,2002,2001,Other UK Airports,BIRMINGHAM,ISLE OF MAN,49988,49935,53,47165,47165,0,5.985370636
31/03/2003 10:37,2002,2001,Other UK Airports,BIRMINGHAM,JERSEY,87674,78272,9402,87526,78736,8790,0.16909261
31/03/2003 10:37,2002,2001,Other UK Airports,BIRMINGHAM,KINLOSS,244,0,244,250,0,250,-2.400000095
31/03/2003 10:37,2002,2001,Other UK Airports,BIRMINGHAM,LEEDS BRADFORD,0,0,0,39,0,39,
31/03/2003 10:37,2002,2001,Other UK Airports,BIRMINGHAM,LEUCHARS,0,0,0,38,0,38,
31/03/2003 10:37,2002,2001,Other UK Airports,BIRMINGHAM,MANCHESTER,77,0,77,72,0,72,6.944444656
31/03/2003 10:37,2002,2001,Other UK Airports,BIRMINGHAM,NEWCASTLE,30361,30361,0,32209,32209,0,-5.737526894
31/03/2003 10:37,2002,2001,Other UK Airports,BIRMINGHAM,NORTHOLT,0,0,0,84,0,84,
31/03/2003 10:37,2002,2001,Other UK Airports,BIRMINGHAM,SOUTHAMPTON,0,0,0,39,0,39,
31/03/2003 10:37,2002,2001,Other UK Airports,BLACKPOOL,CARDIFF WALES,330,0,330,264,0,264,25
31/03/2003 10:37,2002,2001,Other UK Airports,BLACKPOOL,EDINBURGH,0,0,0,30,0,30,
31/03/2003 10:37,2002,2001,Other UK Airports,BLACKPOOL,EXETER,1,0,1,0,0,0,
31/03/2003 10:37,2002,2001,Other UK Airports,BLACKPOOL,ISLE OF MAN,10935,10765,170,4319,4319,0,153.183609
31/03/2003 10:37,2002,2001,Other UK Airports,BLACKPOOL,JERSEY,623,0,623,2740,0,2740,-77.26277161
31/03/2003 10:37,2002,2001,Other UK Airports,BLACKPOOL,NORTHOLT,0,0,0,34,0,34,
31/03/2003 10:37,2002,2001,Other UK Airports,BOURNEMOUTH,EDINBURGH,129,0,129,334,0,334,-61.37724686
31/03/2003 10:37,2002,2001,Other UK Airports,BOURNEMOUTH,EXETER,7,0,7,47,0,47,-85.10638428
31/03/2003 10:37,2002,2001,Other UK Airports,BOURNEMOUTH,JERSEY,9473,1226,8247,3988,0,3988,137.5376129
31/03/2003 10:37,2002,2001,Other UK Airports,BOURNEMOUTH,MANCHESTER,50,0,50,0,0,0,
31/03/2003 10:37,2002,2001,Other UK Airports,BOURNEMOUTH,NEWCASTLE,18,18,0,0,0,0,
31/03/2003 10:37,2002,2001,Other UK Airports,BOURNEMOUTH,PLYMOUTH,0,0,0,32,0,32,
31/03/2003 10:37,2002,2001,Other UK Airports,BRISTOL,CARDIFF WALES,123,0,123,405,10,395,-69.62963104
31/03/2003 10:37,2002,2001,Other UK Airports,BRISTOL,DUNDEE,0,0,0,51,0,51,
31/03/2003 10:37,2002,2001,Other UK Airports,BRISTOL,EAST MIDLANDS,0,0,0,219,0,219,
31/03/2003 10:37,2002,2001,Other UK Airports,BRISTOL,EDINBURGH,298416,298416,0,160618,160571,47,85.79237366
31/03/2003 10:37,2002,2001,Other UK Airports,BRISTOL,EXETER,96,0,96,0,0,0,
31/03/2003 10:37,2002,2001,Other UK Airports,BRISTOL,GLASGOW,265940,265784,156,143571,143571,0,85.23239136
31/03/2003 10:37,2002,2001,Other UK Airports,BRISTOL,GUERNSEY,1588,1588,0,10692,10692,0,-85.14777374
31/03/2003 10:37,2002,2001,Other UK Airports,BRISTOL,ISLE OF MAN,15363,15363,0,13251,13251,0,15.93841934
31/03/2003 10:37,2002,2001,Other UK Airports,BRISTOL,ISLES OF SCILLY (ST.MARYS),3667,3667,0,2987,2987,0,22.76531601
31/03/2003 10:37,2002,2001,Other UK Airports,BRISTOL,JERSEY,24481,23546,935,16039,15938,101,52.63420486
31/03/2003 10:37,2002,2001,Other UK Airports,BRISTOL,LEEDS BRADFORD,3060,3060,0,0,0,0,
31/03/2003 10:37,2002,2001,Other UK Airports,BRISTOL,MANCHESTER,1393,0,1393,2786,1922,864,-50
31/03/2003 10:37,2002,2001,Other UK Airports,BRISTOL,NEWCASTLE,39955,39955,0,26038,26038,0,53.44880676
31/03/2003 10:37,2002,2001,Other UK Airports,BRISTOL,NEWQUAY,0,0,0,601,558,43,
31/03/2003 10:37,2002,2001,Other UK Airports,BRISTOL,NORTHOLT,0,0,0,20,0,20,
31/03/2003 10:37,2002,2001,Other UK Airports,BRISTOL,PLYMOUTH,14991,14991,0,31101,31101,0,-51.7989769
31/03/2003 10:37,2002,2001,Other UK Airports,BRISTOL,PRESTWICK,0,0,0,52,0,52,
31/03/2003 10:37,2002,2001,Other UK Airports,BRISTOL,SHEFFIELD CITY,0,0,0,50,0,50,
31/03/2003 10:37,2002,2001,Other UK Airports,BRIZE NORTON,COVENTRY,0,0,0,3,0,3,
31/03/2003 10:37,2002,2001,Other UK Airports,BRIZE NORTON,EDINBURGH,0,0,0,92,0,92,
31/03/2003 10:37,2002,2001,Other UK Airports,CAMBRIDGE,WICK,0,0,0,86,0,86,
31/03/2003 10:37,2002,2001,Other UK Airports,CAMPBELTOWN,GLASGOW,8142,8142,0,8003,8003,0,1.736848712
31/03/2003 10:37,2002,2001,Other UK Airports,CARDIFF WALES,EAST MIDLANDS,120,0,120,0,0,0,
31/03/2003 10:37,2002,2001,Other UK Airports,CARDIFF WALES,EDINBURGH,29063,28922,141,32968,25829,7139,-11.84481907
31/03/2003 10:37,2002,2001,Other UK Airports,CARDIFF WALES,GLASGOW,19047,18979,68,25279,25275,4,-24.65287399
31/03/2003 10:37,2002,2001,Other UK Airports,CARDIFF WALES,GUERNSEY,0,0,0,2675,2675,0,
31/03/2003 10:37,2002,2001,Other UK Airports,CARDIFF WALES,ISLE OF MAN,0,0,0,46,0,46,
31/03/2003 10:37,2002,2001,Other UK Airports,CARDIFF WALES,JERSEY,24072,22917,1155,22187,20833,1354,8.495965958
31/03/2003 10:37,2002,2001,Other UK Airports,CARDIFF WALES,LEEDS BRADFORD,389,0,389,0,0,0,
31/03/2003 10:37,2002,2001,Other UK Airports,CARDIFF WALES,LIVERPOOL,95,0,95,1019,0,1019,-90.67713165
31/03/2003 10:37,2002,2001,Other UK Airports,CARDIFF WALES,MANCHESTER,266,0,266,2037,1532,505,-86.94158173
31/03/2003 10:37,2002,2001,Other UK Airports,CARDIFF WALES,NEWCASTLE,1780,1689,91,6632,6632,0,-73.16043091
31/03/2003 10:37,2002,2001,Other UK Airports,CARDIFF WALES,NORTHOLT,0,0,0,100,0,100,
31/03/2003 10:37,2002,2001,Other UK Airports,CARDIFF WALES,NORWICH,1926,0,1926,100,0,100,1826
31/03/2003 10:37,2002,2001,Other UK Airports,COVENTRY,EDINBURGH,0,0,0,50,0,50,
31/03/2003 10:37,2002,2001,Other UK Airports,COVENTRY,LEEDS BRADFORD,0,0,0,1,0,1,
31/03/2003 10:37,2002,2001,Other UK Airports,DENHAM,TEESSIDE,212,0,212,0,0,0,
31/03/2003 10:37,2002,2001,Other UK Airports,DUNDEE,JERSEY,1300,0,1300,2047,0,2047,-36.49242783
31/03/2003 10:37,2002,2001,Other UK Airports,DUNDEE,NORTHOLT,0,0,0,59,0,59,
31/03/2003 10:37,2002,2001,Other UK Airports,DUNDEE,NORWICH,0,0,0,81,0,81,
31/03/2003 10:37,2002,2001,Other UK Airports,EAST MIDLANDS,EDINBURGH,188183,188183,0,74283,73191,1092,153.3325195
31/03/2003 10:37,2002,2001,Other UK Airports,EAST MIDLANDS,GLASGOW,177314,177279,35,93374,93374,0,89.89654541
31/03/2003 10:37,2002,2001,Other UK Airports,EAST MIDLANDS,GUERNSEY,10610,10610,0,10260,10260,0,3.411306143
31/03/2003 10:37,2002,2001,Other UK Airports,EAST MIDLANDS,HUMBERSIDE,159,0,159,0,0,0,
31/03/2003 10:37,2002,2001,Other UK Airports,EAST MIDLANDS,ISLE OF MAN,1239,1239,0,0,0,0,
31/03/2003 10:37,2002,2001,Other UK Airports,EAST MIDLANDS,JERSEY,58294,54507,3787,63229,61004,2225,-7.804963112
31/03/2003 10:37,2002,2001,Other UK Airports,EAST MIDLANDS,WICK,48,0,48,0,0,0,
31/03/2003 10:37,2002,2001,Other UK Airports,EDAY,KIRKWALL,446,446,0,451,451,0,-1.108647466
31/03/2003 10:37,2002,2001,Other UK Airports,EDINBURGH,EXETER,1,0,1,2,0,2,-50
31/03/2003 10:37,2002,2001,Other UK Airports,EDINBURGH,FARNBOROUGH,247,0,247,25,0,25,888
31/03/2003 10:37,2002,2001,Other UK Airports,EDINBURGH,GLASGOW,657,589,68,31,0,31,2019.354858
31/03/2003 10:37,2002,2001,Other UK Airports,EDINBURGH,GUERNSEY,33,33,0,1333,1333,0,-97.52438354
31/03/2003 10:37,2002,2001,Other UK Airports,EDINBURGH,HAYDOCK PARK,91,0,91,0,0,0,
31/03/2003 10:37,2002,2001,Other UK Airports,EDINBURGH,INVERNESS,8118,7810,308,1523,1509,14,433.0269165
31/03/2003 10:37,2002,2001,Other UK Airports,EDINBURGH,ISLE OF MAN,3760,3760,0,0,0,0,
31/03/2003 10:37,2002,2001,Other UK Airports,EDINBURGH,JERSEY,13602,12047,1555,9619,8774,845,41.40763092
31/03/2003 10:37,2002,2001,Other UK Airports,EDINBURGH,KIRKWALL,28004,27977,27,28959,28853,106,-3.297765732
31/03/2003 10:37,2002,2001,Other UK Airports,EDINBURGH,LEEDS BRADFORD,49677,49677,0,34467,34457,10,44.12916565
31/03/2003 10:37,2002,2001,Other UK Airports,EDINBURGH,MANCHESTER,190317,190107,210,178363,178092,271,6.702062607
31/03/2003 10:37,2002,2001,Other UK Airports,EDINBURGH,NEWCASTLE,7,0,7,142,0,142,-95.07041931
31/03/2003 10:37,2002,2001,Other UK Airports,EDINBURGH,NORTHOLT,29,0,29,39,0,39,-25.64102554
31/03/2003 10:37,2002,2001,Other UK Airports,EDINBURGH,PLYMOUTH,1836,1836,0,1862,1830,32,-1.396348
31/03/2003 10:37,2002,2001,Other UK Airports,EDINBURGH,PRESTWICK,0,0,0,7,0,7,
31/03/2003 10:37,2002,2001,Other UK Airports,EDINBURGH,SCATSTA,0,0,0,107,0,107,
31/03/2003 10:37,2002,2001,Other UK Airports,EDINBURGH,SOUTHAMPTON,68326,68326,0,75578,75578,0,-9.595384598
31/03/2003 10:37,2002,2001,Other UK Airports,EDINBURGH,STORNOWAY,13285,13285,0,11066,11065,1,20.05241203
31/03/2003 10:37,2002,2001,Other UK Airports,EDINBURGH,SUMBURGH,16663,16663,0,16674,15914,760,-0.065970972
31/03/2003 10:37,2002,2001,Other UK Airports,EDINBURGH,TEESSIDE,0,0,0,297,0,297,
31/03/2003 10:37,2002,2001,Other UK Airports,EDINBURGH,WICK,96,22,74,135,103,32,-28.88888931
31/03/2003 10:37,2002,2001,Other UK Airports,ENNISKILLEN,JERSEY,0,0,0,533,0,533,
31/03/2003 10:37,2002,2001,Other UK Airports,EXETER,GLASGOW,41,41,0,0,0,0,
31/03/2003 10:37,2002,2001,Other UK Airports,EXETER,GUERNSEY,30328,30328,0,24917,24917,0,21.71609688
31/03/2003 10:37,2002,2001,Other UK Airports,EXETER,ISLES OF SCILLY (ST.MARYS),4467,4467,0,4201,4201,0,6.331825733
31/03/2003 10:37,2002,2001,Other UK Airports,EXETER,JERSEY,44361,44361,0,39915,39915,0,11.13866997
31/03/2003 10:37,2002,2001,Other UK Airports,EXETER,MANCHESTER,0,0,0,6,6,0,
31/03/2003 10:37,2002,2001,Other UK Airports,EXETER,NORTHOLT,0,0,0,108,0,108,
31/03/2003 10:37,2002,2001,Other UK Airports,EXETER,PRIVATE STRIPS/HELIPADS,41,0,41,0,0,0,
31/03/2003 10:37,2002,2001,Other UK Airports,EXETER,TEESSIDE,0,0,0,128,0,128,
31/03/2003 10:37,2002,2001,Other UK Airports,FAIR ISLE,LERWICK  (TINGWALL),2075,2075,0,1957,1957,0,6.029637337
31/03/2003 10:37,2002,2001,Other UK Airports,FAIR ISLE,SUMBURGH,208,208,0,144,144,0,44.44444275
31/03/2003 10:37,2002,2001,Other UK Airports,FARNBOROUGH,GLASGOW,4,0,4,7,0,7,-42.8571434
31/03/2003 10:37,2002,2001,Other UK Airports,FARNBOROUGH,GUERNSEY,4,0,4,0,0,0,
31/03/2003 10:37,2002,2001,Other UK Airports,FARNBOROUGH,HUMBERSIDE,4,0,4,0,0,0,
31/03/2003 10:37,2002,2001,Other UK Airports,FARNBOROUGH,JERSEY,21,0,21,1,0,1,2000
31/03/2003 10:37,2002,2001,Other UK Airports,FARNBOROUGH,NORWICH,0,0,0,32,0,32,
31/03/2003 10:37,2002,2001,Other UK Airports,FARNBOROUGH,PRESTWICK,198,0,198,0,0,0,
31/03/2003 10:37,2002,2001,Other UK Airports,FARNBOROUGH,SOUTHAMPTON,70,0,70,29,0,29,141.379303
31/03/2003 10:37,2002,2001,Other UK Airports,FARNBOROUGH,TEESSIDE,7,0,7,0,0,0,
31/03/2003 10:37,2002,2001,Other UK Airports,FILTON,GLASGOW,0,0,0,83,0,83,
31/03/2003 10:37,2002,2001,Other UK Airports,FILTON,HAWARDEN,1889,0,1889,2751,0,2751,-31.33406067
31/03/2003 10:37,2002,2001,Other UK Airports,FILTON,KENT INTERNATIONAL,0,0,0,122,0,122,
31/03/2003 10:37,2002,2001,Other UK Airports,FILTON,LIVERPOOL,42,0,42,0,0,0,
31/03/2003 10:37,2002,2001,Other UK Airports,FILTON,NEWCASTLE,0,0,0,93,0,93,
31/03/2003 10:37,2002,2001,Other UK Airports,GLASGOW,GUERNSEY,0,0,0,805,805,0,
31/03/2003 10:37,2002,2001,Other UK Airports,GLASGOW,INVERNESS,27717,27717,0,20724,20618,106,33.7434845
31/03/2003 10:37,2002,2001,Other UK Airports,GLASGOW,ISLAY,20833,20833,0,19609,19609,0,6.242031574
31/03/2003 10:37,2002,2001,Other UK Airports,GLASGOW,ISLE OF MAN,23958,23958,0,25816,25816,0,-7.197087288
31/03/2003 10:37,2002,2001,Other UK Airports,GLASGOW,JERSEY,13737,13424,313,19796,19515,281,-30.60719299
31/03/2003 10:37,2002,2001,Other UK Airports,GLASGOW,KIRKWALL,5363,5363,0,6417,6266,151,-16.42512131
31/03/2003 10:37,2002,2001,Other UK Airports,GLASGOW,LEEDS BRADFORD,39216,38907,309,36265,36260,5,8.137322426
31/03/2003 10:37,2002,2001,Other UK Airports,GLASGOW,LONDONDERRY,14740,14740,0,21397,21397,0,-31.11183739
31/03/2003 10:37,2002,2001,Other UK Airports,GLASGOW,MANCHESTER,143698,143101,597,148101,147394,707,-2.972971201
31/03/2003 10:37,2002,2001,Other UK Airports,GLASGOW,NEWCASTLE,2,0,2,441,0,441,-99.5464859
31/03/2003 10:37,2002,2001,Other UK Airports,GLASGOW,NORTHOLT,0,0,0,4,0,4,
31/03/2003 10:37,2002,2001,Other UK Airports,GLASGOW,NORWICH,0,0,0,37,0,37,
31/03/2003 10:37,2002,2001,Other UK Airports,GLASGOW,PLYMOUTH,748,748,0,6434,6434,0,-88.37425995
31/03/2003 10:37,2002,2001,Other UK Airports,GLASGOW,SCATSTA,0,0,0,88,0,88,
31/03/2003 10:37,2002,2001,Other UK Airports,GLASGOW,SOUTHAMPTON,66187,66167,20,71183,70725,458,-7.018529892
31/03/2003 10:37,2002,2001,Other UK Airports,GLASGOW,STORNOWAY,47823,47823,0,47989,47932,57,-0.345912606
31/03/2003 10:37,2002,2001,Other UK Airports,GLASGOW,SUMBURGH,12411,12327,84,18164,16539,1625,-31.67253876
31/03/2003 10:37,2002,2001,Other UK Airports,GLASGOW,TIREE,5302,5302,0,5244,5244,0,1.106025934
31/03/2003 10:37,2002,2001,Other UK Airports,GLASGOW,WARTON,0,0,0,2,0,2,
31/03/2003 10:37,2002,2001,Other UK Airports,GLOUCESTERSHIRE,SOUTHAMPTON,0,0,0,32,0,32,
31/03/2003 10:37,2002,2001,Other UK Airports,GUERNSEY,ISLE OF MAN,0,0,0,566,0,566,
31/03/2003 10:37,2002,2001,Other UK Airports,GUERNSEY,JERSEY,148894,148857,37,160341,160341,0,-7.139159679
31/03/2003 10:37,2002,2001,Other UK Airports,GUERNSEY,LEEDS BRADFORD,0,0,0,3226,3226,0,
31/03/2003 10:37,2002,2001,Other UK Airports,GUERNSEY,LIVERPOOL,3,0,3,0,0,0,
31/03/2003 10:37,2002,2001,Other UK Airports,GUERNSEY,MANCHESTER,51259,51259,0,51802,51802,0,-1.048222065
31/03/2003 10:37,2002,2001,Other UK Airports,GUERNSEY,NEWCASTLE,0,0,0,917,917,0,
31/03/2003 10:37,2002,2001,Other UK Airports,GUERNSEY,NORWICH,0,0,0,800,800,0,
31/03/2003 10:37,2002,2001,Other UK Airports,GUERNSEY,PLYMOUTH,0,0,0,388,388,0,
31/03/2003 10:37,2002,2001,Other UK Airports,GUERNSEY,SOUTHAMPTON,116939,116939,0,122919,122919,0,-4.864992619
31/03/2003 10:37,2002,2001,Other UK Airports,HUMBERSIDE,JERSEY,3445,0,3445,3454,0,3454,-0.260567456
31/03/2003 10:37,2002,2001,Other UK Airports,HUMBERSIDE,LEUCHARS,0,0,0,117,0,117,
31/03/2003 10:37,2002,2001,Other UK Airports,HUMBERSIDE,MANCHESTER,0,0,0,177,0,177,
31/03/2003 10:37,2002,2001,Other UK Airports,HUMBERSIDE,NEWCASTLE,0,0,0,18,18,0,
31/03/2003 10:37,2002,2001,Other UK Airports,HUMBERSIDE,NORWICH,0,0,0,48,0,48,
31/03/2003 10:37,2002,2001,Other UK Airports,INVERNESS,KIRKWALL,14189,14189,0,9764,9764,0,45.31954193
31/03/2003 10:37,2002,2001,Other UK Airports,INVERNESS,NORTHOLT,39,0,39,130,0,130,-70
31/03/2003 10:37,2002,2001,Other UK Airports,INVERNESS,SOUTH MARSTON,12,0,12,54,0,54,-77.77777863
31/03/2003 10:37,2002,2001,Other UK Airports,INVERNESS,STORNOWAY,26266,26221,45,23818,23818,0,10.27794075
31/03/2003 10:37,2002,2001,Other UK Airports,INVERNESS,SUMBURGH,1040,1040,0,3894,3894,0,-73.29224396
31/03/2003 10:37,2002,2001,Other UK Airports,INVERNESS,TEESSIDE,0,0,0,46,0,46,
31/03/2003 10:37,2002,2001,Other UK Airports,INVERNESS,WARTON,0,0,0,32,0,32,
31/03/2003 10:37,2002,2001,Other UK Airports,ISLE OF MAN,JERSEY,2592,2592,0,10918,10461,457,-76.25939178
31/03/2003 10:37,2002,2001,Other UK Airports,ISLE OF MAN,LEEDS BRADFORD,11225,11225,0,11398,11398,0,-1.517810106
31/03/2003 10:37,2002,2001,Other UK Airports,ISLE OF MAN,LIVERPOOL,187118,187118,0,198410,198388,22,-5.691245556
31/03/2003 10:37,2002,2001,Other UK Airports,ISLE OF MAN,MANCHESTER,94129,94119,10,97332,97196,136,-3.290798426
31/03/2003 10:37,2002,2001,Other UK Airports,ISLE OF MAN,NEWCASTLE,9968,9968,0,0,0,0,
31/03/2003 10:37,2002,2001,Other UK Airports,ISLE OF MAN,SOUTHAMPTON,2623,2623,0,3992,3992,0,-34.29358673
31/03/2003 10:37,2002,2001,Other UK Airports,ISLE OF MAN,SUMBURGH,0,0,0,180,0,180,
31/03/2003 10:37,2002,2001,Other UK Airports,JERSEY,LEEDS BRADFORD,32950,31294,1656,29993,28339,1654,9.858966827
31/03/2003 10:37,2002,2001,Other UK Airports,JERSEY,LIVERPOOL,4281,0,4281,6945,2831,4114,-38.35853195
31/03/2003 10:37,2002,2001,Other UK Airports,JERSEY,LONDONDERRY,0,0,0,480,196,284,
31/03/2003 10:37,2002,2001,Other UK Airports,JERSEY,MANCHESTER,81649,68651,12998,86698,73312,13386,-5.823663712
31/03/2003 10:37,2002,2001,Other UK Airports,JERSEY,NEWCASTLE,8481,3668,4813,10726,3248,7478,-20.93044853
31/03/2003 10:37,2002,2001,Other UK Airports,JERSEY,NORWICH,4074,0,4074,5664,899,4765,-28.07203484
31/03/2003 10:37,2002,2001,Other UK Airports,JERSEY,PLYMOUTH,258,258,0,9444,9444,0,-97.26810455
31/03/2003 10:37,2002,2001,Other UK Airports,JERSEY,PRESTWICK,1275,0,1275,1310,0,1310,-2.671755791
31/03/2003 10:37,2002,2001,Other UK Airports,JERSEY,SHEFFIELD CITY,2953,0,2953,908,0,908,225.2202606
31/03/2003 10:37,2002,2001,Other UK Airports,JERSEY,SOUTHAMPTON,140114,138969,1145,153455,151877,1578,-8.693754196
31/03/2003 10:37,2002,2001,Other UK Airports,JERSEY,SWANSEA,1598,1598,0,0,0,0,
31/03/2003 10:37,2002,2001,Other UK Airports,JERSEY,TEESSIDE,6334,4872,1462,7324,7324,0,-13.51720333
31/03/2003 10:37,2002,2001,Other UK Airports,KIRKWALL,MANCHESTER,0,0,0,104,0,104,
31/03/2003 10:37,2002,2001,Other UK Airports,KIRKWALL,NORTH RONALDSAY,4400,4400,0,3884,3884,0,13.2852726
31/03/2003 10:37,2002,2001,Other UK Airports,KIRKWALL,PAPA WESTRAY,2783,2783,0,2489,2489,0,11.81197262
31/03/2003 10:37,2002,2001,Other UK Airports,KIRKWALL,SANDAY,2483,2483,0,2076,2076,0,19.60500908
31/03/2003 10:37,2002,2001,Other UK Airports,KIRKWALL,STRONSAY,2719,2719,0,2430,2430,0,11.89300442
31/03/2003 10:37,2002,2001,Other UK Airports,KIRKWALL,SUMBURGH,7449,7252,197,7243,7243,0,2.844125271
31/03/2003 10:37,2002,2001,Other UK Airports,KIRKWALL,WESTRAY,2721,2721,0,2081,2081,0,30.75444412
31/03/2003 10:37,2002,2001,Other UK Airports,KIRKWALL,WICK,8355,8355,0,4511,4511,0,85.21392059
31/03/2003 10:37,2002,2001,Other UK Airports,LEEDS BRADFORD,MANCHESTER,0,0,0,20,0,20,
31/03/2003 10:37,2002,2001,Other UK Airports,LEEDS BRADFORD,NEWQUAY,310,0,310,0,0,0,
31/03/2003 10:37,2002,2001,Other UK Airports,LEEDS BRADFORD,NORTHOLT,0,0,0,142,0,142,
31/03/2003 10:37,2002,2001,Other UK Airports,LEEDS BRADFORD,SHEFFIELD CITY,0,0,0,32,0,32,
31/03/2003 10:37,2002,2001,Other UK Airports,LEEDS BRADFORD,SOUTHAMPTON,22021,22021,0,24558,24521,37,-10.33064556
31/03/2003 10:37,2002,2001,Other UK Airports,LERWICK  (TINGWALL),UNST,0,0,0,26,26,0,
31/03/2003 10:37,2002,2001,Other UK Airports,LIVERPOOL,NORTHOLT,0,0,0,42,0,42,
31/03/2003 10:37,2002,2001,Other UK Airports,LIVERPOOL,SANDOWN,0,0,0,28,0,28,
31/03/2003 10:37,2002,2001,Other UK Airports,LIVERPOOL,SOUTHAMPTON,174,0,174,65,0,65,167.6923065
31/03/2003 10:37,2002,2001,Other UK Airports,LONDONDERRY,MANCHESTER,0,0,0,38,38,0,
31/03/2003 10:37,2002,2001,Other UK Airports,LYDD,NORTHOLT,0,0,0,29,0,29,
31/03/2003 10:37,2002,2001,Other UK Airports,MANCHESTER,NEWCASTLE,94,0,94,45,0,45,108.8888855
31/03/2003 10:37,2002,2001,Other UK Airports,MANCHESTER,NORTHOLT,40,0,40,75,0,75,-46.66666794
31/03/2003 10:37,2002,2001,Other UK Airports,MANCHESTER,PRIVATE STRIPS/HELIPADS,79,0,79,0,0,0,
31/03/2003 10:37,2002,2001,Other UK Airports,MANCHESTER,SCATSTA,0,0,0,3,0,3,
31/03/2003 10:37,2002,2001,Other UK Airports,MANCHESTER,SOUTHAMPTON,57610,57521,89,64944,64837,107,-11.29280567
31/03/2003 10:37,2002,2001,Other UK Airports,MANCHESTER,SUMBURGH,573,0,573,0,0,0,
31/03/2003 10:37,2002,2001,Other UK Airports,NEWCASTLE,NEWQUAY,360,0,360,0,0,0,
31/03/2003 10:37,2002,2001,Other UK Airports,NEWCASTLE,NORTHOLT,0,0,0,90,0,90,
31/03/2003 10:37,2002,2001,Other UK Airports,NEWCASTLE,PLYMOUTH,619,619,0,2706,2706,0,-77.12490845
31/03/2003 10:37,2002,2001,Other UK Airports,NEWCASTLE,SOUTHAMPTON,29387,29329,58,33392,33251,141,-11.99389076
31/03/2003 10:37,2002,2001,Other UK Airports,NEWCASTLE,WICK,0,0,0,2112,2112,0,
31/03/2003 10:37,2002,2001,Other UK Airports,NORTHOLT,NORWICH,32,0,32,0,0,0,
31/03/2003 10:37,2002,2001,Other UK Airports,NORTHOLT,SOUTHAMPTON,0,0,0,50,0,50,
31/03/2003 10:37,2002,2001,Other UK Airports,NORTHOLT,TEESSIDE,0,0,0,10,0,10,
31/03/2003 10:37,2002,2001,Other UK Airports,NORTHOLT,WICK,0,0,0,16,0,16,
31/03/2003 10:37,2002,2001,Other UK Airports,PRESTWICK,WOODFORD,58,0,58,0,0,0,
31/03/2003 10:37,2002,2001,Other UK Airports,SCATSTA,SUMBURGH,44,0,44,54,0,54,-18.51851845
31/03/2003 10:37,2002,2001,Other UK Airports,SHEFFIELD CITY,SOUTHAMPTON,0,0,0,53,0,53,
31/03/2003 10:37,2002,2001,Other UK Airports,SOUTH MARSTON,WICK,0,0,0,34,0,34,
31/03/2003 10:37,2002,2001,Other UK Airports,SOUTHAMPTON,TEESSIDE,0,0,0,48,0,48,
31/03/2003 10:37,2002,2001,Other UK Airports,SOUTHAMPTON,WADDINGTON,11,0,11,50,0,50,-78
31/03/2003 10:37,2002,2001,Other UK Airports,SOUTHAMPTON,WARTON,287,0,287,333,0,333,-13.81381416
31/03/2003 10:37,2002,2001,Other UK Airports,SUMBURGH,UNST,0,0,0,238,238,0,
31/03/2003 10:37,2002,2001,Other UK Airports,SUMBURGH,WICK,616,569,47,1723,1723,0,-64.24840546
