rundate,this_period,last_period,grp_cd,grp_name,apt1_apt_name,apt2_apt_name,total_pax_tp,total_pax_shd_tp,total_pax_cht_tp,total_pax_lp,total_pax_shd_lp,total_pax_cht_lp,total_pax_pc
10/8/2008 11:44,1995,1994,A,London Area Airports,GATWICK,ABERDEEN,162630,162478,152,204448,204448,0,-20.45410156
10/8/2008 11:44,1995,1994,A,London Area Airports,GATWICK,BELFAST CITY (GEORGE BEST),224700,224626,74,210809,210809,0,6.589376926
10/8/2008 11:44,1995,1994,A,London Area Airports,GATWICK,BELFAST INTERNATIONAL,2647,2181,466,316,0,316,737.6582031
10/8/2008 11:44,1995,1994,A,London Area Airports,GATWICK,BIRMINGHAM,74,0,74,239,0,239,-69.03765869
10/8/2008 11:44,1995,1994,A,London Area Airports,GATWICK,BOURNEMOUTH,249,0,249,77,0,77,223.3766174
10/8/2008 11:44,1995,1994,A,London Area Airports,GATWICK,CARDIFF WALES,0,0,0,16,0,16,
10/8/2008 11:44,1995,1994,A,London Area Airports,GATWICK,COVENTRY,199,0,199,0,0,0,
10/8/2008 11:44,1995,1994,A,London Area Airports,GATWICK,DURHAM TEES VALLEY,234,0,234,162,25,137,44.44444275
10/8/2008 11:44,1995,1994,A,London Area Airports,GATWICK,EAST MIDLANDS INTERNATIONAL,1192,966,226,194,0,194,514.4329834
10/8/2008 11:44,1995,1994,A,London Area Airports,GATWICK,EDINBURGH,221762,220622,1140,202955,202018,937,9.266586304
10/8/2008 11:44,1995,1994,A,London Area Airports,GATWICK,EXETER,0,0,0,2,0,2,
10/8/2008 11:44,1995,1994,A,London Area Airports,GATWICK,FILTON,0,0,0,5,0,5,
10/8/2008 11:44,1995,1994,A,London Area Airports,GATWICK,GLASGOW,224369,223809,560,190918,189809,1109,17.52113533
10/8/2008 11:44,1995,1994,A,London Area Airports,GATWICK,GUERNSEY,194289,192353,1936,189573,189436,137,2.487695932
10/8/2008 11:44,1995,1994,A,London Area Airports,GATWICK,HEATHROW,0,0,0,3,0,3,
10/8/2008 11:44,1995,1994,A,London Area Airports,GATWICK,INVERNESS,78,0,78,0,0,0,
10/8/2008 11:44,1995,1994,A,London Area Airports,GATWICK,JERSEY,295617,293318,2299,276009,267581,8428,7.104115963
10/8/2008 11:44,1995,1994,A,London Area Airports,GATWICK,LEEDS BRADFORD,26606,26346,260,22824,22628,196,16.57027626
10/8/2008 11:44,1995,1994,A,London Area Airports,GATWICK,LEUCHARS,30,0,30,0,0,0,
10/8/2008 11:44,1995,1994,A,London Area Airports,GATWICK,LIVERPOOL,59,0,59,125,0,125,-52.79999924
10/8/2008 11:44,1995,1994,A,London Area Airports,GATWICK,LUTON,32,0,32,14,0,14,128.5714264
10/8/2008 11:44,1995,1994,A,London Area Airports,GATWICK,MANCHESTER,335703,332426,3277,254769,252733,2036,31.76760101
10/8/2008 11:44,1995,1994,A,London Area Airports,GATWICK,NEWCASTLE,88903,88556,347,74777,74541,236,18.89083481
10/8/2008 11:44,1995,1994,A,London Area Airports,GATWICK,PRESTWICK,13,0,13,0,0,0,
10/8/2008 11:44,1995,1994,A,London Area Airports,GATWICK,STANSTED,4,0,4,0,0,0,
10/8/2008 11:44,1995,1994,A,London Area Airports,HEATHROW,ABERDEEN,511031,511031,0,481625,481625,0,6.105579853
10/8/2008 11:44,1995,1994,A,London Area Airports,HEATHROW,BELFAST CITY (GEORGE BEST),0,0,0,82089,82065,24,
10/8/2008 11:44,1995,1994,A,London Area Airports,HEATHROW,BELFAST INTERNATIONAL,1082996,1082943,53,1068643,1068469,174,1.343105197
10/8/2008 11:44,1995,1994,A,London Area Airports,HEATHROW,BIRMINGHAM,300,0,300,600,0,600,-50
10/8/2008 11:44,1995,1994,A,London Area Airports,HEATHROW,BRISTOL,300,0,300,519,19,500,-42.1965332
10/8/2008 11:44,1995,1994,A,London Area Airports,HEATHROW,CARDIFF WALES,99,0,99,465,154,311,-78.70967865
10/8/2008 11:44,1995,1994,A,London Area Airports,HEATHROW,DURHAM TEES VALLEY,186566,186566,0,175811,175811,0,6.117364883
10/8/2008 11:44,1995,1994,A,London Area Airports,HEATHROW,EAST MIDLANDS INTERNATIONAL,342,46,296,660,261,399,-48.18181992
10/8/2008 11:44,1995,1994,A,London Area Airports,HEATHROW,EDINBURGH,1541421,1541420,1,1478916,1478858,58,4.226406574
10/8/2008 11:44,1995,1994,A,London Area Airports,HEATHROW,EXETER,400,0,400,0,0,0,
10/8/2008 11:44,1995,1994,A,London Area Airports,HEATHROW,FAIRFORD,200,0,200,400,0,400,-50
10/8/2008 11:44,1995,1994,A,London Area Airports,HEATHROW,FARNBOROUGH,0,0,0,98,0,98,
10/8/2008 11:44,1995,1994,A,London Area Airports,HEATHROW,FILTON,300,0,300,0,0,0,
10/8/2008 11:44,1995,1994,A,London Area Airports,HEATHROW,GLASGOW,1511213,1511047,166,1429358,1428816,542,5.726696968
10/8/2008 11:44,1995,1994,A,London Area Airports,HEATHROW,GUERNSEY,93711,93667,44,90150,90150,0,3.950083256
10/8/2008 11:44,1995,1994,A,London Area Airports,HEATHROW,HUMBERSIDE,181,0,181,200,0,200,-9.5
10/8/2008 11:44,1995,1994,A,London Area Airports,HEATHROW,INVERNESS,209274,209274,0,195540,195406,134,7.023626804
10/8/2008 11:44,1995,1994,A,London Area Airports,HEATHROW,ISLE OF MAN,117186,117186,0,116819,116819,0,0.314161211
10/8/2008 11:44,1995,1994,A,London Area Airports,HEATHROW,JERSEY,245519,245480,39,259267,258862,405,-5.302641869
10/8/2008 11:44,1995,1994,A,London Area Airports,HEATHROW,KENT INTERNATIONAL,400,0,400,347,0,347,15.2737751
10/8/2008 11:44,1995,1994,A,London Area Airports,HEATHROW,KINROSS,94,0,94,0,0,0,
10/8/2008 11:44,1995,1994,A,London Area Airports,HEATHROW,LEEDS BRADFORD,193327,192727,600,191888,191489,399,0.749916613
10/8/2008 11:44,1995,1994,A,London Area Airports,HEATHROW,LEUCHARS,152,0,152,129,0,129,17.82945824
10/8/2008 11:44,1995,1994,A,London Area Airports,HEATHROW,LIVERPOOL,238,0,238,240,0,240,-0.833333313
10/8/2008 11:44,1995,1994,A,London Area Airports,HEATHROW,LUTON,0,0,0,200,0,200,
10/8/2008 11:44,1995,1994,A,London Area Airports,HEATHROW,MANCHESTER,1073747,1072747,1000,1024608,1023269,1339,4.795882702
10/8/2008 11:44,1995,1994,A,London Area Airports,HEATHROW,NEWCASTLE,436332,436332,0,423677,423677,0,2.986945152
10/8/2008 11:44,1995,1994,A,London Area Airports,HEATHROW,NEWQUAY,30834,30834,0,28082,27928,154,9.799871445
10/8/2008 11:44,1995,1994,A,London Area Airports,HEATHROW,NORWICH,111,0,111,0,0,0,
10/8/2008 11:44,1995,1994,A,London Area Airports,HEATHROW,PLYMOUTH,64347,64347,0,54304,54304,0,18.49403381
10/8/2008 11:44,1995,1994,A,London Area Airports,HEATHROW,PRESTWICK,0,0,0,20,0,20,
10/8/2008 11:44,1995,1994,A,London Area Airports,LONDON CITY,ABERDEEN,37,0,37,0,0,0,
10/8/2008 11:44,1995,1994,A,London Area Airports,LONDON CITY,CITY OF DERRY (EGLINTON),0,0,0,80,0,80,
10/8/2008 11:44,1995,1994,A,London Area Airports,LONDON CITY,EDINBURGH,41,0,41,0,0,0,
10/8/2008 11:44,1995,1994,A,London Area Airports,LONDON CITY,HUMBERSIDE,521,521,0,703,703,0,-25.88904762
10/8/2008 11:44,1995,1994,A,London Area Airports,LONDON CITY,JERSEY,1162,0,1162,0,0,0,
10/8/2008 11:44,1995,1994,A,London Area Airports,LONDON CITY,LIVERPOOL,0,0,0,12326,12326,0,
10/8/2008 11:44,1995,1994,A,London Area Airports,LONDON CITY,SOUTHAMPTON,79,0,79,0,0,0,
10/8/2008 11:44,1995,1994,A,London Area Airports,LUTON,ABERDEEN,28,0,28,6,0,6,366.6666565
10/8/2008 11:44,1995,1994,A,London Area Airports,LUTON,BELFAST CITY (GEORGE BEST),40403,40223,180,73022,73022,0,-44.67010117
10/8/2008 11:44,1995,1994,A,London Area Airports,LUTON,BELFAST INTERNATIONAL,12866,12657,209,3677,3612,65,249.9048157
10/8/2008 11:44,1995,1994,A,London Area Airports,LUTON,BIRMINGHAM,148,0,148,0,0,0,
10/8/2008 11:44,1995,1994,A,London Area Airports,LUTON,BRISTOL,0,0,0,8,0,8,
10/8/2008 11:44,1995,1994,A,London Area Airports,LUTON,DURHAM TEES VALLEY,86,0,86,0,0,0,
10/8/2008 11:44,1995,1994,A,London Area Airports,LUTON,EAST MIDLANDS INTERNATIONAL,4,0,4,0,0,0,
10/8/2008 11:44,1995,1994,A,London Area Airports,LUTON,EDINBURGH,15752,14842,910,449,0,449,3408.240479
10/8/2008 11:44,1995,1994,A,London Area Airports,LUTON,GLASGOW,23587,23287,300,0,0,0,
10/8/2008 11:44,1995,1994,A,London Area Airports,LUTON,ISLE OF MAN,21362,21362,0,19751,19751,0,8.156549454
10/8/2008 11:44,1995,1994,A,London Area Airports,LUTON,JERSEY,10239,8300,1939,11922,10775,1147,-14.1167593
10/8/2008 11:44,1995,1994,A,London Area Airports,LUTON,LEEDS BRADFORD,255,0,255,0,0,0,
10/8/2008 11:44,1995,1994,A,London Area Airports,LUTON,LUTON,0,0,0,119,0,119,
10/8/2008 11:44,1995,1994,A,London Area Airports,LUTON,MANCHESTER,132,0,132,408,0,408,-67.64705658
10/8/2008 11:44,1995,1994,A,London Area Airports,LUTON,NEWCASTLE,179,0,179,183,0,183,-2.185792446
10/8/2008 11:44,1995,1994,A,London Area Airports,SOUTHEND,EDINBURGH,13,0,13,0,0,0,
10/8/2008 11:44,1995,1994,A,London Area Airports,SOUTHEND,HUMBERSIDE,30,0,30,0,0,0,
10/8/2008 11:44,1995,1994,A,London Area Airports,SOUTHEND,JERSEY,327,0,327,495,0,495,-33.93939209
10/8/2008 11:44,1995,1994,A,London Area Airports,STANSTED,ABERDEEN,88802,88802,0,73501,73257,244,20.81740379
10/8/2008 11:44,1995,1994,A,London Area Airports,STANSTED,BELFAST CITY (GEORGE BEST),166381,166286,95,59837,59837,0,178.0570526
10/8/2008 11:44,1995,1994,A,London Area Airports,STANSTED,BELFAST INTERNATIONAL,116168,115946,222,56,0,56,207342.8594
10/8/2008 11:44,1995,1994,A,London Area Airports,STANSTED,BIRMINGHAM,1,0,1,102,0,102,-99.01960754
10/8/2008 11:44,1995,1994,A,London Area Airports,STANSTED,BOURNEMOUTH,283,0,283,23,0,23,1130.434814
10/8/2008 11:44,1995,1994,A,London Area Airports,STANSTED,CARDIFF WALES,0,0,0,116,0,116,
10/8/2008 11:44,1995,1994,A,London Area Airports,STANSTED,CITY OF DERRY (EGLINTON),496,408,88,0,0,0,
10/8/2008 11:44,1995,1994,A,London Area Airports,STANSTED,DURHAM TEES VALLEY,1518,1285,233,1989,1989,0,-23.68024063
10/8/2008 11:44,1995,1994,A,London Area Airports,STANSTED,EAST MIDLANDS INTERNATIONAL,80,0,80,0,0,0,
10/8/2008 11:44,1995,1994,A,London Area Airports,STANSTED,EDINBURGH,154100,153119,981,108633,108445,188,41.85376358
10/8/2008 11:44,1995,1994,A,London Area Airports,STANSTED,EXETER,11,0,11,19,0,19,-42.10526276
10/8/2008 11:44,1995,1994,A,London Area Airports,STANSTED,GLASGOW,114879,114879,0,107429,107429,0,6.934812546
10/8/2008 11:44,1995,1994,A,London Area Airports,STANSTED,GUERNSEY,18471,18203,268,17710,17380,330,4.297007561
10/8/2008 11:44,1995,1994,A,London Area Airports,STANSTED,HUMBERSIDE,168,0,168,715,715,0,-76.50349426
10/8/2008 11:44,1995,1994,A,London Area Airports,STANSTED,INVERNESS,117,0,117,0,0,0,
10/8/2008 11:44,1995,1994,A,London Area Airports,STANSTED,ISLE OF MAN,0,0,0,89,0,89,
10/8/2008 11:44,1995,1994,A,London Area Airports,STANSTED,JERSEY,52005,49713,2292,50570,49648,922,2.837650776
10/8/2008 11:44,1995,1994,A,London Area Airports,STANSTED,LEEDS BRADFORD,633,0,633,0,0,0,
10/8/2008 11:44,1995,1994,A,London Area Airports,STANSTED,LEUCHARS,660,0,660,0,0,0,
10/8/2008 11:44,1995,1994,A,London Area Airports,STANSTED,LIVERPOOL,442,0,442,0,0,0,
10/8/2008 11:44,1995,1994,A,London Area Airports,STANSTED,MANCHESTER,23040,22225,815,17294,17292,2,33.2253952
10/8/2008 11:44,1995,1994,A,London Area Airports,STANSTED,NEWCASTLE,38323,37963,360,32968,32968,0,16.24302292
10/8/2008 11:44,1995,1994,A,London Area Airports,STANSTED,PLYMOUTH,71,0,71,0,0,0,
10/8/2008 11:44,1995,1994,A,London Area Airports,STANSTED,PRESTWICK,33373,33343,30,24,0,24,138954.1719
10/8/2008 11:44,1995,1994,A,London Area Airports,STANSTED,SOUTHAMPTON,0,0,0,1,0,1,
10/8/2008 11:44,1995,1994,A,London Area Airports,STANSTED,STANSTED,171,0,171,0,0,0,
10/8/2008 11:44,1995,1994,A,London Area Airports,STANSTED,SUMBURGH,0,0,0,46,0,46,
10/8/2008 11:44,1995,1994,A,London Area Airports,STANSTED,WOODFORD,0,0,0,4,0,4,
10/8/2008 11:44,1995,1994,B,Other UK Airports,ABERDEEN,BELFAST INTERNATIONAL,17529,17529,0,9733,9733,0,80.09863281
10/8/2008 11:44,1995,1994,B,Other UK Airports,ABERDEEN,BIRMINGHAM,46998,46998,0,44859,44859,0,4.76827383
10/8/2008 11:44,1995,1994,B,Other UK Airports,ABERDEEN,BRISTOL,26260,26260,0,21121,21121,0,24.33123398
10/8/2008 11:44,1995,1994,B,Other UK Airports,ABERDEEN,CARDIFF WALES,8299,8299,0,7280,7280,0,13.99725246
10/8/2008 11:44,1995,1994,B,Other UK Airports,ABERDEEN,COVENTRY,237,0,237,0,0,0,
10/8/2008 11:44,1995,1994,B,Other UK Airports,ABERDEEN,DUNDEE,19,19,0,15,15,0,26.66666603
10/8/2008 11:44,1995,1994,B,Other UK Airports,ABERDEEN,DURHAM TEES VALLEY,0,0,0,4367,4367,0,
10/8/2008 11:44,1995,1994,B,Other UK Airports,ABERDEEN,EAST MIDLANDS INTERNATIONAL,23146,22947,199,25326,25237,89,-8.607754707
10/8/2008 11:44,1995,1994,B,Other UK Airports,ABERDEEN,EDINBURGH,775,527,248,778,770,8,-0.385604113
10/8/2008 11:44,1995,1994,B,Other UK Airports,ABERDEEN,EXETER,22,22,0,0,0,0,
10/8/2008 11:44,1995,1994,B,Other UK Airports,ABERDEEN,GLASGOW,9769,9764,5,22655,22611,44,-56.87927628
10/8/2008 11:44,1995,1994,B,Other UK Airports,ABERDEEN,HUMBERSIDE,39852,39852,0,41776,41776,0,-4.605515003
10/8/2008 11:44,1995,1994,B,Other UK Airports,ABERDEEN,INVERNESS,511,511,0,2167,2021,146,-76.41901398
10/8/2008 11:44,1995,1994,B,Other UK Airports,ABERDEEN,ISLE OF MAN,1793,1793,0,0,0,0,
10/8/2008 11:44,1995,1994,B,Other UK Airports,ABERDEEN,JERSEY,3766,0,3766,4499,0,4499,-16.29250908
10/8/2008 11:44,1995,1994,B,Other UK Airports,ABERDEEN,KIRKWALL,31566,31346,220,28593,28545,48,10.39764977
10/8/2008 11:44,1995,1994,B,Other UK Airports,ABERDEEN,LEEDS BRADFORD,4717,4717,0,3574,3574,0,31.9809742
10/8/2008 11:44,1995,1994,B,Other UK Airports,ABERDEEN,MANCHESTER,111281,111281,0,78832,78832,0,41.16222
10/8/2008 11:44,1995,1994,B,Other UK Airports,ABERDEEN,NEWCASTLE,23527,23497,30,26376,26374,2,-10.80148602
10/8/2008 11:44,1995,1994,B,Other UK Airports,ABERDEEN,NORWICH,50319,50319,0,42424,42408,16,18.60974884
10/8/2008 11:44,1995,1994,B,Other UK Airports,ABERDEEN,PLYMOUTH,0,0,0,1956,1956,0,
10/8/2008 11:44,1995,1994,B,Other UK Airports,ABERDEEN,SOUTHAMPTON,2834,2834,0,3161,3161,0,-10.34482765
10/8/2008 11:44,1995,1994,B,Other UK Airports,ABERDEEN,SUMBURGH,262334,93114,169220,253789,94886,158903,3.366970301
10/8/2008 11:44,1995,1994,B,Other UK Airports,ABERDEEN,UNST,35803,0,35803,42442,0,42442,-15.64252377
10/8/2008 11:44,1995,1994,B,Other UK Airports,ABERDEEN,WICK,11189,11189,0,13065,13065,0,-14.35897446
10/8/2008 11:44,1995,1994,B,Other UK Airports,ALDERNEY,GUERNSEY,36935,36935,0,36841,36841,0,0.255150497
10/8/2008 11:44,1995,1994,B,Other UK Airports,ALDERNEY,JERSEY,15544,15544,0,15212,15212,0,2.182487488
10/8/2008 11:44,1995,1994,B,Other UK Airports,ALDERNEY,SOUTHAMPTON,32334,32334,0,31641,31641,0,2.190196276
10/8/2008 11:44,1995,1994,B,Other UK Airports,BARRA,BENBECULA,2466,2466,0,1591,1591,0,54.99685669
10/8/2008 11:44,1995,1994,B,Other UK Airports,BARRA,GLASGOW,4510,4510,0,1557,1557,0,189.6596069
10/8/2008 11:44,1995,1994,B,Other UK Airports,BARRA,STORNOWAY,630,630,0,106,106,0,494.3396301
10/8/2008 11:44,1995,1994,B,Other UK Airports,BARRA,TIREE,82,82,0,1964,1964,0,-95.82484436
10/8/2008 11:44,1995,1994,B,Other UK Airports,BELFAST CITY (GEORGE BEST),BIRMINGHAM,147633,147604,29,138279,138246,33,6.764584541
10/8/2008 11:44,1995,1994,B,Other UK Airports,BELFAST CITY (GEORGE BEST),BLACKPOOL,49761,49761,0,36490,36490,0,36.36886978
10/8/2008 11:44,1995,1994,B,Other UK Airports,BELFAST CITY (GEORGE BEST),BRISTOL,43275,43245,30,37230,37230,0,16.23690605
10/8/2008 11:44,1995,1994,B,Other UK Airports,BELFAST CITY (GEORGE BEST),CARDIFF WALES,14752,14752,0,14725,14662,63,0.183361635
10/8/2008 11:44,1995,1994,B,Other UK Airports,BELFAST CITY (GEORGE BEST),CITY OF DERRY (EGLINTON),25416,25416,0,0,0,0,
10/8/2008 11:44,1995,1994,B,Other UK Airports,BELFAST CITY (GEORGE BEST),DURHAM TEES VALLEY,1131,1131,0,9046,9046,0,-87.49723816
10/8/2008 11:44,1995,1994,B,Other UK Airports,BELFAST CITY (GEORGE BEST),EAST MIDLANDS INTERNATIONAL,2424,2424,0,48677,48677,0,-95.02023315
10/8/2008 11:44,1995,1994,B,Other UK Airports,BELFAST CITY (GEORGE BEST),EDINBURGH,65450,65450,0,63120,63120,0,3.691381454
10/8/2008 11:44,1995,1994,B,Other UK Airports,BELFAST CITY (GEORGE BEST),EXETER,15872,15872,0,14052,14052,0,12.95189285
10/8/2008 11:44,1995,1994,B,Other UK Airports,BELFAST CITY (GEORGE BEST),GLASGOW,74878,74878,0,71653,71653,0,4.500858307
10/8/2008 11:44,1995,1994,B,Other UK Airports,BELFAST CITY (GEORGE BEST),ISLE OF MAN,4563,4560,3,24732,24732,0,-81.55021667
10/8/2008 11:44,1995,1994,B,Other UK Airports,BELFAST CITY (GEORGE BEST),JERSEY,14719,12153,2566,10901,8479,2422,35.02431107
10/8/2008 11:44,1995,1994,B,Other UK Airports,BELFAST CITY (GEORGE BEST),LEEDS BRADFORD,82211,82211,0,71598,71598,0,14.82304001
10/8/2008 11:44,1995,1994,B,Other UK Airports,BELFAST CITY (GEORGE BEST),LIVERPOOL,65012,65012,0,68662,68662,0,-5.315895081
10/8/2008 11:44,1995,1994,B,Other UK Airports,BELFAST CITY (GEORGE BEST),MANCHESTER,128336,128135,201,121626,121579,47,5.51691246
10/8/2008 11:44,1995,1994,B,Other UK Airports,BELFAST CITY (GEORGE BEST),NEWCASTLE,52366,52366,0,47807,47807,0,9.536260605
10/8/2008 11:44,1995,1994,B,Other UK Airports,BELFAST CITY (GEORGE BEST),PRESTWICK,27683,27683,0,0,0,0,
10/8/2008 11:44,1995,1994,B,Other UK Airports,BELFAST CITY (GEORGE BEST),SOUTHAMPTON,16912,16912,0,11308,11308,0,49.55783463
10/8/2008 11:44,1995,1994,B,Other UK Airports,BELFAST INTERNATIONAL,BIRMINGHAM,129010,128885,125,109608,109284,324,17.70126343
10/8/2008 11:44,1995,1994,B,Other UK Airports,BELFAST INTERNATIONAL,BRISTOL,21,0,21,0,0,0,
10/8/2008 11:44,1995,1994,B,Other UK Airports,BELFAST INTERNATIONAL,COVENTRY,0,0,0,1,0,1,
10/8/2008 11:44,1995,1994,B,Other UK Airports,BELFAST INTERNATIONAL,DURHAM TEES VALLEY,919,919,0,0,0,0,
10/8/2008 11:44,1995,1994,B,Other UK Airports,BELFAST INTERNATIONAL,EAST MIDLANDS INTERNATIONAL,67752,67547,205,127,0,127,53248.03125
10/8/2008 11:44,1995,1994,B,Other UK Airports,BELFAST INTERNATIONAL,EDINBURGH,65,0,65,0,0,0,
10/8/2008 11:44,1995,1994,B,Other UK Airports,BELFAST INTERNATIONAL,FILTON,4,0,4,0,0,0,
10/8/2008 11:44,1995,1994,B,Other UK Airports,BELFAST INTERNATIONAL,GLASGOW,48310,48232,78,65695,65695,0,-26.46320152
10/8/2008 11:44,1995,1994,B,Other UK Airports,BELFAST INTERNATIONAL,JERSEY,17996,17967,29,19828,19480,348,-9.239459038
10/8/2008 11:44,1995,1994,B,Other UK Airports,BELFAST INTERNATIONAL,KENT INTERNATIONAL,0,0,0,118,0,118,
10/8/2008 11:44,1995,1994,B,Other UK Airports,BELFAST INTERNATIONAL,LEEDS BRADFORD,6851,6851,0,2351,2261,90,191.4079132
10/8/2008 11:44,1995,1994,B,Other UK Airports,BELFAST INTERNATIONAL,LIVERPOOL,0,0,0,87,0,87,
10/8/2008 11:44,1995,1994,B,Other UK Airports,BELFAST INTERNATIONAL,MANCHESTER,128475,128446,29,122029,121850,179,5.282351017
10/8/2008 11:44,1995,1994,B,Other UK Airports,BELFAST INTERNATIONAL,NEWCASTLE,13,0,13,66,0,66,-80.30303192
10/8/2008 11:44,1995,1994,B,Other UK Airports,BELFAST INTERNATIONAL,NORWICH,46,0,46,0,0,0,
10/8/2008 11:44,1995,1994,B,Other UK Airports,BENBECULA,GLASGOW,21591,21591,0,21804,21804,0,-0.976884961
10/8/2008 11:44,1995,1994,B,Other UK Airports,BENBECULA,STORNOWAY,13375,13375,0,12609,12609,0,6.075025558
10/8/2008 11:44,1995,1994,B,Other UK Airports,BIRMINGHAM,BRISTOL,92,0,92,0,0,0,
10/8/2008 11:44,1995,1994,B,Other UK Airports,BIRMINGHAM,CARDIFF WALES,335,0,335,0,0,0,
10/8/2008 11:44,1995,1994,B,Other UK Airports,BIRMINGHAM,CITY OF DERRY (EGLINTON),344,344,0,0,0,0,
10/8/2008 11:44,1995,1994,B,Other UK Airports,BIRMINGHAM,EAST MIDLANDS INTERNATIONAL,361,260,101,551,120,431,-34.48275757
10/8/2008 11:44,1995,1994,B,Other UK Airports,BIRMINGHAM,EDINBURGH,206652,205995,657,189856,189110,746,8.846704483
10/8/2008 11:44,1995,1994,B,Other UK Airports,BIRMINGHAM,EXETER,40,0,40,0,0,0,
10/8/2008 11:44,1995,1994,B,Other UK Airports,BIRMINGHAM,GLASGOW,233934,233417,517,190103,189204,899,23.05644798
10/8/2008 11:44,1995,1994,B,Other UK Airports,BIRMINGHAM,GUERNSEY,32764,32764,0,28636,28636,0,14.41542149
10/8/2008 11:44,1995,1994,B,Other UK Airports,BIRMINGHAM,INVERNESS,196,0,196,76,0,76,157.8947296
10/8/2008 11:44,1995,1994,B,Other UK Airports,BIRMINGHAM,ISLE OF MAN,44356,44332,24,40551,40551,0,9.383245468
10/8/2008 11:44,1995,1994,B,Other UK Airports,BIRMINGHAM,JERSEY,65118,53805,11313,69252,56826,12426,-5.969502449
10/8/2008 11:44,1995,1994,B,Other UK Airports,BIRMINGHAM,KINLOSS,106,0,106,0,0,0,
10/8/2008 11:44,1995,1994,B,Other UK Airports,BIRMINGHAM,KIRKWALL,21417,21417,0,10092,10092,0,112.217598
10/8/2008 11:44,1995,1994,B,Other UK Airports,BIRMINGHAM,MANCHESTER,303,126,177,382,346,36,-20.68062782
10/8/2008 11:44,1995,1994,B,Other UK Airports,BIRMINGHAM,NEWCASTLE,21239,21158,81,19908,19908,0,6.685754299
10/8/2008 11:44,1995,1994,B,Other UK Airports,BIRMINGHAM,PRESTWICK,0,0,0,146,0,146,
10/8/2008 11:44,1995,1994,B,Other UK Airports,BIRMINGHAM,WICK,0,0,0,33,33,0,
10/8/2008 11:44,1995,1994,B,Other UK Airports,BLACKPOOL,CITY OF DERRY (EGLINTON),445,445,0,0,0,0,
10/8/2008 11:44,1995,1994,B,Other UK Airports,BLACKPOOL,ISLE OF MAN,3570,3570,0,449,449,0,695.1002197
10/8/2008 11:44,1995,1994,B,Other UK Airports,BLACKPOOL,JERSEY,3391,1626,1765,3816,2251,1565,-11.1373167
10/8/2008 11:44,1995,1994,B,Other UK Airports,BLACKPOOL,LEEDS BRADFORD,388,0,388,0,0,0,
10/8/2008 11:44,1995,1994,B,Other UK Airports,BLACKPOOL,LYDD,17,0,17,0,0,0,
10/8/2008 11:44,1995,1994,B,Other UK Airports,BOURNEMOUTH,BRISTOL,337,0,337,183,0,183,84.15300751
10/8/2008 11:44,1995,1994,B,Other UK Airports,BOURNEMOUTH,EDINBURGH,0,0,0,137,0,137,
10/8/2008 11:44,1995,1994,B,Other UK Airports,BOURNEMOUTH,EXETER,209,0,209,280,0,280,-25.3571434
10/8/2008 11:44,1995,1994,B,Other UK Airports,BOURNEMOUTH,GLASGOW,0,0,0,179,0,179,
10/8/2008 11:44,1995,1994,B,Other UK Airports,BOURNEMOUTH,GUERNSEY,526,0,526,1176,1,1175,-55.27210999
10/8/2008 11:44,1995,1994,B,Other UK Airports,BOURNEMOUTH,HUMBERSIDE,0,0,0,4,4,0,
10/8/2008 11:44,1995,1994,B,Other UK Airports,BOURNEMOUTH,JERSEY,3693,0,3693,2046,279,1767,80.49853516
10/8/2008 11:44,1995,1994,B,Other UK Airports,BRISTOL,CARDIFF WALES,1,0,1,0,0,0,
10/8/2008 11:44,1995,1994,B,Other UK Airports,BRISTOL,DURHAM TEES VALLEY,0,0,0,78,0,78,
10/8/2008 11:44,1995,1994,B,Other UK Airports,BRISTOL,EDINBURGH,59984,59593,391,42197,41700,497,42.15228653
10/8/2008 11:44,1995,1994,B,Other UK Airports,BRISTOL,EXETER,174,0,174,73,16,57,138.3561707
10/8/2008 11:44,1995,1994,B,Other UK Airports,BRISTOL,FILTON,0,0,0,46,0,46,
10/8/2008 11:44,1995,1994,B,Other UK Airports,BRISTOL,GLASGOW,62347,62325,22,63000,62974,26,-1.036507964
10/8/2008 11:44,1995,1994,B,Other UK Airports,BRISTOL,GUERNSEY,7676,7474,202,5108,4888,220,50.27407837
10/8/2008 11:44,1995,1994,B,Other UK Airports,BRISTOL,ISLES OF SCILLY (ST.MARYS),2038,2038,0,13,13,0,15576.92285
10/8/2008 11:44,1995,1994,B,Other UK Airports,BRISTOL,JERSEY,35786,33278,2508,33838,29526,4312,5.756841183
10/8/2008 11:44,1995,1994,B,Other UK Airports,BRISTOL,MANCHESTER,174,0,174,24,0,24,625
10/8/2008 11:44,1995,1994,B,Other UK Airports,BRISTOL,NEWCASTLE,2447,2239,208,1437,1402,35,70.28531647
10/8/2008 11:44,1995,1994,B,Other UK Airports,BRISTOL,NORWICH,0,0,0,100,0,100,
10/8/2008 11:44,1995,1994,B,Other UK Airports,BRISTOL,PLYMOUTH,8939,8939,0,6934,6934,0,28.9154892
10/8/2008 11:44,1995,1994,B,Other UK Airports,BRIZE NORTON,EDINBURGH,0,0,0,124,0,124,
10/8/2008 11:44,1995,1994,B,Other UK Airports,BRIZE NORTON,LEEDS BRADFORD,0,0,0,87,0,87,
10/8/2008 11:44,1995,1994,B,Other UK Airports,CAMBRIDGE,JERSEY,3141,2528,613,3455,3455,0,-9.088277817
10/8/2008 11:44,1995,1994,B,Other UK Airports,CAMBRIDGE,MANCHESTER,6998,6989,9,7198,7198,0,-2.778549671
10/8/2008 11:44,1995,1994,B,Other UK Airports,CAMBRIDGE,NEWCASTLE,0,0,0,37,2,35,
10/8/2008 11:44,1995,1994,B,Other UK Airports,CAMPBELTOWN,GLASGOW,32,32,0,136,136,0,-76.47058868
10/8/2008 11:44,1995,1994,B,Other UK Airports,CARDIFF WALES,EAST MIDLANDS INTERNATIONAL,0,0,0,21,0,21,
10/8/2008 11:44,1995,1994,B,Other UK Airports,CARDIFF WALES,EDINBURGH,15543,5225,10318,5232,4555,677,197.0756836
10/8/2008 11:44,1995,1994,B,Other UK Airports,CARDIFF WALES,GLASGOW,20678,20678,0,18943,18909,34,9.15905571
10/8/2008 11:44,1995,1994,B,Other UK Airports,CARDIFF WALES,GUERNSEY,1427,1359,68,1126,1126,0,26.73179436
10/8/2008 11:44,1995,1994,B,Other UK Airports,CARDIFF WALES,ISLE OF MAN,2611,2611,0,2841,2841,0,-8.095741272
10/8/2008 11:44,1995,1994,B,Other UK Airports,CARDIFF WALES,JERSEY,19946,19946,0,21270,20641,629,-6.224729538
10/8/2008 11:44,1995,1994,B,Other UK Airports,CARDIFF WALES,LEEDS BRADFORD,0,0,0,199,199,0,
10/8/2008 11:44,1995,1994,B,Other UK Airports,CARDIFF WALES,MANCHESTER,1452,1452,0,32,13,19,4437.5
10/8/2008 11:44,1995,1994,B,Other UK Airports,CARDIFF WALES,NEWCASTLE,0,0,0,45,0,45,
10/8/2008 11:44,1995,1994,B,Other UK Airports,CARDIFF WALES,SOUTHAMPTON,12,12,0,63,63,0,-80.95237732
10/8/2008 11:44,1995,1994,B,Other UK Airports,CARLISLE,EAST MIDLANDS INTERNATIONAL,96,0,96,0,0,0,
10/8/2008 11:44,1995,1994,B,Other UK Airports,CARLISLE,MANCHESTER,59,0,59,0,0,0,
10/8/2008 11:44,1995,1994,B,Other UK Airports,CITY OF DERRY (EGLINTON),EDINBURGH,510,510,0,0,0,0,
10/8/2008 11:44,1995,1994,B,Other UK Airports,CITY OF DERRY (EGLINTON),GLASGOW,14001,14001,0,14287,14287,0,-2.001819849
10/8/2008 11:44,1995,1994,B,Other UK Airports,CITY OF DERRY (EGLINTON),ISLE OF MAN,189,0,189,172,0,172,9.883721352
10/8/2008 11:44,1995,1994,B,Other UK Airports,CITY OF DERRY (EGLINTON),JERSEY,1121,0,1121,1073,0,1073,4.47343874
10/8/2008 11:44,1995,1994,B,Other UK Airports,CITY OF DERRY (EGLINTON),MANCHESTER,17530,17530,0,16409,16409,0,6.831616879
10/8/2008 11:44,1995,1994,B,Other UK Airports,CITY OF DERRY (EGLINTON),NORWICH,90,0,90,0,0,0,
10/8/2008 11:44,1995,1994,B,Other UK Airports,COVENTRY,GLASGOW,2,0,2,0,0,0,
10/8/2008 11:44,1995,1994,B,Other UK Airports,COVENTRY,GLOUCESTERSHIRE,0,0,0,91,91,0,
10/8/2008 11:44,1995,1994,B,Other UK Airports,COVENTRY,GUERNSEY,0,0,0,3,3,0,
10/8/2008 11:44,1995,1994,B,Other UK Airports,COVENTRY,JERSEY,0,0,0,465,465,0,
10/8/2008 11:44,1995,1994,B,Other UK Airports,CUMBERNAULD,JERSEY,0,0,0,45,0,45,
10/8/2008 11:44,1995,1994,B,Other UK Airports,DONCASTER SHEFFIELD,LIVERPOOL,0,0,0,68,0,68,
10/8/2008 11:44,1995,1994,B,Other UK Airports,DUNDEE,INVERNESS,0,0,0,9,9,0,
10/8/2008 11:44,1995,1994,B,Other UK Airports,DUNDEE,MANCHESTER,17,17,0,1,1,0,1600
10/8/2008 11:44,1995,1994,B,Other UK Airports,DURHAM TEES VALLEY,EDINBURGH,0,0,0,38,0,38,
10/8/2008 11:44,1995,1994,B,Other UK Airports,DURHAM TEES VALLEY,EXETER,0,0,0,8,8,0,
10/8/2008 11:44,1995,1994,B,Other UK Airports,DURHAM TEES VALLEY,GLASGOW,76,0,76,99,0,99,-23.23232269
10/8/2008 11:44,1995,1994,B,Other UK Airports,DURHAM TEES VALLEY,HUMBERSIDE,425,425,0,627,627,0,-32.2169075
10/8/2008 11:44,1995,1994,B,Other UK Airports,DURHAM TEES VALLEY,JERSEY,11403,8851,2552,9990,8070,1920,14.14414406
10/8/2008 11:44,1995,1994,B,Other UK Airports,DURHAM TEES VALLEY,LEEDS BRADFORD,200,0,200,69,0,69,189.855072
10/8/2008 11:44,1995,1994,B,Other UK Airports,DURHAM TEES VALLEY,MANCHESTER,112,0,112,78,18,60,43.58974457
10/8/2008 11:44,1995,1994,B,Other UK Airports,DURHAM TEES VALLEY,NEWCASTLE,0,0,0,30,30,0,
10/8/2008 11:44,1995,1994,B,Other UK Airports,DURHAM TEES VALLEY,NORWICH,2108,2108,0,1974,1973,1,6.788247108
10/8/2008 11:44,1995,1994,B,Other UK Airports,DURHAM TEES VALLEY,PLYMOUTH,0,0,0,92,0,92,
10/8/2008 11:44,1995,1994,B,Other UK Airports,DURHAM TEES VALLEY,SOUTHAMPTON,196,0,196,0,0,0,
10/8/2008 11:44,1995,1994,B,Other UK Airports,EAST MIDLANDS INTERNATIONAL,EDINBURGH,68213,67786,427,39659,39517,142,71.99878693
10/8/2008 11:44,1995,1994,B,Other UK Airports,EAST MIDLANDS INTERNATIONAL,GLASGOW,93073,92869,204,84376,84254,122,10.30743313
10/8/2008 11:44,1995,1994,B,Other UK Airports,EAST MIDLANDS INTERNATIONAL,GUERNSEY,18053,17957,96,16847,16712,135,7.15854454
10/8/2008 11:44,1995,1994,B,Other UK Airports,EAST MIDLANDS INTERNATIONAL,INVERNESS,208,0,208,0,0,0,
10/8/2008 11:44,1995,1994,B,Other UK Airports,EAST MIDLANDS INTERNATIONAL,JERSEY,60149,58078,2071,54112,53359,753,11.15649033
10/8/2008 11:44,1995,1994,B,Other UK Airports,EAST MIDLANDS INTERNATIONAL,LEEDS BRADFORD,169,0,169,128,0,128,32.03125
10/8/2008 11:44,1995,1994,B,Other UK Airports,EAST MIDLANDS INTERNATIONAL,LIVERPOOL,4,0,4,0,0,0,
10/8/2008 11:44,1995,1994,B,Other UK Airports,EAST MIDLANDS INTERNATIONAL,MANCHESTER,279,0,279,19,0,19,1368.421021
10/8/2008 11:44,1995,1994,B,Other UK Airports,EAST MIDLANDS INTERNATIONAL,NEWCASTLE,82,0,82,37,0,37,121.6216202
10/8/2008 11:44,1995,1994,B,Other UK Airports,EAST MIDLANDS INTERNATIONAL,SUMBURGH,1270,1270,0,8928,8928,0,-85.77509308
10/8/2008 11:44,1995,1994,B,Other UK Airports,EDAY,KIRKWALL,360,360,0,270,270,0,33.33333206
10/8/2008 11:44,1995,1994,B,Other UK Airports,EDINBURGH,GLASGOW,163,163,0,234,234,0,-30.3418808
10/8/2008 11:44,1995,1994,B,Other UK Airports,EDINBURGH,GUERNSEY,0,0,0,2140,2048,92,
10/8/2008 11:44,1995,1994,B,Other UK Airports,EDINBURGH,HUMBERSIDE,31,0,31,2122,2122,0,-98.53911591
10/8/2008 11:44,1995,1994,B,Other UK Airports,EDINBURGH,INVERNESS,0,0,0,211,40,171,
10/8/2008 11:44,1995,1994,B,Other UK Airports,EDINBURGH,ISLE OF MAN,0,0,0,24,24,0,
10/8/2008 11:44,1995,1994,B,Other UK Airports,EDINBURGH,JERSEY,10970,7028,3942,10814,8062,2752,1.442574382
10/8/2008 11:44,1995,1994,B,Other UK Airports,EDINBURGH,KENT INTERNATIONAL,0,0,0,66,0,66,
10/8/2008 11:44,1995,1994,B,Other UK Airports,EDINBURGH,KIRKWALL,9670,9670,0,6133,6011,122,57.67161179
10/8/2008 11:44,1995,1994,B,Other UK Airports,EDINBURGH,LEEDS BRADFORD,18233,18123,110,18725,18725,0,-2.627503395
10/8/2008 11:44,1995,1994,B,Other UK Airports,EDINBURGH,LIVERPOOL,0,0,0,23,0,23,
10/8/2008 11:44,1995,1994,B,Other UK Airports,EDINBURGH,MANCHESTER,119687,119332,355,100759,100634,125,18.78541946
10/8/2008 11:44,1995,1994,B,Other UK Airports,EDINBURGH,NEWCASTLE,7,0,7,73,73,0,-90.41095734
10/8/2008 11:44,1995,1994,B,Other UK Airports,EDINBURGH,NORWICH,16188,16188,0,15746,15705,41,2.807062149
10/8/2008 11:44,1995,1994,B,Other UK Airports,EDINBURGH,PLYMOUTH,2160,2160,0,11937,11937,0,-81.90499878
10/8/2008 11:44,1995,1994,B,Other UK Airports,EDINBURGH,SOUTHAMPTON,29341,28944,397,23002,22868,134,27.55847359
10/8/2008 11:44,1995,1994,B,Other UK Airports,EDINBURGH,SUMBURGH,20143,20143,0,10462,10462,0,92.53488922
10/8/2008 11:44,1995,1994,B,Other UK Airports,EDINBURGH,UNST,72,0,72,5736,5736,0,-98.74476624
10/8/2008 11:44,1995,1994,B,Other UK Airports,EDINBURGH,WICK,57,57,0,4646,4646,0,-98.77313995
10/8/2008 11:44,1995,1994,B,Other UK Airports,ENNISKILLEN,JERSEY,721,0,721,0,0,0,
10/8/2008 11:44,1995,1994,B,Other UK Airports,EXETER,GLASGOW,182,0,182,0,0,0,
10/8/2008 11:44,1995,1994,B,Other UK Airports,EXETER,GUERNSEY,20939,20939,0,16504,16401,103,26.87227249
10/8/2008 11:44,1995,1994,B,Other UK Airports,EXETER,ISLES OF SCILLY (ST.MARYS),6524,6524,0,6836,6836,0,-4.564072609
10/8/2008 11:44,1995,1994,B,Other UK Airports,EXETER,JERSEY,31385,31385,0,33241,33151,90,-5.583466053
10/8/2008 11:44,1995,1994,B,Other UK Airports,EXETER,MANCHESTER,0,0,0,280,280,0,
10/8/2008 11:44,1995,1994,B,Other UK Airports,EXETER,NORWICH,84,0,84,0,0,0,
10/8/2008 11:44,1995,1994,B,Other UK Airports,EXETER,PLYMOUTH,0,0,0,25,25,0,
10/8/2008 11:44,1995,1994,B,Other UK Airports,FAIR ISLE,KIRKWALL,123,123,0,75,75,0,64
10/8/2008 11:44,1995,1994,B,Other UK Airports,FAIR ISLE,LERWICK (TINGWALL),8,8,0,3,3,0,166.6666718
10/8/2008 11:44,1995,1994,B,Other UK Airports,FAIR ISLE,SUMBURGH,80,80,0,45,45,0,77.77777863
10/8/2008 11:44,1995,1994,B,Other UK Airports,FILTON,JERSEY,0,0,0,24,0,24,
10/8/2008 11:44,1995,1994,B,Other UK Airports,FILTON,LIVERPOOL,130,0,130,93,0,93,39.78494644
10/8/2008 11:44,1995,1994,B,Other UK Airports,GLASGOW,GUERNSEY,2385,2385,0,2662,2662,0,-10.40571022
10/8/2008 11:44,1995,1994,B,Other UK Airports,GLASGOW,HUMBERSIDE,0,0,0,44,0,44,
10/8/2008 11:44,1995,1994,B,Other UK Airports,GLASGOW,INVERNESS,447,447,0,784,585,199,-42.98469543
10/8/2008 11:44,1995,1994,B,Other UK Airports,GLASGOW,ISLAY,16027,16027,0,14470,14470,0,10.76019382
10/8/2008 11:44,1995,1994,B,Other UK Airports,GLASGOW,ISLE OF MAN,18436,18436,0,19818,19818,0,-6.97345829
10/8/2008 11:44,1995,1994,B,Other UK Airports,GLASGOW,JERSEY,29283,24180,5103,31834,24141,7693,-8.013444901
10/8/2008 11:44,1995,1994,B,Other UK Airports,GLASGOW,KINLOSS,38,0,38,0,0,0,
10/8/2008 11:44,1995,1994,B,Other UK Airports,GLASGOW,KIRKWALL,10549,10549,0,22477,22477,0,-53.06758118
10/8/2008 11:44,1995,1994,B,Other UK Airports,GLASGOW,LEEDS BRADFORD,30605,30595,10,28038,28038,0,9.155431747
10/8/2008 11:44,1995,1994,B,Other UK Airports,GLASGOW,MANCHESTER,133489,133209,280,109603,108702,901,21.79319954
10/8/2008 11:44,1995,1994,B,Other UK Airports,GLASGOW,NEWCASTLE,214,0,214,0,0,0,
10/8/2008 11:44,1995,1994,B,Other UK Airports,GLASGOW,PRESTWICK,0,0,0,51,0,51,
10/8/2008 11:44,1995,1994,B,Other UK Airports,GLASGOW,SOUTHAMPTON,27174,27174,0,21599,21599,0,25.81138039
10/8/2008 11:44,1995,1994,B,Other UK Airports,GLASGOW,STORNOWAY,48581,48581,0,50586,50586,0,-3.96354723
10/8/2008 11:44,1995,1994,B,Other UK Airports,GLASGOW,SUMBURGH,19195,19195,0,11733,11733,0,63.5983963
10/8/2008 11:44,1995,1994,B,Other UK Airports,GLASGOW,TIREE,4200,4200,0,1241,1241,0,238.4367371
10/8/2008 11:44,1995,1994,B,Other UK Airports,GLOUCESTERSHIRE,GUERNSEY,0,0,0,22,22,0,
10/8/2008 11:44,1995,1994,B,Other UK Airports,GLOUCESTERSHIRE,JERSEY,1688,0,1688,435,435,0,288.04599
10/8/2008 11:44,1995,1994,B,Other UK Airports,GUERNSEY,JERSEY,189959,189955,4,194019,193801,218,-2.09257865
10/8/2008 11:44,1995,1994,B,Other UK Airports,GUERNSEY,LEEDS BRADFORD,6512,6471,41,3523,3523,0,84.84246063
10/8/2008 11:44,1995,1994,B,Other UK Airports,GUERNSEY,LIVERPOOL,0,0,0,90,0,90,
10/8/2008 11:44,1995,1994,B,Other UK Airports,GUERNSEY,MANCHESTER,34678,33070,1608,30637,28804,1833,13.18993378
10/8/2008 11:44,1995,1994,B,Other UK Airports,GUERNSEY,MARHAM(KINGS LYNN),0,0,0,193,0,193,
10/8/2008 11:44,1995,1994,B,Other UK Airports,GUERNSEY,NEWCASTLE,1079,1079,0,3173,3173,0,-65.99432373
10/8/2008 11:44,1995,1994,B,Other UK Airports,GUERNSEY,NORWICH,1834,1834,0,2125,2125,0,-13.69411755
10/8/2008 11:44,1995,1994,B,Other UK Airports,GUERNSEY,PLYMOUTH,0,0,0,4731,4655,76,
10/8/2008 11:44,1995,1994,B,Other UK Airports,GUERNSEY,SOUTHAMPTON,102428,102428,0,103225,102194,1031,-0.772099793
10/8/2008 11:44,1995,1994,B,Other UK Airports,HAWARDEN,INVERNESS,0,0,0,98,0,98,
10/8/2008 11:44,1995,1994,B,Other UK Airports,HUMBERSIDE,JERSEY,5384,2117,3267,5980,2088,3892,-9.966555595
10/8/2008 11:44,1995,1994,B,Other UK Airports,HUMBERSIDE,LEEDS BRADFORD,26,0,26,0,0,0,
10/8/2008 11:44,1995,1994,B,Other UK Airports,HUMBERSIDE,MANCHESTER,0,0,0,167,0,167,
10/8/2008 11:44,1995,1994,B,Other UK Airports,HUMBERSIDE,NORWICH,358,358,0,684,684,0,-47.66082001
10/8/2008 11:44,1995,1994,B,Other UK Airports,INVERNESS,JERSEY,1335,0,1335,1251,0,1251,6.71462822
10/8/2008 11:44,1995,1994,B,Other UK Airports,INVERNESS,KIRKWALL,4874,4874,0,5411,5411,0,-9.924228668
10/8/2008 11:44,1995,1994,B,Other UK Airports,INVERNESS,MANCHESTER,2600,2544,56,10751,10751,0,-75.81620026
10/8/2008 11:44,1995,1994,B,Other UK Airports,INVERNESS,PRESTWICK,0,0,0,24,0,24,
10/8/2008 11:44,1995,1994,B,Other UK Airports,INVERNESS,SOUTH MARSTON,0,0,0,16,0,16,
10/8/2008 11:44,1995,1994,B,Other UK Airports,INVERNESS,STORNOWAY,32969,32969,0,32034,32034,0,2.91877389
10/8/2008 11:44,1995,1994,B,Other UK Airports,INVERNESS,SUMBURGH,6649,6649,0,2674,2674,0,148.6537018
10/8/2008 11:44,1995,1994,B,Other UK Airports,INVERNESS,WICK,32,32,0,480,480,0,-93.33333588
10/8/2008 11:44,1995,1994,B,Other UK Airports,ISLE OF MAN,JERSEY,5476,5476,0,2316,2316,0,136.4421387
10/8/2008 11:44,1995,1994,B,Other UK Airports,ISLE OF MAN,LEEDS BRADFORD,11650,11650,0,9114,9106,8,27.8253231
10/8/2008 11:44,1995,1994,B,Other UK Airports,ISLE OF MAN,LIVERPOOL,139896,139896,0,131354,131338,16,6.503037453
10/8/2008 11:44,1995,1994,B,Other UK Airports,ISLE OF MAN,MANCHESTER,78462,78155,307,79104,78847,257,-0.811589777
10/8/2008 11:44,1995,1994,B,Other UK Airports,ISLE OF MAN,NEWCASTLE,1100,910,190,1037,848,189,6.07521677
10/8/2008 11:44,1995,1994,B,Other UK Airports,ISLE OF MAN,SOUTHAMPTON,2363,2363,0,1928,1724,204,22.5622406
10/8/2008 11:44,1995,1994,B,Other UK Airports,JERSEY,KENT INTERNATIONAL,1733,0,1733,0,0,0,
10/8/2008 11:44,1995,1994,B,Other UK Airports,JERSEY,LEEDS BRADFORD,26296,24199,2097,18407,16820,1587,42.85869598
10/8/2008 11:44,1995,1994,B,Other UK Airports,JERSEY,LIVERPOOL,8712,3072,5640,7952,3046,4906,9.557344437
10/8/2008 11:44,1995,1994,B,Other UK Airports,JERSEY,MANCHESTER,105230,83944,21286,114560,91553,23007,-8.14420414
10/8/2008 11:44,1995,1994,B,Other UK Airports,JERSEY,NEWCASTLE,14722,4040,10682,25683,13235,12448,-42.67803574
10/8/2008 11:44,1995,1994,B,Other UK Airports,JERSEY,NORWICH,6930,6930,0,6999,6999,0,-0.985855103
10/8/2008 11:44,1995,1994,B,Other UK Airports,JERSEY,PLYMOUTH,3259,3259,0,7812,7812,0,-58.2821312
10/8/2008 11:44,1995,1994,B,Other UK Airports,JERSEY,PRESTWICK,1934,0,1934,2187,0,2187,-11.56835842
10/8/2008 11:44,1995,1994,B,Other UK Airports,JERSEY,SOUTHAMPTON,151679,144976,6703,156189,149414,6775,-2.887527227
10/8/2008 11:44,1995,1994,B,Other UK Airports,KENT INTERNATIONAL,NEWCASTLE,0,0,0,4,0,4,
10/8/2008 11:44,1995,1994,B,Other UK Airports,KIRKWALL,MANCHESTER,0,0,0,1715,1715,0,
10/8/2008 11:44,1995,1994,B,Other UK Airports,KIRKWALL,NORTH RONALDSAY,3593,3593,0,3327,3327,0,7.995191097
10/8/2008 11:44,1995,1994,B,Other UK Airports,KIRKWALL,PAPA WESTRAY,3094,3094,0,3001,3001,0,3.098967075
10/8/2008 11:44,1995,1994,B,Other UK Airports,KIRKWALL,SANDAY,2620,2620,0,2238,2238,0,17.06881142
10/8/2008 11:44,1995,1994,B,Other UK Airports,KIRKWALL,STRONSAY,2131,2131,0,2781,2781,0,-23.37288666
10/8/2008 11:44,1995,1994,B,Other UK Airports,KIRKWALL,SUMBURGH,9207,9143,64,10259,10252,7,-10.25441074
10/8/2008 11:44,1995,1994,B,Other UK Airports,KIRKWALL,WESTRAY,2482,2482,0,2873,2873,0,-13.60946751
10/8/2008 11:44,1995,1994,B,Other UK Airports,KIRKWALL,WICK,3585,3585,0,9691,9691,0,-63.00691223
10/8/2008 11:44,1995,1994,B,Other UK Airports,LEEDS BRADFORD,MANCHESTER,0,0,0,71,0,71,
10/8/2008 11:44,1995,1994,B,Other UK Airports,LEEDS BRADFORD,NEWCASTLE,0,0,0,398,0,398,
10/8/2008 11:44,1995,1994,B,Other UK Airports,LEEDS BRADFORD,NORWICH,259,0,259,21,21,0,1133.333374
10/8/2008 11:44,1995,1994,B,Other UK Airports,LEEDS BRADFORD,SOUTHAMPTON,6772,6747,25,2080,2080,0,225.5769196
10/8/2008 11:44,1995,1994,B,Other UK Airports,LIVERPOOL,MANCHESTER,42,0,42,63,0,63,-33.33333206
10/8/2008 11:44,1995,1994,B,Other UK Airports,LIVERPOOL,NEWCASTLE,426,0,426,0,0,0,
10/8/2008 11:44,1995,1994,B,Other UK Airports,LIVERPOOL,NORWICH,102,0,102,296,0,296,-65.5405426
10/8/2008 11:44,1995,1994,B,Other UK Airports,LIVERPOOL,PRESTWICK,178,0,178,0,0,0,
10/8/2008 11:44,1995,1994,B,Other UK Airports,LIVERPOOL,SOUTHAMPTON,0,0,0,68,0,68,
10/8/2008 11:44,1995,1994,B,Other UK Airports,LLANBEDR,SUMBURGH,0,0,0,55,0,55,
10/8/2008 11:44,1995,1994,B,Other UK Airports,MANCHESTER,NEWCASTLE,15186,15082,104,15791,15791,0,-3.831296206
10/8/2008 11:44,1995,1994,B,Other UK Airports,MANCHESTER,NORWICH,739,0,739,140,0,140,427.8571472
10/8/2008 11:44,1995,1994,B,Other UK Airports,MANCHESTER,PRESTWICK,170,0,170,0,0,0,
10/8/2008 11:44,1995,1994,B,Other UK Airports,MANCHESTER,SOUTHAMPTON,32471,32009,462,23400,23307,93,38.76495743
10/8/2008 11:44,1995,1994,B,Other UK Airports,MANCHESTER,SUMBURGH,28417,28417,0,35277,35277,0,-19.44609833
10/8/2008 11:44,1995,1994,B,Other UK Airports,NEWCASTLE,NORTHOLT,24,0,24,0,0,0,
10/8/2008 11:44,1995,1994,B,Other UK Airports,NEWCASTLE,NORWICH,1,1,0,87,0,87,-98.85057831
10/8/2008 11:44,1995,1994,B,Other UK Airports,NEWCASTLE,SOUTHAMPTON,11150,10996,154,2327,2327,0,379.1577148
10/8/2008 11:44,1995,1994,B,Other UK Airports,NEWCASTLE,WICK,17265,17265,0,1581,1581,0,992.0303345
10/8/2008 11:44,1995,1994,B,Other UK Airports,NORWICH,PLYMOUTH,0,0,0,92,0,92,
10/8/2008 11:44,1995,1994,B,Other UK Airports,SOUTH MARSTON,WICK,53,0,53,0,0,0,
10/8/2008 11:44,1995,1994,B,Other UK Airports,SUMBURGH,SUMBURGH,0,0,0,171,0,171,
10/8/2008 11:44,1995,1994,B,Other UK Airports,SUMBURGH,UNST,1748,1748,0,1928,1912,16,-9.336099625
10/8/2008 11:44,1995,1994,B,Other UK Airports,SUMBURGH,WICK,0,0,0,1454,1454,0,
10/8/2008 11:44,1995,1994,B,Other UK Airports,UNST,WICK,1,1,0,809,809,0,-99.87638855
