rundate,this_period,last_period,grp_cd,grp_name,apt1_apt_name,apt2_apt_name,total_pax_tp,total_pax_shd_tp,total_pax_cht_tp,total_pax_lp,total_pax_shd_lp,total_pax_cht_lp,total_pax_pc
08/03/2010 14:19,2009,2008,A,London Area Airports,GATWICK,ABERDEEN,135545,135543,2,147978,147944,34,-8.401925087
08/03/2010 14:19,2009,2008,A,London Area Airports,GATWICK,BELFAST CITY (GEORGE BEST),215485,215485,0,189398,189398,0,13.77364063
08/03/2010 14:19,2009,2008,A,London Area Airports,GATWICK,BELFAST INTERNATIONAL,309976,309922,54,347377,347377,0,-10.76668835
08/03/2010 14:19,2009,2008,A,London Area Airports,GATWICK,BIRMINGHAM,1,0,1,0,0,0,
08/03/2010 14:19,2009,2008,A,London Area Airports,GATWICK,BLACKPOOL,36,0,36,33,0,33,9.090909004
08/03/2010 14:19,2009,2008,A,London Area Airports,GATWICK,CARDIFF WALES,219,0,219,116,0,116,88.79310608
08/03/2010 14:19,2009,2008,A,London Area Airports,GATWICK,DONCASTER SHEFFIELD,40,0,40,49,0,49,-18.36734772
08/03/2010 14:19,2009,2008,A,London Area Airports,GATWICK,DURHAM TEES VALLEY,84,0,84,58,0,58,44.82758713
08/03/2010 14:19,2009,2008,A,London Area Airports,GATWICK,EAST MIDLANDS INTERNATIONAL,0,0,0,49,0,49,
08/03/2010 14:19,2009,2008,A,London Area Airports,GATWICK,EDINBURGH,647908,647908,0,704906,704891,15,-8.08590126
08/03/2010 14:19,2009,2008,A,London Area Airports,GATWICK,GLASGOW,514660,514660,0,521878,521878,0,-1.383081913
08/03/2010 14:19,2009,2008,A,London Area Airports,GATWICK,GUERNSEY,341656,341656,0,338720,338720,0,0.866792619
08/03/2010 14:19,2009,2008,A,London Area Airports,GATWICK,HUMBERSIDE,0,0,0,41,0,41,
08/03/2010 14:19,2009,2008,A,London Area Airports,GATWICK,INVERNESS,224872,224792,80,243168,242645,523,-7.52401638
08/03/2010 14:19,2009,2008,A,London Area Airports,GATWICK,ISLE OF MAN,126462,126348,114,147409,147324,85,-14.21012306
08/03/2010 14:19,2009,2008,A,London Area Airports,GATWICK,JERSEY,555971,555906,65,517899,517899,0,7.351240158
08/03/2010 14:19,2009,2008,A,London Area Airports,GATWICK,LEEDS BRADFORD,30431,30431,0,262,0,262,11514.88574
08/03/2010 14:19,2009,2008,A,London Area Airports,GATWICK,LIVERPOOL,40,0,40,213,0,213,-81.22065735
08/03/2010 14:19,2009,2008,A,London Area Airports,GATWICK,MANCHESTER,288191,287665,526,344031,343000,1031,-16.23109627
08/03/2010 14:19,2009,2008,A,London Area Airports,GATWICK,NEWCASTLE,110583,110429,154,101400,101212,188,9.056213379
08/03/2010 14:19,2009,2008,A,London Area Airports,GATWICK,NEWQUAY,100918,100918,0,63435,63435,0,59.08883286
08/03/2010 14:19,2009,2008,A,London Area Airports,GATWICK,PLYMOUTH,57516,57516,0,60546,60546,0,-5.004459381
08/03/2010 14:19,2009,2008,A,London Area Airports,HEATHROW,ABERDEEN,641294,641294,0,656034,656034,0,-2.246834755
08/03/2010 14:19,2009,2008,A,London Area Airports,HEATHROW,BELFAST CITY (GEORGE BEST),522676,522676,0,521913,521913,0,0.146192953
08/03/2010 14:19,2009,2008,A,London Area Airports,HEATHROW,BELFAST INTERNATIONAL,266819,266819,0,258033,258033,0,3.404990911
08/03/2010 14:19,2009,2008,A,London Area Airports,HEATHROW,CITY OF DERRY (EGLINTON),262,0,262,0,0,0,
08/03/2010 14:19,2009,2008,A,London Area Airports,HEATHROW,DURHAM TEES VALLEY,13852,13852,0,81407,81407,0,-82.98426056
08/03/2010 14:19,2009,2008,A,London Area Airports,HEATHROW,EDINBURGH,1306065,1305830,235,1318962,1318962,0,-0.977814376
08/03/2010 14:19,2009,2008,A,London Area Airports,HEATHROW,GLASGOW,1079970,1079970,0,1143533,1143426,107,-5.558475494
08/03/2010 14:19,2009,2008,A,London Area Airports,HEATHROW,INVERNESS,0,0,0,7899,7899,0,
08/03/2010 14:19,2009,2008,A,London Area Airports,HEATHROW,JERSEY,18519,18519,0,76679,76679,0,-75.84867096
08/03/2010 14:19,2009,2008,A,London Area Airports,HEATHROW,LEEDS BRADFORD,21160,21160,0,126069,126069,0,-83.21553802
08/03/2010 14:19,2009,2008,A,London Area Airports,HEATHROW,LIVERPOOL,368,0,368,97,0,97,279.3814392
08/03/2010 14:19,2009,2008,A,London Area Airports,HEATHROW,MANCHESTER,908723,908723,0,910101,910009,92,-0.151411772
08/03/2010 14:19,2009,2008,A,London Area Airports,HEATHROW,NEWCASTLE,475432,475432,0,462615,462615,0,2.770554304
08/03/2010 14:19,2009,2008,A,London Area Airports,HEATHROW,PRESTWICK,0,0,0,118,0,118,
08/03/2010 14:19,2009,2008,A,London Area Airports,LONDON CITY,BELFAST CITY (GEORGE BEST),0,0,0,6692,6692,0,
08/03/2010 14:19,2009,2008,A,London Area Airports,LONDON CITY,DUNDEE,41297,41297,0,40089,40089,0,3.013295412
08/03/2010 14:19,2009,2008,A,London Area Airports,LONDON CITY,EDINBURGH,326553,326553,0,371507,371507,0,-12.10044479
08/03/2010 14:19,2009,2008,A,London Area Airports,LONDON CITY,GLASGOW,114920,114920,0,112736,112736,0,1.93726933
08/03/2010 14:19,2009,2008,A,London Area Airports,LONDON CITY,GUERNSEY,5,0,5,0,0,0,
08/03/2010 14:19,2009,2008,A,London Area Airports,LONDON CITY,ISLE OF MAN,60521,60521,0,29147,29147,0,107.6405792
08/03/2010 14:19,2009,2008,A,London Area Airports,LONDON CITY,JERSEY,9512,9512,0,12132,12132,0,-21.59577942
08/03/2010 14:19,2009,2008,A,London Area Airports,LONDON CITY,LIVERPOOL,31,0,31,0,0,0,
08/03/2010 14:19,2009,2008,A,London Area Airports,LONDON CITY,MANCHESTER,21913,21913,0,89417,89417,0,-75.49347687
08/03/2010 14:19,2009,2008,A,London Area Airports,LONDON CITY,NEWCASTLE,28,0,28,0,0,0,
08/03/2010 14:19,2009,2008,A,London Area Airports,LONDON CITY,NEWQUAY,18680,18680,0,0,0,0,
08/03/2010 14:19,2009,2008,A,London Area Airports,LUTON,ABERDEEN,126877,126716,161,139404,139404,0,-8.986112595
08/03/2010 14:19,2009,2008,A,London Area Airports,LUTON,BELFAST CITY (GEORGE BEST),0,0,0,49,0,49,
08/03/2010 14:19,2009,2008,A,London Area Airports,LUTON,BELFAST INTERNATIONAL,246905,246894,11,263238,263121,117,-6.204651356
08/03/2010 14:19,2009,2008,A,London Area Airports,LUTON,BIRMINGHAM,19,19,0,0,0,0,
08/03/2010 14:19,2009,2008,A,London Area Airports,LUTON,BLACKPOOL,68,0,68,134,0,134,-49.25373077
08/03/2010 14:19,2009,2008,A,London Area Airports,LUTON,BOURNEMOUTH,0,0,0,34,0,34,
08/03/2010 14:19,2009,2008,A,London Area Airports,LUTON,CAMBRIDGE,0,0,0,22,0,22,
08/03/2010 14:19,2009,2008,A,London Area Airports,LUTON,CARDIFF WALES,96,0,96,0,0,0,
08/03/2010 14:19,2009,2008,A,London Area Airports,LUTON,CITY OF DERRY (EGLINTON),33388,33388,0,5641,5641,0,491.8808594
08/03/2010 14:19,2009,2008,A,London Area Airports,LUTON,DONCASTER SHEFFIELD,86,0,86,0,0,0,
08/03/2010 14:19,2009,2008,A,London Area Airports,LUTON,DURHAM TEES VALLEY,60,0,60,55,0,55,9.090909004
08/03/2010 14:19,2009,2008,A,London Area Airports,LUTON,EDINBURGH,315623,315383,240,359543,359497,46,-12.21550655
08/03/2010 14:19,2009,2008,A,London Area Airports,LUTON,FARNBOROUGH,0,0,0,2,0,2,
08/03/2010 14:19,2009,2008,A,London Area Airports,LUTON,GLASGOW,326033,325324,709,352448,352429,19,-7.494722843
08/03/2010 14:19,2009,2008,A,London Area Airports,LUTON,HUMBERSIDE,59,0,59,0,0,0,
08/03/2010 14:19,2009,2008,A,London Area Airports,LUTON,INVERNESS,86604,86604,0,102526,102495,31,-15.52971935
08/03/2010 14:19,2009,2008,A,London Area Airports,LUTON,ISLE OF MAN,27322,27178,144,38055,38055,0,-28.20391464
08/03/2010 14:19,2009,2008,A,London Area Airports,LUTON,JERSEY,13088,13088,0,55221,54698,523,-76.2988739
08/03/2010 14:19,2009,2008,A,London Area Airports,LUTON,LIVERPOOL,332,0,332,339,0,339,-2.064896822
08/03/2010 14:19,2009,2008,A,London Area Airports,LUTON,MANCHESTER,582,0,582,672,0,672,-13.39285755
08/03/2010 14:19,2009,2008,A,London Area Airports,LUTON,NEWCASTLE,68,0,68,491,0,491,-86.15071106
08/03/2010 14:19,2009,2008,A,London Area Airports,LUTON,NEWQUAY,113,0,113,196,0,196,-42.34693909
08/03/2010 14:19,2009,2008,A,London Area Airports,LUTON,PLYMOUTH,60,0,60,0,0,0,
08/03/2010 14:19,2009,2008,A,London Area Airports,LUTON,STANSTED,238,238,0,0,0,0,
08/03/2010 14:19,2009,2008,A,London Area Airports,LUTON,STORNOWAY,0,0,0,64,0,64,
08/03/2010 14:19,2009,2008,A,London Area Airports,SOUTHEND,CARDIFF WALES,0,0,0,143,0,143,
08/03/2010 14:19,2009,2008,A,London Area Airports,SOUTHEND,DURHAM TEES VALLEY,0,0,0,54,0,54,
08/03/2010 14:19,2009,2008,A,London Area Airports,SOUTHEND,JERSEY,2448,2448,0,2775,2775,0,-11.78378391
08/03/2010 14:19,2009,2008,A,London Area Airports,STANSTED,BELFAST CITY (GEORGE BEST),328619,328619,0,340303,340303,0,-3.433410883
08/03/2010 14:19,2009,2008,A,London Area Airports,STANSTED,BELFAST INTERNATIONAL,293077,293077,0,313111,313099,12,-6.398369789
08/03/2010 14:19,2009,2008,A,London Area Airports,STANSTED,BLACKPOOL,0,0,0,71,0,71,
08/03/2010 14:19,2009,2008,A,London Area Airports,STANSTED,BRISTOL,3,0,3,0,0,0,
08/03/2010 14:19,2009,2008,A,London Area Airports,STANSTED,CITY OF DERRY (EGLINTON),79891,79891,0,146779,146779,0,-45.57055283
08/03/2010 14:19,2009,2008,A,London Area Airports,STANSTED,DUNDEE,0,0,0,4,0,4,
08/03/2010 14:19,2009,2008,A,London Area Airports,STANSTED,DURHAM TEES VALLEY,70,0,70,74,0,74,-5.405405521
08/03/2010 14:19,2009,2008,A,London Area Airports,STANSTED,EAST MIDLANDS INTERNATIONAL,179,112,67,0,0,0,
08/03/2010 14:19,2009,2008,A,London Area Airports,STANSTED,EDINBURGH,373714,373590,124,401902,401797,105,-7.01364994
08/03/2010 14:19,2009,2008,A,London Area Airports,STANSTED,GLASGOW,305052,305052,0,358634,358634,0,-14.94058037
08/03/2010 14:19,2009,2008,A,London Area Airports,STANSTED,GUERNSEY,27276,27276,0,31496,31496,0,-13.39852715
08/03/2010 14:19,2009,2008,A,London Area Airports,STANSTED,HUMBERSIDE,0,0,0,74,0,74,
08/03/2010 14:19,2009,2008,A,London Area Airports,STANSTED,JERSEY,20650,20650,0,1283,0,1283,1509.508911
08/03/2010 14:19,2009,2008,A,London Area Airports,STANSTED,KENT INTERNATIONAL,4,0,4,0,0,0,
08/03/2010 14:19,2009,2008,A,London Area Airports,STANSTED,LEEDS BRADFORD,0,0,0,5,0,5,
08/03/2010 14:19,2009,2008,A,London Area Airports,STANSTED,LIVERPOOL,425,0,425,349,0,349,21.77650452
08/03/2010 14:19,2009,2008,A,London Area Airports,STANSTED,MANCHESTER,467,0,467,15275,14977,298,-96.94271851
08/03/2010 14:19,2009,2008,A,London Area Airports,STANSTED,NEWCASTLE,140979,140975,4,200126,199914,212,-29.55488014
08/03/2010 14:19,2009,2008,A,London Area Airports,STANSTED,NEWQUAY,45967,45967,0,126840,126840,0,-63.75985336
08/03/2010 14:19,2009,2008,A,London Area Airports,STANSTED,PRESTWICK,278284,278284,0,402729,402729,0,-30.90043259
08/03/2010 14:19,2009,2008,A,London Area Airports,STANSTED,SUMBURGH,0,0,0,2108,2108,0,
08/03/2010 14:19,2009,2008,B,Other Reporting Airports,ABERDEEN,BELFAST CITY (GEORGE BEST),24237,24237,0,25365,25365,0,-4.447072506
08/03/2010 14:19,2009,2008,B,Other Reporting Airports,ABERDEEN,BIRMINGHAM,111134,111084,50,146455,146455,0,-24.11730576
08/03/2010 14:19,2009,2008,B,Other Reporting Airports,ABERDEEN,BRISTOL,23229,23229,0,26876,26876,0,-13.5697279
08/03/2010 14:19,2009,2008,B,Other Reporting Airports,ABERDEEN,CARDIFF WALES,6937,6937,0,0,0,0,
08/03/2010 14:19,2009,2008,B,Other Reporting Airports,ABERDEEN,DUNDEE,39,0,39,0,0,0,
08/03/2010 14:19,2009,2008,B,Other Reporting Airports,ABERDEEN,DURHAM TEES VALLEY,31949,31949,0,33161,33161,0,-3.654895782
08/03/2010 14:19,2009,2008,B,Other Reporting Airports,ABERDEEN,EAST MIDLANDS INTERNATIONAL,19455,19417,38,20760,20760,0,-6.28612709
08/03/2010 14:19,2009,2008,B,Other Reporting Airports,ABERDEEN,EXETER,28127,28127,0,17623,17623,0,59.60392761
08/03/2010 14:19,2009,2008,B,Other Reporting Airports,ABERDEEN,FARNBOROUGH,0,0,0,1,0,1,
08/03/2010 14:19,2009,2008,B,Other Reporting Airports,ABERDEEN,GLASGOW,0,0,0,134,0,134,
08/03/2010 14:19,2009,2008,B,Other Reporting Airports,ABERDEEN,HUMBERSIDE,31993,31913,80,33689,33689,0,-5.034284115
08/03/2010 14:19,2009,2008,B,Other Reporting Airports,ABERDEEN,INVERNESS,40,0,40,0,0,0,
08/03/2010 14:19,2009,2008,B,Other Reporting Airports,ABERDEEN,JERSEY,2024,2024,0,2367,2367,0,-14.49091721
08/03/2010 14:19,2009,2008,B,Other Reporting Airports,ABERDEEN,KIRKWALL,39518,39482,36,44363,44177,186,-10.92126274
08/03/2010 14:19,2009,2008,B,Other Reporting Airports,ABERDEEN,LEEDS BRADFORD,15481,15481,0,21560,21560,0,-28.19573212
08/03/2010 14:19,2009,2008,B,Other Reporting Airports,ABERDEEN,MANCHESTER,104620,101985,2635,132341,130845,1496,-20.94664574
08/03/2010 14:19,2009,2008,B,Other Reporting Airports,ABERDEEN,NEWCASTLE,18451,18451,0,22388,22388,0,-17.5853138
08/03/2010 14:19,2009,2008,B,Other Reporting Airports,ABERDEEN,NORWICH,60852,60852,0,65777,65777,0,-7.487419605
08/03/2010 14:19,2009,2008,B,Other Reporting Airports,ABERDEEN,PRESTWICK,98,0,98,0,0,0,
08/03/2010 14:19,2009,2008,B,Other Reporting Airports,ABERDEEN,SCATSTA,145094,0,145094,130769,0,130769,10.95443153
08/03/2010 14:19,2009,2008,B,Other Reporting Airports,ABERDEEN,SOUTHAMPTON,45174,45160,14,55480,55480,0,-18.57606316
08/03/2010 14:19,2009,2008,B,Other Reporting Airports,ABERDEEN,STORNOWAY,6350,6350,0,7113,7113,0,-10.72683811
08/03/2010 14:19,2009,2008,B,Other Reporting Airports,ABERDEEN,SUMBURGH,63831,61605,2226,74913,68357,6556,-14.79316044
08/03/2010 14:19,2009,2008,B,Other Reporting Airports,ABERDEEN,WICK,14497,14497,0,16594,16539,55,-12.63709736
08/03/2010 14:19,2009,2008,B,Other Reporting Airports,ALDERNEY,BOURNEMOUTH,767,767,0,4630,4630,0,-83.43412781
08/03/2010 14:19,2009,2008,B,Other Reporting Airports,ALDERNEY,GUERNSEY,44510,44510,0,41909,41909,0,6.206304073
08/03/2010 14:19,2009,2008,B,Other Reporting Airports,ALDERNEY,JERSEY,444,444,0,843,843,0,-47.33095932
08/03/2010 14:19,2009,2008,B,Other Reporting Airports,ALDERNEY,SHOREHAM,0,0,0,106,106,0,
08/03/2010 14:19,2009,2008,B,Other Reporting Airports,ALDERNEY,SOUTHAMPTON,29114,29114,0,29651,29651,0,-1.811068773
08/03/2010 14:19,2009,2008,B,Other Reporting Airports,ANGLESEY (VALLEY),CARDIFF WALES,11846,11846,0,13471,13471,0,-12.06295013
08/03/2010 14:19,2009,2008,B,Other Reporting Airports,BARRA,BENBECULA,1529,1529,0,1656,1656,0,-7.669082165
08/03/2010 14:19,2009,2008,B,Other Reporting Airports,BARRA,GLASGOW,8703,8703,0,9066,9066,0,-4.0039711
08/03/2010 14:19,2009,2008,B,Other Reporting Airports,BARROW-IN-FURNESS,CARDIFF WALES,32,0,32,0,0,0,
08/03/2010 14:19,2009,2008,B,Other Reporting Airports,BELFAST CITY (GEORGE BEST),BIRMINGHAM,195383,195335,48,213847,213847,0,-8.634210587
08/03/2010 14:19,2009,2008,B,Other Reporting Airports,BELFAST CITY (GEORGE BEST),BLACKPOOL,7943,7943,0,0,0,0,
08/03/2010 14:19,2009,2008,B,Other Reporting Airports,BELFAST CITY (GEORGE BEST),BRISTOL,79014,79014,0,0,0,0,
08/03/2010 14:19,2009,2008,B,Other Reporting Airports,BELFAST CITY (GEORGE BEST),CARDIFF WALES,32754,32754,0,40673,40673,0,-19.4699192
08/03/2010 14:19,2009,2008,B,Other Reporting Airports,BELFAST CITY (GEORGE BEST),DONCASTER SHEFFIELD,23184,23184,0,31702,31702,0,-26.86896706
08/03/2010 14:19,2009,2008,B,Other Reporting Airports,BELFAST CITY (GEORGE BEST),DUNDEE,10397,10397,0,5902,5902,0,76.16062164
08/03/2010 14:19,2009,2008,B,Other Reporting Airports,BELFAST CITY (GEORGE BEST),EAST MIDLANDS INTERNATIONAL,162271,162271,0,128764,128764,0,26.02202415
08/03/2010 14:19,2009,2008,B,Other Reporting Airports,BELFAST CITY (GEORGE BEST),EDINBURGH,119386,119386,0,126539,126539,0,-5.652802467
08/03/2010 14:19,2009,2008,B,Other Reporting Airports,BELFAST CITY (GEORGE BEST),EXETER,22606,22606,0,30196,30196,0,-25.13578033
08/03/2010 14:19,2009,2008,B,Other Reporting Airports,BELFAST CITY (GEORGE BEST),GLASGOW,100055,100055,0,104553,104553,0,-4.3021245
08/03/2010 14:19,2009,2008,B,Other Reporting Airports,BELFAST CITY (GEORGE BEST),INVERNESS,19320,19320,0,22618,22618,0,-14.58130646
08/03/2010 14:19,2009,2008,B,Other Reporting Airports,BELFAST CITY (GEORGE BEST),ISLE OF MAN,17662,17662,0,27351,27351,0,-35.42466354
08/03/2010 14:19,2009,2008,B,Other Reporting Airports,BELFAST CITY (GEORGE BEST),JERSEY,1680,1680,0,5192,5192,0,-67.64252472
08/03/2010 14:19,2009,2008,B,Other Reporting Airports,BELFAST CITY (GEORGE BEST),KENT INTERNATIONAL,962,0,962,0,0,0,
08/03/2010 14:19,2009,2008,B,Other Reporting Airports,BELFAST CITY (GEORGE BEST),LEEDS BRADFORD,78332,78332,0,76101,76051,50,2.931630373
08/03/2010 14:19,2009,2008,B,Other Reporting Airports,BELFAST CITY (GEORGE BEST),LIVERPOOL,158172,158172,0,155876,155876,0,1.472965717
08/03/2010 14:19,2009,2008,B,Other Reporting Airports,BELFAST CITY (GEORGE BEST),MANCHESTER,229875,229875,0,235998,235998,0,-2.594513416
08/03/2010 14:19,2009,2008,B,Other Reporting Airports,BELFAST CITY (GEORGE BEST),NEWCASTLE,41878,41878,0,40449,40449,0,3.532843828
08/03/2010 14:19,2009,2008,B,Other Reporting Airports,BELFAST CITY (GEORGE BEST),NEWQUAY,0,0,0,2615,2615,0,
08/03/2010 14:19,2009,2008,B,Other Reporting Airports,BELFAST CITY (GEORGE BEST),PRESTWICK,91672,91672,0,86330,86330,0,6.187883854
08/03/2010 14:19,2009,2008,B,Other Reporting Airports,BELFAST CITY (GEORGE BEST),SOUTHAMPTON,84051,84051,0,86399,86399,0,-2.717623949
08/03/2010 14:19,2009,2008,B,Other Reporting Airports,BELFAST INTERNATIONAL,BIGGIN HILL,0,0,0,16,0,16,
08/03/2010 14:19,2009,2008,B,Other Reporting Airports,BELFAST INTERNATIONAL,BIRMINGHAM,130139,130054,85,155920,155860,60,-16.53476143
08/03/2010 14:19,2009,2008,B,Other Reporting Airports,BELFAST INTERNATIONAL,BLACKPOOL,26865,26865,0,42897,42601,296,-37.37324142
08/03/2010 14:19,2009,2008,B,Other Reporting Airports,BELFAST INTERNATIONAL,BRISTOL,163459,163459,0,211923,211923,0,-22.86868286
08/03/2010 14:19,2009,2008,B,Other Reporting Airports,BELFAST INTERNATIONAL,CARDIFF WALES,49806,49767,39,52283,52142,141,-4.737677574
08/03/2010 14:19,2009,2008,B,Other Reporting Airports,BELFAST INTERNATIONAL,EAST MIDLANDS INTERNATIONAL,94151,94151,0,121562,121562,0,-22.54898643
08/03/2010 14:19,2009,2008,B,Other Reporting Airports,BELFAST INTERNATIONAL,EDINBURGH,232121,232121,0,236927,236884,43,-2.0284729
08/03/2010 14:19,2009,2008,B,Other Reporting Airports,BELFAST INTERNATIONAL,GLASGOW,223844,223844,0,219623,219587,36,1.921929836
08/03/2010 14:19,2009,2008,B,Other Reporting Airports,BELFAST INTERNATIONAL,ISLE OF MAN,10570,10570,0,11634,11634,0,-9.145607948
08/03/2010 14:19,2009,2008,B,Other Reporting Airports,BELFAST INTERNATIONAL,JERSEY,9213,9213,0,341,0,341,2601.759521
08/03/2010 14:19,2009,2008,B,Other Reporting Airports,BELFAST INTERNATIONAL,LEEDS BRADFORD,87838,87838,0,104765,104765,0,-16.15711403
08/03/2010 14:19,2009,2008,B,Other Reporting Airports,BELFAST INTERNATIONAL,LIVERPOOL,397052,397052,0,394569,394524,45,0.629294217
08/03/2010 14:19,2009,2008,B,Other Reporting Airports,BELFAST INTERNATIONAL,MANCHESTER,121335,120960,375,156002,155450,552,-22.2221508
08/03/2010 14:19,2009,2008,B,Other Reporting Airports,BELFAST INTERNATIONAL,NEWCASTLE,192673,192593,80,205180,205143,37,-6.095623493
08/03/2010 14:19,2009,2008,B,Other Reporting Airports,BELFAST INTERNATIONAL,NEWQUAY,5013,5013,0,0,0,0,
08/03/2010 14:19,2009,2008,B,Other Reporting Airports,BENBECULA,GLASGOW,24703,24703,0,25201,25201,0,-1.976112008
08/03/2010 14:19,2009,2008,B,Other Reporting Airports,BENBECULA,INVERNESS,0,0,0,18,18,0,
08/03/2010 14:19,2009,2008,B,Other Reporting Airports,BENBECULA,STORNOWAY,6987,6987,0,7330,7330,0,-4.67939949
08/03/2010 14:19,2009,2008,B,Other Reporting Airports,BIGGIN HILL,GUERNSEY,18,0,18,35,0,35,-48.57143021
08/03/2010 14:19,2009,2008,B,Other Reporting Airports,BIGGIN HILL,LEEDS BRADFORD,0,0,0,20,0,20,
08/03/2010 14:19,2009,2008,B,Other Reporting Airports,BIGGIN HILL,MANCHESTER,0,0,0,18,0,18,
08/03/2010 14:19,2009,2008,B,Other Reporting Airports,BIGGIN HILL,NEWCASTLE,64,0,64,0,0,0,
08/03/2010 14:19,2009,2008,B,Other Reporting Airports,BIGGIN HILL,WICK,101,0,101,0,0,0,
08/03/2010 14:19,2009,2008,B,Other Reporting Airports,BIRMINGHAM,CARDIFF WALES,0,0,0,38,0,38,
08/03/2010 14:19,2009,2008,B,Other Reporting Airports,BIRMINGHAM,CITY OF DERRY (EGLINTON),67830,67830,0,12979,12979,0,422.6134644
08/03/2010 14:19,2009,2008,B,Other Reporting Airports,BIRMINGHAM,DUNDEE,19067,19067,0,13029,13029,0,46.34277344
08/03/2010 14:19,2009,2008,B,Other Reporting Airports,BIRMINGHAM,EDINBURGH,336150,335999,151,401147,401106,41,-16.20278931
08/03/2010 14:19,2009,2008,B,Other Reporting Airports,BIRMINGHAM,GLASGOW,269411,269371,40,337132,336958,174,-20.08738327
08/03/2010 14:19,2009,2008,B,Other Reporting Airports,BIRMINGHAM,GUERNSEY,32413,32139,274,30388,30320,68,6.663814545
08/03/2010 14:19,2009,2008,B,Other Reporting Airports,BIRMINGHAM,INVERNESS,30348,30130,218,24947,24947,0,21.64989853
08/03/2010 14:19,2009,2008,B,Other Reporting Airports,BIRMINGHAM,ISLE OF MAN,46932,46932,0,49456,49456,0,-5.103526592
08/03/2010 14:19,2009,2008,B,Other Reporting Airports,BIRMINGHAM,JERSEY,58801,58801,0,60329,60329,0,-2.532778502
08/03/2010 14:19,2009,2008,B,Other Reporting Airports,BIRMINGHAM,MANCHESTER,0,0,0,78,0,78,
08/03/2010 14:19,2009,2008,B,Other Reporting Airports,BIRMINGHAM,NEWCASTLE,16206,16176,30,22551,22488,63,-28.13622475
08/03/2010 14:19,2009,2008,B,Other Reporting Airports,BIRMINGHAM,NEWQUAY,7924,7924,0,6829,6829,0,16.03455925
08/03/2010 14:19,2009,2008,B,Other Reporting Airports,BIRMINGHAM,PRESTWICK,0,0,0,26,0,26,
08/03/2010 14:19,2009,2008,B,Other Reporting Airports,BIRMINGHAM,WICK,0,0,0,216,0,216,
08/03/2010 14:19,2009,2008,B,Other Reporting Airports,BLACKPOOL,CARDIFF WALES,53,0,53,29,0,29,82.75862122
08/03/2010 14:19,2009,2008,B,Other Reporting Airports,BLACKPOOL,CITY OF DERRY (EGLINTON),200,0,200,0,0,0,
08/03/2010 14:19,2009,2008,B,Other Reporting Airports,BLACKPOOL,ISLE OF MAN,29673,29530,143,22560,22560,0,31.52925491
08/03/2010 14:19,2009,2008,B,Other Reporting Airports,BLACKPOOL,NORWICH,0,0,0,61,0,61,
08/03/2010 14:19,2009,2008,B,Other Reporting Airports,BLACKPOOL,PLYMOUTH,0,0,0,93,0,93,
08/03/2010 14:19,2009,2008,B,Other Reporting Airports,BLACKPOOL,SOUTH MARSTON,40,0,40,144,0,144,-72.22222137
08/03/2010 14:19,2009,2008,B,Other Reporting Airports,BLACKPOOL,SOUTHAMPTON,112,0,112,117,0,117,-4.273504257
08/03/2010 14:19,2009,2008,B,Other Reporting Airports,BOURNEMOUTH,EAST MIDLANDS INTERNATIONAL,61,0,61,0,0,0,
08/03/2010 14:19,2009,2008,B,Other Reporting Airports,BOURNEMOUTH,EDINBURGH,88376,88376,0,19317,19317,0,357.5037537
08/03/2010 14:19,2009,2008,B,Other Reporting Airports,BOURNEMOUTH,GLASGOW,134,0,134,0,0,0,
08/03/2010 14:19,2009,2008,B,Other Reporting Airports,BOURNEMOUTH,GUERNSEY,0,0,0,85,85,0,
08/03/2010 14:19,2009,2008,B,Other Reporting Airports,BOURNEMOUTH,ISLE OF MAN,0,0,0,248,0,248,
08/03/2010 14:19,2009,2008,B,Other Reporting Airports,BOURNEMOUTH,JERSEY,769,766,3,5869,4305,1564,-86.89725494
08/03/2010 14:19,2009,2008,B,Other Reporting Airports,BOURNEMOUTH,MANCHESTER,0,0,0,286,0,286,
08/03/2010 14:19,2009,2008,B,Other Reporting Airports,BOURNEMOUTH,NEWCASTLE,0,0,0,286,0,286,
08/03/2010 14:19,2009,2008,B,Other Reporting Airports,BOURNEMOUTH,PRESTWICK,34270,34270,0,128961,128961,0,-73.42607117
08/03/2010 14:19,2009,2008,B,Other Reporting Airports,BRISTOL,CITY OF DERRY (EGLINTON),0,0,0,31969,31969,0,
08/03/2010 14:19,2009,2008,B,Other Reporting Airports,BRISTOL,DURHAM TEES VALLEY,0,0,0,28,0,28,
08/03/2010 14:19,2009,2008,B,Other Reporting Airports,BRISTOL,EAST MIDLANDS INTERNATIONAL,158,0,158,2,0,2,7800
08/03/2010 14:19,2009,2008,B,Other Reporting Airports,BRISTOL,EDINBURGH,235196,235196,0,249766,249766,0,-5.833460331
08/03/2010 14:19,2009,2008,B,Other Reporting Airports,BRISTOL,GLASGOW,212253,212253,0,220222,220123,99,-3.618621111
08/03/2010 14:19,2009,2008,B,Other Reporting Airports,BRISTOL,GUERNSEY,26976,26976,0,27552,27552,0,-2.090592384
08/03/2010 14:19,2009,2008,B,Other Reporting Airports,BRISTOL,INVERNESS,73315,73315,0,73960,73960,0,-0.872093022
08/03/2010 14:19,2009,2008,B,Other Reporting Airports,BRISTOL,ISLE OF MAN,0,0,0,208,208,0,
08/03/2010 14:19,2009,2008,B,Other Reporting Airports,BRISTOL,ISLES OF SCILLY (ST.MARYS),3330,3330,0,3914,3914,0,-14.92079735
08/03/2010 14:19,2009,2008,B,Other Reporting Airports,BRISTOL,JERSEY,28042,27996,46,31865,31865,0,-11.99748898
08/03/2010 14:19,2009,2008,B,Other Reporting Airports,BRISTOL,KENT INTERNATIONAL,48,0,48,0,0,0,
08/03/2010 14:19,2009,2008,B,Other Reporting Airports,BRISTOL,LEEDS BRADFORD,28544,28544,0,31511,31511,0,-9.41576004
08/03/2010 14:19,2009,2008,B,Other Reporting Airports,BRISTOL,MANCHESTER,21798,21797,1,29342,29196,146,-25.71058464
08/03/2010 14:19,2009,2008,B,Other Reporting Airports,BRISTOL,NEWCASTLE,187022,186934,88,202178,202178,0,-7.496364594
08/03/2010 14:19,2009,2008,B,Other Reporting Airports,BRISTOL,NEWQUAY,16589,16589,0,18813,18813,0,-11.82161236
08/03/2010 14:19,2009,2008,B,Other Reporting Airports,BRISTOL,PLYMOUTH,10686,10686,0,9566,9566,0,11.70813274
08/03/2010 14:19,2009,2008,B,Other Reporting Airports,CAMBRIDGE,NEWCASTLE,29,0,29,0,0,0,
08/03/2010 14:19,2009,2008,B,Other Reporting Airports,CAMBRIDGE,PLYMOUTH,62,0,62,0,0,0,
08/03/2010 14:19,2009,2008,B,Other Reporting Airports,CAMBRIDGE,WARTON,0,0,0,24,0,24,
08/03/2010 14:19,2009,2008,B,Other Reporting Airports,CAMPBELTOWN,EDINBURGH,2,0,2,0,0,0,
08/03/2010 14:19,2009,2008,B,Other Reporting Airports,CAMPBELTOWN,GLASGOW,9334,9334,0,9072,9072,0,2.888007164
08/03/2010 14:19,2009,2008,B,Other Reporting Airports,CAMPBELTOWN,ISLAY,40,40,0,0,0,0,
08/03/2010 14:19,2009,2008,B,Other Reporting Airports,CARDIFF WALES,DURHAM TEES VALLEY,0,0,0,99,0,99,
08/03/2010 14:19,2009,2008,B,Other Reporting Airports,CARDIFF WALES,EDINBURGH,161001,159376,1625,162556,162290,266,-0.956593394
08/03/2010 14:19,2009,2008,B,Other Reporting Airports,CARDIFF WALES,GLASGOW,56429,56309,120,83986,83986,0,-32.81142044
08/03/2010 14:19,2009,2008,B,Other Reporting Airports,CARDIFF WALES,HUMBERSIDE,0,0,0,54,0,54,
08/03/2010 14:19,2009,2008,B,Other Reporting Airports,CARDIFF WALES,ISLE OF MAN,0,0,0,35,0,35,
08/03/2010 14:19,2009,2008,B,Other Reporting Airports,CARDIFF WALES,JERSEY,25058,25058,0,23718,23718,0,5.649717331
08/03/2010 14:19,2009,2008,B,Other Reporting Airports,CARDIFF WALES,MANCHESTER,0,0,0,248,248,0,
08/03/2010 14:19,2009,2008,B,Other Reporting Airports,CARDIFF WALES,NEWCASTLE,30436,29894,542,31516,31516,0,-3.426830769
08/03/2010 14:19,2009,2008,B,Other Reporting Airports,CARDIFF WALES,NEWQUAY,0,0,0,1060,1060,0,
08/03/2010 14:19,2009,2008,B,Other Reporting Airports,CARDIFF WALES,NORWICH,153,0,153,62,0,62,146.7742004
08/03/2010 14:19,2009,2008,B,Other Reporting Airports,CARDIFF WALES,PLYMOUTH,1,0,1,0,0,0,
08/03/2010 14:19,2009,2008,B,Other Reporting Airports,CARDIFF WALES,WATTISHAM,0,0,0,85,0,85,
08/03/2010 14:19,2009,2008,B,Other Reporting Airports,CITY OF DERRY (EGLINTON),EAST MIDLANDS INTERNATIONAL,0,0,0,53532,53532,0,
08/03/2010 14:19,2009,2008,B,Other Reporting Airports,CITY OF DERRY (EGLINTON),GLASGOW,0,0,0,9428,9428,0,
08/03/2010 14:19,2009,2008,B,Other Reporting Airports,CITY OF DERRY (EGLINTON),LIVERPOOL,69103,69103,0,79122,79106,16,-12.66272354
08/03/2010 14:19,2009,2008,B,Other Reporting Airports,CITY OF DERRY (EGLINTON),PRESTWICK,51310,51310,0,64001,64001,0,-19.82937813
08/03/2010 14:19,2009,2008,B,Other Reporting Airports,COVENTRY,DURHAM TEES VALLEY,0,0,0,62,0,62,
08/03/2010 14:19,2009,2008,B,Other Reporting Airports,COVENTRY,GUERNSEY,0,0,0,62,0,62,
08/03/2010 14:19,2009,2008,B,Other Reporting Airports,COVENTRY,INVERNESS,0,0,0,15,0,15,
08/03/2010 14:19,2009,2008,B,Other Reporting Airports,COVENTRY,JERSEY,0,0,0,49143,49048,95,
08/03/2010 14:19,2009,2008,B,Other Reporting Airports,COVENTRY,NEWCASTLE,0,0,0,60,0,60,
08/03/2010 14:19,2009,2008,B,Other Reporting Airports,DONCASTER SHEFFIELD,EDINBURGH,0,0,0,92,0,92,
08/03/2010 14:19,2009,2008,B,Other Reporting Airports,DONCASTER SHEFFIELD,FARNBOROUGH,31,0,31,0,0,0,
08/03/2010 14:19,2009,2008,B,Other Reporting Airports,DONCASTER SHEFFIELD,JERSEY,14858,14858,0,17352,17352,0,-14.37298298
08/03/2010 14:19,2009,2008,B,Other Reporting Airports,DONCASTER SHEFFIELD,NORWICH,102,0,102,0,0,0,
08/03/2010 14:19,2009,2008,B,Other Reporting Airports,DONCASTER SHEFFIELD,PLYMOUTH,0,0,0,59,0,59,
08/03/2010 14:19,2009,2008,B,Other Reporting Airports,DUNDEE,JERSEY,2157,2157,0,1842,0,1842,17.10097694
08/03/2010 14:19,2009,2008,B,Other Reporting Airports,DUNDEE,LIVERPOOL,27,0,27,0,0,0,
08/03/2010 14:19,2009,2008,B,Other Reporting Airports,DUNDEE,SCATSTA,10,0,10,0,0,0,
08/03/2010 14:19,2009,2008,B,Other Reporting Airports,DUNKESWELL,JERSEY,0,0,0,1680,0,1680,
08/03/2010 14:19,2009,2008,B,Other Reporting Airports,DURHAM TEES VALLEY,FARNBOROUGH,0,0,0,29,0,29,
08/03/2010 14:19,2009,2008,B,Other Reporting Airports,DURHAM TEES VALLEY,JERSEY,0,0,0,4642,4642,0,
08/03/2010 14:19,2009,2008,B,Other Reporting Airports,DURHAM TEES VALLEY,LIVERPOOL,31,0,31,55,0,55,-43.63636398
08/03/2010 14:19,2009,2008,B,Other Reporting Airports,DURHAM TEES VALLEY,MANCHESTER,0,0,0,70,0,70,
08/03/2010 14:19,2009,2008,B,Other Reporting Airports,DURHAM TEES VALLEY,NEWQUAY,0,0,0,76,0,76,
08/03/2010 14:19,2009,2008,B,Other Reporting Airports,DURHAM TEES VALLEY,PLYMOUTH,82,0,82,0,0,0,
08/03/2010 14:19,2009,2008,B,Other Reporting Airports,DURHAM TEES VALLEY,SOUTHAMPTON,661,576,85,100,0,100,561
08/03/2010 14:19,2009,2008,B,Other Reporting Airports,EAST MIDLANDS INTERNATIONAL,EDINBURGH,130205,130105,100,164051,164051,0,-20.63138962
08/03/2010 14:19,2009,2008,B,Other Reporting Airports,EAST MIDLANDS INTERNATIONAL,GLASGOW,115002,115002,0,150916,150768,148,-23.79734421
08/03/2010 14:19,2009,2008,B,Other Reporting Airports,EAST MIDLANDS INTERNATIONAL,GUERNSEY,20085,20085,0,0,0,0,
08/03/2010 14:19,2009,2008,B,Other Reporting Airports,EAST MIDLANDS INTERNATIONAL,INVERNESS,20373,20373,0,40185,40185,0,-49.30197906
08/03/2010 14:19,2009,2008,B,Other Reporting Airports,EAST MIDLANDS INTERNATIONAL,ISLE OF MAN,6413,6413,0,5574,5574,0,15.0520277
08/03/2010 14:19,2009,2008,B,Other Reporting Airports,EAST MIDLANDS INTERNATIONAL,JERSEY,61340,61340,0,56577,56390,187,8.418615341
08/03/2010 14:19,2009,2008,B,Other Reporting Airports,EAST MIDLANDS INTERNATIONAL,STORNOWAY,0,0,0,63,0,63,
08/03/2010 14:19,2009,2008,B,Other Reporting Airports,EAST MIDLANDS INTERNATIONAL,WARTON,0,0,0,25,0,25,
08/03/2010 14:19,2009,2008,B,Other Reporting Airports,EDAY,KIRKWALL,536,536,0,603,603,0,-11.11111069
08/03/2010 14:19,2009,2008,B,Other Reporting Airports,EDINBURGH,EXETER,61095,61095,0,68043,68043,0,-10.21119022
08/03/2010 14:19,2009,2008,B,Other Reporting Airports,EDINBURGH,FARNBOROUGH,20,0,20,35,0,35,-42.8571434
08/03/2010 14:19,2009,2008,B,Other Reporting Airports,EDINBURGH,INVERNESS,854,848,6,7510,7510,0,-88.62849426
08/03/2010 14:19,2009,2008,B,Other Reporting Airports,EDINBURGH,ISLE OF MAN,11522,11522,0,13048,13048,0,-11.69527912
08/03/2010 14:19,2009,2008,B,Other Reporting Airports,EDINBURGH,JERSEY,23190,23190,0,28740,28740,0,-19.31106377
08/03/2010 14:19,2009,2008,B,Other Reporting Airports,EDINBURGH,KIRKWALL,39054,39054,0,35656,35656,0,9.529953003
08/03/2010 14:19,2009,2008,B,Other Reporting Airports,EDINBURGH,LEEDS BRADFORD,18960,18960,0,36473,36473,0,-48.01634216
08/03/2010 14:19,2009,2008,B,Other Reporting Airports,EDINBURGH,MANCHESTER,158307,158292,15,228551,228525,26,-30.73449707
08/03/2010 14:19,2009,2008,B,Other Reporting Airports,EDINBURGH,NEWCASTLE,0,0,0,67,0,67,
08/03/2010 14:19,2009,2008,B,Other Reporting Airports,EDINBURGH,NEWQUAY,12218,12218,0,17921,17862,59,-31.82300186
08/03/2010 14:19,2009,2008,B,Other Reporting Airports,EDINBURGH,NORWICH,50365,50365,0,58612,58612,0,-14.07049751
08/03/2010 14:19,2009,2008,B,Other Reporting Airports,EDINBURGH,SOUTHAMPTON,191511,191511,0,205057,205057,0,-6.605967999
08/03/2010 14:19,2009,2008,B,Other Reporting Airports,EDINBURGH,STORNOWAY,31831,31831,0,28320,28320,0,12.39759922
08/03/2010 14:19,2009,2008,B,Other Reporting Airports,EDINBURGH,SUMBURGH,32897,32897,0,30801,30801,0,6.804974079
08/03/2010 14:19,2009,2008,B,Other Reporting Airports,EDINBURGH,WICK,7566,7566,0,7336,7255,81,3.135223627
08/03/2010 14:19,2009,2008,B,Other Reporting Airports,EXETER,GLASGOW,33359,33359,0,39424,39424,0,-15.38403034
08/03/2010 14:19,2009,2008,B,Other Reporting Airports,EXETER,GUERNSEY,24479,24479,0,26621,26621,0,-8.046278954
08/03/2010 14:19,2009,2008,B,Other Reporting Airports,EXETER,INVERNESS,0,0,0,5824,5824,0,
08/03/2010 14:19,2009,2008,B,Other Reporting Airports,EXETER,ISLES OF SCILLY (ST.MARYS),4223,4223,0,4154,4154,0,1.661049604
08/03/2010 14:19,2009,2008,B,Other Reporting Airports,EXETER,JERSEY,33193,33193,0,34317,34317,0,-3.27534461
08/03/2010 14:19,2009,2008,B,Other Reporting Airports,EXETER,LEEDS BRADFORD,15357,15357,0,22703,22703,0,-32.35695648
08/03/2010 14:19,2009,2008,B,Other Reporting Airports,EXETER,MANCHESTER,48526,48526,0,52470,52470,0,-7.516676426
08/03/2010 14:19,2009,2008,B,Other Reporting Airports,EXETER,NEWCASTLE,39029,39029,0,48216,48216,0,-19.05384064
08/03/2010 14:19,2009,2008,B,Other Reporting Airports,EXETER,NORWICH,8992,8992,0,10876,10876,0,-17.32254601
08/03/2010 14:19,2009,2008,B,Other Reporting Airports,FAIR ISLE,LERWICK (TINGWALL),2645,2645,0,2591,2591,0,2.08413744
08/03/2010 14:19,2009,2008,B,Other Reporting Airports,FAIR ISLE,SUMBURGH,83,83,0,211,211,0,-60.66350555
08/03/2010 14:19,2009,2008,B,Other Reporting Airports,FARNBOROUGH,GLASGOW,24,0,24,0,0,0,
08/03/2010 14:19,2009,2008,B,Other Reporting Airports,FARNBOROUGH,HUMBERSIDE,0,0,0,35,0,35,
08/03/2010 14:19,2009,2008,B,Other Reporting Airports,FARNBOROUGH,LIVERPOOL,95,0,95,168,0,168,-43.45238113
08/03/2010 14:19,2009,2008,B,Other Reporting Airports,FARNBOROUGH,MANCHESTER,361,0,361,269,0,269,34.20074463
08/03/2010 14:19,2009,2008,B,Other Reporting Airports,FARNBOROUGH,NEWCASTLE,178,0,178,62,0,62,187.0967712
08/03/2010 14:19,2009,2008,B,Other Reporting Airports,FILTON,LIVERPOOL,0,0,0,28,0,28,
08/03/2010 14:19,2009,2008,B,Other Reporting Airports,FILTON,MANCHESTER,19,0,19,0,0,0,
08/03/2010 14:19,2009,2008,B,Other Reporting Airports,FOULA,LERWICK (TINGWALL),1291,1291,0,1380,1380,0,-6.449275494
08/03/2010 14:19,2009,2008,B,Other Reporting Airports,GLASGOW,INVERNESS,0,0,0,70,0,70,
08/03/2010 14:19,2009,2008,B,Other Reporting Airports,GLASGOW,ISLAY,26242,26242,0,29338,29338,0,-10.55286694
08/03/2010 14:19,2009,2008,B,Other Reporting Airports,GLASGOW,ISLE OF MAN,13768,13768,0,16685,16685,0,-17.48276901
08/03/2010 14:19,2009,2008,B,Other Reporting Airports,GLASGOW,JERSEY,5415,5415,0,5639,5639,0,-3.972335577
08/03/2010 14:19,2009,2008,B,Other Reporting Airports,GLASGOW,KIRKWALL,15366,15366,0,15055,15055,0,2.065758944
08/03/2010 14:19,2009,2008,B,Other Reporting Airports,GLASGOW,LEEDS BRADFORD,19923,19923,0,30438,30438,0,-34.54563522
08/03/2010 14:19,2009,2008,B,Other Reporting Airports,GLASGOW,LIVERPOOL,0,0,0,94,0,94,
08/03/2010 14:19,2009,2008,B,Other Reporting Airports,GLASGOW,MANCHESTER,100364,100275,89,151842,150797,1045,-33.90234756
08/03/2010 14:19,2009,2008,B,Other Reporting Airports,GLASGOW,NEWCASTLE,239,0,239,0,0,0,
08/03/2010 14:19,2009,2008,B,Other Reporting Airports,GLASGOW,NEWQUAY,279,279,0,1636,1636,0,-82.94621277
08/03/2010 14:19,2009,2008,B,Other Reporting Airports,GLASGOW,NORWICH,0,0,0,5423,5423,0,
08/03/2010 14:19,2009,2008,B,Other Reporting Airports,GLASGOW,PLYMOUTH,24370,24370,0,17176,17176,0,41.88402557
08/03/2010 14:19,2009,2008,B,Other Reporting Airports,GLASGOW,SCATSTA,0,0,0,52,0,52,
08/03/2010 14:19,2009,2008,B,Other Reporting Airports,GLASGOW,SOUTHAMPTON,156293,156078,215,161558,161264,294,-3.258891582
08/03/2010 14:19,2009,2008,B,Other Reporting Airports,GLASGOW,STORNOWAY,53723,53723,0,58144,58144,0,-7.603536129
08/03/2010 14:19,2009,2008,B,Other Reporting Airports,GLASGOW,SUMBURGH,17406,17406,0,17227,17227,0,1.039066553
08/03/2010 14:19,2009,2008,B,Other Reporting Airports,GLASGOW,TIREE,7305,7305,0,7894,7894,0,-7.461362839
08/03/2010 14:19,2009,2008,B,Other Reporting Airports,GLOUCESTERSHIRE,ISLE OF MAN,16872,16872,0,16460,16460,0,2.503037691
08/03/2010 14:19,2009,2008,B,Other Reporting Airports,GLOUCESTERSHIRE,JERSEY,3297,3297,0,2602,2602,0,26.71022224
08/03/2010 14:19,2009,2008,B,Other Reporting Airports,GUERNSEY,ISLE OF MAN,3880,3841,39,2111,2111,0,83.79914856
08/03/2010 14:19,2009,2008,B,Other Reporting Airports,GUERNSEY,JERSEY,139890,139890,0,159246,159195,51,-12.15477943
08/03/2010 14:19,2009,2008,B,Other Reporting Airports,GUERNSEY,MANCHESTER,74865,74865,0,78073,77982,91,-4.108974934
08/03/2010 14:19,2009,2008,B,Other Reporting Airports,GUERNSEY,NORWICH,0,0,0,2772,2772,0,
08/03/2010 14:19,2009,2008,B,Other Reporting Airports,GUERNSEY,PLYMOUTH,3152,3152,0,0,0,0,
08/03/2010 14:19,2009,2008,B,Other Reporting Airports,GUERNSEY,SOUTHAMPTON,142402,142270,132,141494,141494,0,0.641723335
08/03/2010 14:19,2009,2008,B,Other Reporting Airports,HUMBERSIDE,JERSEY,2244,2244,0,1764,0,1764,27.21088409
08/03/2010 14:19,2009,2008,B,Other Reporting Airports,HUMBERSIDE,LIVERPOOL,56,0,56,0,0,0,
08/03/2010 14:19,2009,2008,B,Other Reporting Airports,HUMBERSIDE,MANCHESTER,0,0,0,187,0,187,
08/03/2010 14:19,2009,2008,B,Other Reporting Airports,HUMBERSIDE,NORWICH,209,140,69,169,0,169,23.66863823
08/03/2010 14:19,2009,2008,B,Other Reporting Airports,HUMBERSIDE,PLYMOUTH,0,0,0,140,0,140,
08/03/2010 14:19,2009,2008,B,Other Reporting Airports,HUMBERSIDE,SOUTHAMPTON,209,0,209,0,0,0,
08/03/2010 14:19,2009,2008,B,Other Reporting Airports,INVERNESS,ISLAY,0,0,0,29,0,29,
08/03/2010 14:19,2009,2008,B,Other Reporting Airports,INVERNESS,ISLE OF MAN,0,0,0,131,0,131,
08/03/2010 14:19,2009,2008,B,Other Reporting Airports,INVERNESS,JERSEY,1232,1232,0,922,0,922,33.62255859
08/03/2010 14:19,2009,2008,B,Other Reporting Airports,INVERNESS,KIRKWALL,24795,24795,0,25085,25085,0,-1.156069398
08/03/2010 14:19,2009,2008,B,Other Reporting Airports,INVERNESS,LEEDS BRADFORD,0,0,0,815,815,0,
08/03/2010 14:19,2009,2008,B,Other Reporting Airports,INVERNESS,MANCHESTER,50505,50505,0,42940,42890,50,17.61760521
08/03/2010 14:19,2009,2008,B,Other Reporting Airports,INVERNESS,PRESTWICK,0,0,0,162,0,162,
08/03/2010 14:19,2009,2008,B,Other Reporting Airports,INVERNESS,SCATSTA,0,0,0,111,0,111,
08/03/2010 14:19,2009,2008,B,Other Reporting Airports,INVERNESS,SOUTHAMPTON,3903,3903,0,14862,14862,0,-73.73839569
08/03/2010 14:19,2009,2008,B,Other Reporting Airports,INVERNESS,STORNOWAY,33110,33110,0,35636,35636,0,-7.088337421
08/03/2010 14:19,2009,2008,B,Other Reporting Airports,INVERNESS,SUMBURGH,29,29,0,158,158,0,-81.64556885
08/03/2010 14:19,2009,2008,B,Other Reporting Airports,ISLE OF MAN,JERSEY,5721,5721,0,8479,8479,0,-32.52742004
08/03/2010 14:19,2009,2008,B,Other Reporting Airports,ISLE OF MAN,LEEDS BRADFORD,11892,11892,0,12808,12808,0,-7.151780128
08/03/2010 14:19,2009,2008,B,Other Reporting Airports,ISLE OF MAN,LIVERPOOL,117492,117492,0,133869,133869,0,-12.23360157
08/03/2010 14:19,2009,2008,B,Other Reporting Airports,ISLE OF MAN,MANCHESTER,142142,142074,68,159362,159362,0,-10.80558681
08/03/2010 14:19,2009,2008,B,Other Reporting Airports,ISLE OF MAN,NEWCASTLE,5553,5553,0,6115,6115,0,-9.190515518
08/03/2010 14:19,2009,2008,B,Other Reporting Airports,ISLE OF MAN,NEWQUAY,1919,1919,0,1200,1200,0,59.91666794
08/03/2010 14:19,2009,2008,B,Other Reporting Airports,ISLE OF MAN,OXFORD (KIDLINGTON),28,0,28,0,0,0,
08/03/2010 14:19,2009,2008,B,Other Reporting Airports,ISLE OF MAN,SOUTHAMPTON,8207,8207,0,14393,14393,0,-42.97922516
08/03/2010 14:19,2009,2008,B,Other Reporting Airports,ISLES OF SCILLY (ST.MARYS),NEWQUAY,12212,12212,0,16690,16690,0,-26.83043671
08/03/2010 14:19,2009,2008,B,Other Reporting Airports,ISLES OF SCILLY (ST.MARYS),SOUTHAMPTON,3081,3081,0,3373,3373,0,-8.656981468
08/03/2010 14:19,2009,2008,B,Other Reporting Airports,JERSEY,KENT INTERNATIONAL,1896,1896,0,1435,0,1435,32.12543488
08/03/2010 14:19,2009,2008,B,Other Reporting Airports,JERSEY,LEEDS BRADFORD,18195,18195,0,14904,14904,0,22.08131981
08/03/2010 14:19,2009,2008,B,Other Reporting Airports,JERSEY,LIVERPOOL,54971,54971,0,54241,54241,0,1.345845342
08/03/2010 14:19,2009,2008,B,Other Reporting Airports,JERSEY,MANCHESTER,94734,94734,0,102862,102777,85,-7.90184927
08/03/2010 14:19,2009,2008,B,Other Reporting Airports,JERSEY,NEWCASTLE,13042,13042,0,13192,13192,0,-1.137052774
08/03/2010 14:19,2009,2008,B,Other Reporting Airports,JERSEY,NEWQUAY,0,0,0,403,173,230,
08/03/2010 14:19,2009,2008,B,Other Reporting Airports,JERSEY,NORWICH,7568,7568,0,14600,14600,0,-48.16438293
08/03/2010 14:19,2009,2008,B,Other Reporting Airports,JERSEY,OXFORD (KIDLINGTON),832,0,832,0,0,0,
08/03/2010 14:19,2009,2008,B,Other Reporting Airports,JERSEY,PLYMOUTH,13434,13434,0,14774,14774,0,-9.069988251
08/03/2010 14:19,2009,2008,B,Other Reporting Airports,JERSEY,SOUTHAMPTON,141830,141756,74,139313,139313,0,1.806722999
08/03/2010 14:19,2009,2008,B,Other Reporting Airports,KENT INTERNATIONAL,MANCHESTER,58,0,58,37,0,37,56.75675583
08/03/2010 14:19,2009,2008,B,Other Reporting Airports,KIRKWALL,NORTH RONALDSAY,7344,7344,0,6791,6791,0,8.143130302
08/03/2010 14:19,2009,2008,B,Other Reporting Airports,KIRKWALL,PAPA WESTRAY,4269,4269,0,3795,3795,0,12.49011898
08/03/2010 14:19,2009,2008,B,Other Reporting Airports,KIRKWALL,SANDAY,2968,2968,0,2911,2911,0,1.958089948
08/03/2010 14:19,2009,2008,B,Other Reporting Airports,KIRKWALL,STRONSAY,3145,3145,0,2964,2964,0,6.106612682
08/03/2010 14:19,2009,2008,B,Other Reporting Airports,KIRKWALL,SUMBURGH,8833,8833,0,8709,8709,0,1.423814416
08/03/2010 14:19,2009,2008,B,Other Reporting Airports,KIRKWALL,WESTRAY,3565,3565,0,3340,3340,0,6.736526966
08/03/2010 14:19,2009,2008,B,Other Reporting Airports,LEEDS BRADFORD,LIVERPOOL,3,3,0,0,0,0,
08/03/2010 14:19,2009,2008,B,Other Reporting Airports,LEEDS BRADFORD,MANCHESTER,631,631,0,0,0,0,
08/03/2010 14:19,2009,2008,B,Other Reporting Airports,LEEDS BRADFORD,NEWQUAY,23941,23941,0,4842,4838,4,394.444458
08/03/2010 14:19,2009,2008,B,Other Reporting Airports,LEEDS BRADFORD,PLYMOUTH,8209,8209,0,1609,1609,0,410.1926575
08/03/2010 14:19,2009,2008,B,Other Reporting Airports,LEEDS BRADFORD,SOUTHAMPTON,79901,79901,0,86128,86128,0,-7.229937077
08/03/2010 14:19,2009,2008,B,Other Reporting Airports,LEEDS BRADFORD,WICK,0,0,0,15,0,15,
08/03/2010 14:19,2009,2008,B,Other Reporting Airports,LERWICK (TINGWALL),OUT SKERRIES,586,586,0,625,625,0,-6.239999771
08/03/2010 14:19,2009,2008,B,Other Reporting Airports,LERWICK (TINGWALL),PAPA STOUR,145,145,0,135,135,0,7.407407284
08/03/2010 14:19,2009,2008,B,Other Reporting Airports,LIVERPOOL,MANCHESTER,0,0,0,208,0,208,
08/03/2010 14:19,2009,2008,B,Other Reporting Airports,LIVERPOOL,NEWCASTLE,54,0,54,0,0,0,
08/03/2010 14:19,2009,2008,B,Other Reporting Airports,LIVERPOOL,SOUTHAMPTON,5236,5086,150,60,0,60,8626.666992
08/03/2010 14:19,2009,2008,B,Other Reporting Airports,MANCHESTER,NEWCASTLE,0,0,0,364,0,364,
08/03/2010 14:19,2009,2008,B,Other Reporting Airports,MANCHESTER,NEWQUAY,51538,51353,185,42855,42855,0,20.26134682
08/03/2010 14:19,2009,2008,B,Other Reporting Airports,MANCHESTER,NORWICH,34438,34376,62,42846,42846,0,-19.62376976
08/03/2010 14:19,2009,2008,B,Other Reporting Airports,MANCHESTER,PLYMOUTH,24307,24307,0,33002,33002,0,-26.34688759
08/03/2010 14:19,2009,2008,B,Other Reporting Airports,MANCHESTER,SOUTHAMPTON,132139,131416,723,156187,155883,304,-15.39692783
08/03/2010 14:19,2009,2008,B,Other Reporting Airports,MANCHESTER,WICK,0,0,0,32,0,32,
08/03/2010 14:19,2009,2008,B,Other Reporting Airports,NEWCASTLE,NEWQUAY,0,0,0,118,60,58,
08/03/2010 14:19,2009,2008,B,Other Reporting Airports,NEWCASTLE,NORWICH,72,0,72,0,0,0,
08/03/2010 14:19,2009,2008,B,Other Reporting Airports,NEWCASTLE,PLYMOUTH,16722,16722,0,13348,13348,0,25.27719498
08/03/2010 14:19,2009,2008,B,Other Reporting Airports,NEWCASTLE,SOUTHAMPTON,110338,110043,295,117305,117041,264,-5.939218044
08/03/2010 14:19,2009,2008,B,Other Reporting Airports,NEWQUAY,PLYMOUTH,725,725,0,189,189,0,283.5978699
08/03/2010 14:19,2009,2008,B,Other Reporting Airports,NEWQUAY,SOUTHAMPTON,23,0,23,28,0,28,-17.8571434
08/03/2010 14:19,2009,2008,B,Other Reporting Airports,NORWICH,PLYMOUTH,95,0,95,0,0,0,
08/03/2010 14:19,2009,2008,B,Other Reporting Airports,OBAN (NORTH CONNEL),TIREE,925,925,0,440,440,0,110.227272
08/03/2010 14:19,2009,2008,B,Other Reporting Airports,SOUTH MARSTON,WICK,0,0,0,71,0,71,
