rundate,this_period,last_period,grp_name,apt1_apt_name,apt2_apt_name,total_pax_tp,total_pax_shd_tp,total_pax_cht_tp,total_pax_lp,total_pax_shd_lp,total_pax_cht_lp,total_pax_pc
28/02/2008 17:39,2007,2006,London Area Airports,GATWICK,ABERDEEN,214946,214946,0,216677,216677,0,-0.798884988
28/02/2008 17:39,2007,2006,London Area Airports,GATWICK,BELFAST CITY (GEORGE BEST),200801,200801,0,198079,197872,207,1.374199152
28/02/2008 17:39,2007,2006,London Area Airports,GATWICK,BELFAST INTERNATIONAL,383674,383658,16,362388,362205,183,5.873814583
28/02/2008 17:39,2007,2006,London Area Airports,GATWICK,BIRMINGHAM,50,0,50,59,59,0,-15.25423717
28/02/2008 17:39,2007,2006,London Area Airports,GATWICK,BLACKPOOL,0,0,0,46,0,46,
28/02/2008 17:39,2007,2006,London Area Airports,GATWICK,BOURNEMOUTH,0,0,0,17,0,17,
28/02/2008 17:39,2007,2006,London Area Airports,GATWICK,CARDIFF WALES,105,0,105,2,0,2,5150
28/02/2008 17:39,2007,2006,London Area Airports,GATWICK,DURHAM TEES VALLEY,1028,0,1028,42439,40503,1936,-97.57769775
28/02/2008 17:39,2007,2006,London Area Airports,GATWICK,EDINBURGH,748309,748230,79,754106,753746,360,-0.768724799
28/02/2008 17:39,2007,2006,London Area Airports,GATWICK,EXETER,9,0,9,0,0,0,
28/02/2008 17:39,2007,2006,London Area Airports,GATWICK,GLASGOW,570656,570655,1,433003,433003,0,31.79031181
28/02/2008 17:39,2007,2006,London Area Airports,GATWICK,GUERNSEY,342826,342826,0,352752,352752,0,-2.81387496
28/02/2008 17:39,2007,2006,London Area Airports,GATWICK,HUMBERSIDE,45,0,45,0,0,0,
28/02/2008 17:39,2007,2006,London Area Airports,GATWICK,INVERNESS,221550,221550,0,240771,240771,0,-7.983104229
28/02/2008 17:39,2007,2006,London Area Airports,GATWICK,ISLE OF MAN,144346,144346,0,117977,117843,134,22.35096741
28/02/2008 17:39,2007,2006,London Area Airports,GATWICK,JERSEY,525156,524247,909,538343,538343,0,-2.44955349
28/02/2008 17:39,2007,2006,London Area Airports,GATWICK,KIRKWALL,211,0,211,0,0,0,
28/02/2008 17:39,2007,2006,London Area Airports,GATWICK,LIVERPOOL,2399,0,2399,152,0,152,1478.289429
28/02/2008 17:39,2007,2006,London Area Airports,GATWICK,MANCHESTER,414350,413768,582,472942,471978,964,-12.388834
28/02/2008 17:39,2007,2006,London Area Airports,GATWICK,NEWCASTLE,109649,109609,40,216544,216470,74,-49.36410141
28/02/2008 17:39,2007,2006,London Area Airports,GATWICK,NEWQUAY,73927,73927,0,43124,43124,0,71.42890167
28/02/2008 17:39,2007,2006,London Area Airports,GATWICK,NOTTINGHAM EAST MIDLANDS INT'L,40,0,40,0,0,0,
28/02/2008 17:39,2007,2006,London Area Airports,GATWICK,PLYMOUTH,67780,67780,0,68742,68742,0,-1.39943552
28/02/2008 17:39,2007,2006,London Area Airports,GATWICK,SOUTHEND,20,0,20,0,0,0,
28/02/2008 17:39,2007,2006,London Area Airports,HEATHROW,ABERDEEN,658984,658984,0,673228,673228,0,-2.115776539
28/02/2008 17:39,2007,2006,London Area Airports,HEATHROW,BELFAST CITY (GEORGE BEST),626218,626218,0,665656,665656,0,-5.924681664
28/02/2008 17:39,2007,2006,London Area Airports,HEATHROW,BRIZE NORTON,0,0,0,8,0,8,
28/02/2008 17:39,2007,2006,London Area Airports,HEATHROW,CARDIFF WALES,0,0,0,33,0,33,
28/02/2008 17:39,2007,2006,London Area Airports,HEATHROW,DURHAM TEES VALLEY,88223,88223,0,110803,110803,0,-20.37850952
28/02/2008 17:39,2007,2006,London Area Airports,HEATHROW,EDINBURGH,1436598,1436516,82,1495042,1495034,8,-3.909187794
28/02/2008 17:39,2007,2006,London Area Airports,HEATHROW,GLASGOW,1207127,1207118,9,1284469,1284414,55,-6.02132082
28/02/2008 17:39,2007,2006,London Area Airports,HEATHROW,INVERNESS,53549,53549,0,50952,50940,12,5.096953869
28/02/2008 17:39,2007,2006,London Area Airports,HEATHROW,JERSEY,77574,77563,11,0,0,0,
28/02/2008 17:39,2007,2006,London Area Airports,HEATHROW,LEEDS BRADFORD,136952,136952,0,147992,147992,0,-7.459862709
28/02/2008 17:39,2007,2006,London Area Airports,HEATHROW,LIVERPOOL,66,0,66,0,0,0,
28/02/2008 17:39,2007,2006,London Area Airports,HEATHROW,LUTON,2,0,2,0,0,0,
28/02/2008 17:39,2007,2006,London Area Airports,HEATHROW,MANCHESTER,973044,972612,432,1086918,1086906,12,-10.47677898
28/02/2008 17:39,2007,2006,London Area Airports,HEATHROW,NEWCASTLE,495366,495366,0,478505,478505,0,3.523683071
28/02/2008 17:39,2007,2006,London Area Airports,HEATHROW,NOTTINGHAM EAST MIDLANDS INT'L,0,0,0,6,0,6,
28/02/2008 17:39,2007,2006,London Area Airports,LONDON CITY,BELFAST CITY (GEORGE BEST),14482,14482,0,0,0,0,
28/02/2008 17:39,2007,2006,London Area Airports,LONDON CITY,DUNDEE,48991,48991,0,50015,50015,0,-2.047385693
28/02/2008 17:39,2007,2006,London Area Airports,LONDON CITY,EDINBURGH,353874,353874,0,313934,313934,0,12.72241974
28/02/2008 17:39,2007,2006,London Area Airports,LONDON CITY,GLASGOW,78079,78079,0,0,0,0,
28/02/2008 17:39,2007,2006,London Area Airports,LONDON CITY,ISLE OF MAN,65343,65343,0,65200,65200,0,0.219325155
28/02/2008 17:39,2007,2006,London Area Airports,LONDON CITY,JERSEY,16476,16476,0,16034,16034,0,2.756642103
28/02/2008 17:39,2007,2006,London Area Airports,LONDON CITY,LIVERPOOL,12514,12514,0,47931,47931,0,-73.89163208
28/02/2008 17:39,2007,2006,London Area Airports,LONDON CITY,MANCHESTER,108562,108537,25,113310,113289,21,-4.190274239
28/02/2008 17:39,2007,2006,London Area Airports,LONDON CITY,NEWCASTLE,685,685,0,14575,14575,0,-95.3001709
28/02/2008 17:39,2007,2006,London Area Airports,LONDON CITY,SANDOWN,0,0,0,56,56,0,
28/02/2008 17:39,2007,2006,London Area Airports,LUTON,ABERDEEN,149885,149819,66,148741,148741,0,0.769122183
28/02/2008 17:39,2007,2006,London Area Airports,LUTON,BELFAST CITY (GEORGE BEST),35,0,35,0,0,0,
28/02/2008 17:39,2007,2006,London Area Airports,LUTON,BELFAST INTERNATIONAL,360176,360176,0,366395,366395,0,-1.697348475
28/02/2008 17:39,2007,2006,London Area Airports,LUTON,BLACKPOOL,164,0,164,136,0,136,20.58823586
28/02/2008 17:39,2007,2006,London Area Airports,LUTON,BOURNEMOUTH,44,0,44,0,0,0,
28/02/2008 17:39,2007,2006,London Area Airports,LUTON,CARDIFF WALES,591,0,591,71,0,71,732.3943481
28/02/2008 17:39,2007,2006,London Area Airports,LUTON,COVENTRY,96,0,96,0,0,0,
28/02/2008 17:39,2007,2006,London Area Airports,LUTON,DONCASTER SHEFFIELD,64,0,64,23,0,23,178.2608643
28/02/2008 17:39,2007,2006,London Area Airports,LUTON,DURHAM TEES VALLEY,108,0,108,336,0,336,-67.85713959
28/02/2008 17:39,2007,2006,London Area Airports,LUTON,EDINBURGH,429107,429087,20,443977,443977,0,-3.34927249
28/02/2008 17:39,2007,2006,London Area Airports,LUTON,EXETER,87,0,87,0,0,0,
28/02/2008 17:39,2007,2006,London Area Airports,LUTON,FARNBOROUGH,55,0,55,0,0,0,
28/02/2008 17:39,2007,2006,London Area Airports,LUTON,GLASGOW,407691,407690,1,413876,413654,222,-1.494408965
28/02/2008 17:39,2007,2006,London Area Airports,LUTON,INVERNESS,102251,102185,66,100492,100354,138,1.750388145
28/02/2008 17:39,2007,2006,London Area Airports,LUTON,ISLE OF MAN,4181,4181,0,55554,55554,0,-92.47399139
28/02/2008 17:39,2007,2006,London Area Airports,LUTON,JERSEY,33789,33773,16,3707,3707,0,811.4917603
28/02/2008 17:39,2007,2006,London Area Airports,LUTON,LEEDS BRADFORD,0,0,0,14,0,14,
28/02/2008 17:39,2007,2006,London Area Airports,LUTON,LIVERPOOL,395,0,395,154,0,154,156.4934998
28/02/2008 17:39,2007,2006,London Area Airports,LUTON,MANCHESTER,319,0,319,599,0,599,-46.7445755
28/02/2008 17:39,2007,2006,London Area Airports,LUTON,NEWCASTLE,131,0,131,219,0,219,-40.18264771
28/02/2008 17:39,2007,2006,London Area Airports,LUTON,NEWQUAY,0,0,0,2623,2623,0,
28/02/2008 17:39,2007,2006,London Area Airports,LUTON,PLYMOUTH,0,0,0,92,0,92,
28/02/2008 17:39,2007,2006,London Area Airports,LUTON,PRESTWICK,0,0,0,17,0,17,
28/02/2008 17:39,2007,2006,London Area Airports,LUTON,WICK,152,0,152,0,0,0,
28/02/2008 17:39,2007,2006,London Area Airports,SOUTHEND,BLACKPOOL,87,0,87,0,0,0,
28/02/2008 17:39,2007,2006,London Area Airports,SOUTHEND,JERSEY,2747,2747,0,2913,2763,150,-5.698592663
28/02/2008 17:39,2007,2006,London Area Airports,SOUTHEND,MANCHESTER,0,0,0,67,0,67,
28/02/2008 17:39,2007,2006,London Area Airports,SOUTHEND,PLYMOUTH,0,0,0,49,0,49,
28/02/2008 17:39,2007,2006,London Area Airports,STANSTED,BELFAST CITY (GEORGE BEST),138228,138228,0,62001,62001,0,122.9447937
28/02/2008 17:39,2007,2006,London Area Airports,STANSTED,BELFAST INTERNATIONAL,372627,372627,0,373931,373931,0,-0.348727435
28/02/2008 17:39,2007,2006,London Area Airports,STANSTED,BIGGIN HILL,0,0,0,8,0,8,
28/02/2008 17:39,2007,2006,London Area Airports,STANSTED,BIRMINGHAM,0,0,0,135,135,0,
28/02/2008 17:39,2007,2006,London Area Airports,STANSTED,BLACKPOOL,43327,43269,58,121716,121689,27,-64.40319824
28/02/2008 17:39,2007,2006,London Area Airports,STANSTED,CARDIFF WALES,0,0,0,968,0,968,
28/02/2008 17:39,2007,2006,London Area Airports,STANSTED,CITY OF DERRY (EGLINTON),155488,155488,0,153785,153785,0,1.107390165
28/02/2008 17:39,2007,2006,London Area Airports,STANSTED,EDINBURGH,448745,448599,146,470164,469942,222,-4.555644512
28/02/2008 17:39,2007,2006,London Area Airports,STANSTED,EXETER,0,0,0,29,0,29,
28/02/2008 17:39,2007,2006,London Area Airports,STANSTED,GLASGOW,448049,447369,680,461556,461556,0,-2.92640543
28/02/2008 17:39,2007,2006,London Area Airports,STANSTED,GUERNSEY,35639,35639,0,30846,30846,0,15.53848171
28/02/2008 17:39,2007,2006,London Area Airports,STANSTED,INVERNESS,304,0,304,0,0,0,
28/02/2008 17:39,2007,2006,London Area Airports,STANSTED,ISLE OF MAN,56,0,56,140,140,0,-60
28/02/2008 17:39,2007,2006,London Area Airports,STANSTED,JERSEY,1983,0,1983,1693,0,1693,17.12935638
28/02/2008 17:39,2007,2006,London Area Airports,STANSTED,LIVERPOOL,28,0,28,3528,0,3528,-99.20635223
28/02/2008 17:39,2007,2006,London Area Airports,STANSTED,MANCHESTER,82854,82710,144,103699,103327,372,-20.10144806
28/02/2008 17:39,2007,2006,London Area Airports,STANSTED,NEWCASTLE,297882,297769,113,303682,303682,0,-1.909892559
28/02/2008 17:39,2007,2006,London Area Airports,STANSTED,NEWQUAY,97096,97096,0,101585,101585,0,-4.418959618
28/02/2008 17:39,2007,2006,London Area Airports,STANSTED,PRESTWICK,427062,427062,0,469623,469605,18,-9.062801361
28/02/2008 17:39,2007,2006,London Area Airports,STANSTED,SUMBURGH,2493,2493,0,69,69,0,3513.043457
28/02/2008 17:39,2007,2006,London Area Airports,STANSTED,WICK,0,0,0,34,0,34,
28/02/2008 17:39,2007,2006,Other UK Airports,ABERDEEN,BELFAST CITY (GEORGE BEST),25650,25650,0,29916,29916,0,-14.25992775
28/02/2008 17:39,2007,2006,Other UK Airports,ABERDEEN,BIRMINGHAM,151484,151484,0,77948,77948,0,94.33981323
28/02/2008 17:39,2007,2006,Other UK Airports,ABERDEEN,BRISTOL,26692,26692,0,28686,28686,0,-6.951126099
28/02/2008 17:39,2007,2006,Other UK Airports,ABERDEEN,CARDIFF WALES,0,0,0,1354,1354,0,
28/02/2008 17:39,2007,2006,Other UK Airports,ABERDEEN,DURHAM TEES VALLEY,33434,33434,0,33710,33452,258,-0.818748116
28/02/2008 17:39,2007,2006,Other UK Airports,ABERDEEN,EDINBURGH,0,0,0,10,0,10,
28/02/2008 17:39,2007,2006,Other UK Airports,ABERDEEN,EXETER,24582,24582,0,3337,3337,0,636.6496582
28/02/2008 17:39,2007,2006,Other UK Airports,ABERDEEN,FARNBOROUGH,74,0,74,0,0,0,
28/02/2008 17:39,2007,2006,Other UK Airports,ABERDEEN,HUMBERSIDE,32478,32478,0,29607,29607,0,9.697031021
28/02/2008 17:39,2007,2006,Other UK Airports,ABERDEEN,ISLAY,20,20,0,0,0,0,
28/02/2008 17:39,2007,2006,Other UK Airports,ABERDEEN,JERSEY,1506,0,1506,1545,0,1545,-2.524271727
28/02/2008 17:39,2007,2006,Other UK Airports,ABERDEEN,KIRKWALL,42806,42738,68,42228,42228,0,1.368760109
28/02/2008 17:39,2007,2006,Other UK Airports,ABERDEEN,LEEDS BRADFORD,26685,26684,1,20895,20895,0,27.7099781
28/02/2008 17:39,2007,2006,Other UK Airports,ABERDEEN,LIVERPOOL,46719,46719,0,17717,17717,0,163.6958923
28/02/2008 17:39,2007,2006,Other UK Airports,ABERDEEN,LYNEHAM,0,0,0,5,0,5,
28/02/2008 17:39,2007,2006,Other UK Airports,ABERDEEN,MANCHESTER,121609,121397,212,134665,134409,256,-9.695169449
28/02/2008 17:39,2007,2006,Other UK Airports,ABERDEEN,NEWCASTLE,21826,21826,0,26707,26546,161,-18.27610779
28/02/2008 17:39,2007,2006,Other UK Airports,ABERDEEN,NORWICH,65612,65573,39,68685,68685,0,-4.474048138
28/02/2008 17:39,2007,2006,Other UK Airports,ABERDEEN,NOTTINGHAM EAST MIDLANDS INT'L,18833,18833,0,22525,22525,0,-16.3906765
28/02/2008 17:39,2007,2006,Other UK Airports,ABERDEEN,SCATSTA,136972,0,136972,138439,0,138439,-1.059672475
28/02/2008 17:39,2007,2006,Other UK Airports,ABERDEEN,SOUTHAMPTON,40328,40328,0,33176,33176,0,21.55775261
28/02/2008 17:39,2007,2006,Other UK Airports,ABERDEEN,STORNOWAY,6750,6750,0,5371,5305,66,25.67492104
28/02/2008 17:39,2007,2006,Other UK Airports,ABERDEEN,SUMBURGH,73317,68817,4500,68404,64680,3724,7.182328701
28/02/2008 17:39,2007,2006,Other UK Airports,ABERDEEN,WICK,14948,14793,155,12676,12610,66,17.92363548
28/02/2008 17:39,2007,2006,Other UK Airports,ALDERNEY,BOURNEMOUTH,6415,6415,0,6658,6658,0,-3.649744749
28/02/2008 17:39,2007,2006,Other UK Airports,ALDERNEY,GUERNSEY,41560,41560,0,35916,35916,0,15.71444511
28/02/2008 17:39,2007,2006,Other UK Airports,ALDERNEY,JERSEY,694,694,0,4530,4530,0,-84.67990875
28/02/2008 17:39,2007,2006,Other UK Airports,ALDERNEY,SHOREHAM,2076,2076,0,2653,2653,0,-21.74896431
28/02/2008 17:39,2007,2006,Other UK Airports,ALDERNEY,SOUTHAMPTON,28347,28347,0,27068,27068,0,4.725136757
28/02/2008 17:39,2007,2006,Other UK Airports,BARRA,BENBECULA,1721,1721,0,1731,1731,0,-0.577700734
28/02/2008 17:39,2007,2006,Other UK Airports,BARRA,GLASGOW,8706,8706,0,8077,8077,0,7.787544727
28/02/2008 17:39,2007,2006,Other UK Airports,BELFAST CITY (GEORGE BEST),BIRMINGHAM,227454,227454,0,263934,263934,0,-13.82163715
28/02/2008 17:39,2007,2006,Other UK Airports,BELFAST CITY (GEORGE BEST),BLACKPOOL,4,4,0,4840,4840,0,-99.9173584
28/02/2008 17:39,2007,2006,Other UK Airports,BELFAST CITY (GEORGE BEST),BRISTOL,0,0,0,24923,24923,0,
28/02/2008 17:39,2007,2006,Other UK Airports,BELFAST CITY (GEORGE BEST),CARDIFF WALES,12417,12227,190,24,24,0,51637.5
28/02/2008 17:39,2007,2006,Other UK Airports,BELFAST CITY (GEORGE BEST),DONCASTER SHEFFIELD,40904,40904,0,7259,7259,0,463.4935913
28/02/2008 17:39,2007,2006,Other UK Airports,BELFAST CITY (GEORGE BEST),DUNDEE,5268,5268,0,0,0,0,
28/02/2008 17:39,2007,2006,Other UK Airports,BELFAST CITY (GEORGE BEST),EDINBURGH,106090,106090,0,108923,108923,0,-2.600919962
28/02/2008 17:39,2007,2006,Other UK Airports,BELFAST CITY (GEORGE BEST),EXETER,34356,34356,0,38337,38337,0,-10.38422394
28/02/2008 17:39,2007,2006,Other UK Airports,BELFAST CITY (GEORGE BEST),GLASGOW,99673,99638,35,116099,116033,66,-14.14826965
28/02/2008 17:39,2007,2006,Other UK Airports,BELFAST CITY (GEORGE BEST),INVERNESS,24393,24393,0,903,903,0,2601.328857
28/02/2008 17:39,2007,2006,Other UK Airports,BELFAST CITY (GEORGE BEST),ISLE OF MAN,27649,27649,0,23644,23644,0,16.93875885
28/02/2008 17:39,2007,2006,Other UK Airports,BELFAST CITY (GEORGE BEST),JERSEY,5593,5593,0,6404,6372,32,-12.66396046
28/02/2008 17:39,2007,2006,Other UK Airports,BELFAST CITY (GEORGE BEST),LEEDS BRADFORD,82644,82644,0,83741,83741,0,-1.309991479
28/02/2008 17:39,2007,2006,Other UK Airports,BELFAST CITY (GEORGE BEST),LIVERPOOL,26192,26192,0,51424,51424,0,-49.06658554
28/02/2008 17:39,2007,2006,Other UK Airports,BELFAST CITY (GEORGE BEST),MANCHESTER,237403,237403,0,243304,243304,0,-2.425360918
28/02/2008 17:39,2007,2006,Other UK Airports,BELFAST CITY (GEORGE BEST),NEWCASTLE,37208,37208,0,27858,27858,0,33.56306839
28/02/2008 17:39,2007,2006,Other UK Airports,BELFAST CITY (GEORGE BEST),NEWQUAY,1571,1571,0,0,0,0,
28/02/2008 17:39,2007,2006,Other UK Airports,BELFAST CITY (GEORGE BEST),NORWICH,0,0,0,708,708,0,
28/02/2008 17:39,2007,2006,Other UK Airports,BELFAST CITY (GEORGE BEST),NOTTINGHAM EAST MIDLANDS INT'L,11700,11700,0,0,0,0,
28/02/2008 17:39,2007,2006,Other UK Airports,BELFAST CITY (GEORGE BEST),PRESTWICK,11811,11811,0,26,0,26,45326.92188
28/02/2008 17:39,2007,2006,Other UK Airports,BELFAST CITY (GEORGE BEST),SOUTHAMPTON,100239,100239,0,97815,97815,0,2.478147507
28/02/2008 17:39,2007,2006,Other UK Airports,BELFAST INTERNATIONAL,BIRMINGHAM,189826,189826,0,176141,176141,0,7.769343853
28/02/2008 17:39,2007,2006,Other UK Airports,BELFAST INTERNATIONAL,BLACKPOOL,54757,54757,0,54392,54392,0,0.671054542
28/02/2008 17:39,2007,2006,Other UK Airports,BELFAST INTERNATIONAL,BOURNEMOUTH,0,0,0,52,0,52,
28/02/2008 17:39,2007,2006,Other UK Airports,BELFAST INTERNATIONAL,BRISTOL,234322,234322,0,242941,242941,0,-3.54777503
28/02/2008 17:39,2007,2006,Other UK Airports,BELFAST INTERNATIONAL,CARDIFF WALES,93543,93469,74,63791,63697,94,46.63980865
28/02/2008 17:39,2007,2006,Other UK Airports,BELFAST INTERNATIONAL,DONCASTER SHEFFIELD,57,0,57,0,0,0,
28/02/2008 17:39,2007,2006,Other UK Airports,BELFAST INTERNATIONAL,EDINBURGH,295704,295517,187,314353,314247,106,-5.932502747
28/02/2008 17:39,2007,2006,Other UK Airports,BELFAST INTERNATIONAL,EXETER,0,0,0,53,0,53,
28/02/2008 17:39,2007,2006,Other UK Airports,BELFAST INTERNATIONAL,GLASGOW,293100,293072,28,310003,310003,0,-5.452528
28/02/2008 17:39,2007,2006,Other UK Airports,BELFAST INTERNATIONAL,GUERNSEY,211,0,211,0,0,0,
28/02/2008 17:39,2007,2006,Other UK Airports,BELFAST INTERNATIONAL,INVERNESS,0,0,0,39801,39801,0,
28/02/2008 17:39,2007,2006,Other UK Airports,BELFAST INTERNATIONAL,ISLE OF MAN,10642,10642,0,4959,4959,0,114.5997162
28/02/2008 17:39,2007,2006,Other UK Airports,BELFAST INTERNATIONAL,JERSEY,797,0,797,889,0,889,-10.34870625
28/02/2008 17:39,2007,2006,Other UK Airports,BELFAST INTERNATIONAL,LEEDS BRADFORD,107192,107192,0,112134,112134,0,-4.407227039
28/02/2008 17:39,2007,2006,Other UK Airports,BELFAST INTERNATIONAL,LIVERPOOL,459910,459910,0,475256,475256,0,-3.228996515
28/02/2008 17:39,2007,2006,Other UK Airports,BELFAST INTERNATIONAL,MANCHESTER,196006,196006,0,179718,179718,0,9.063087463
28/02/2008 17:39,2007,2006,Other UK Airports,BELFAST INTERNATIONAL,NEWCASTLE,224565,224565,0,230438,230438,0,-2.548624754
28/02/2008 17:39,2007,2006,Other UK Airports,BELFAST INTERNATIONAL,NORWICH,7,0,7,0,0,0,
28/02/2008 17:39,2007,2006,Other UK Airports,BELFAST INTERNATIONAL,NOTTINGHAM EAST MIDLANDS INT'L,159902,159902,0,165989,165989,0,-3.667110443
28/02/2008 17:39,2007,2006,Other UK Airports,BENBECULA,GLASGOW,24286,24286,0,22582,22582,0,7.545833111
28/02/2008 17:39,2007,2006,Other UK Airports,BENBECULA,INVERNESS,1404,1404,0,1071,1071,0,31.09243774
28/02/2008 17:39,2007,2006,Other UK Airports,BENBECULA,STORNOWAY,8249,8249,0,8698,8698,0,-5.162106037
28/02/2008 17:39,2007,2006,Other UK Airports,BIGGIN HILL,EDINBURGH,0,0,0,12,0,12,
28/02/2008 17:39,2007,2006,Other UK Airports,BIGGIN HILL,INVERNESS,256,0,256,12,0,12,2033.333374
28/02/2008 17:39,2007,2006,Other UK Airports,BIGGIN HILL,ISLE OF MAN,77,0,77,37,0,37,108.1081085
28/02/2008 17:39,2007,2006,Other UK Airports,BIGGIN HILL,WICK,65,0,65,100,0,100,-35
28/02/2008 17:39,2007,2006,Other UK Airports,BIRMINGHAM,DUNDEE,9017,9017,0,0,0,0,
28/02/2008 17:39,2007,2006,Other UK Airports,BIRMINGHAM,EDINBURGH,435275,435275,0,495309,494741,568,-12.12051487
28/02/2008 17:39,2007,2006,Other UK Airports,BIRMINGHAM,GLASGOW,347002,346656,346,326470,325912,558,6.289092541
28/02/2008 17:39,2007,2006,Other UK Airports,BIRMINGHAM,GUERNSEY,30384,30281,103,47086,47086,0,-35.47126389
28/02/2008 17:39,2007,2006,Other UK Airports,BIRMINGHAM,INVERNESS,15092,15092,0,18216,18107,109,-17.14975929
28/02/2008 17:39,2007,2006,Other UK Airports,BIRMINGHAM,ISLE OF MAN,53165,53165,0,56072,56072,0,-5.184405804
28/02/2008 17:39,2007,2006,Other UK Airports,BIRMINGHAM,JERSEY,60792,60534,258,37930,37822,108,60.274189
28/02/2008 17:39,2007,2006,Other UK Airports,BIRMINGHAM,KINLOSS,0,0,0,109,0,109,
28/02/2008 17:39,2007,2006,Other UK Airports,BIRMINGHAM,NEWCASTLE,24169,24169,0,25189,25189,0,-4.049386501
28/02/2008 17:39,2007,2006,Other UK Airports,BIRMINGHAM,SOUTHAMPTON,0,0,0,40,40,0,
28/02/2008 17:39,2007,2006,Other UK Airports,BLACKPOOL,ISLE OF MAN,21472,21472,0,17134,16988,146,25.3180809
28/02/2008 17:39,2007,2006,Other UK Airports,BLACKPOOL,JERSEY,30,0,30,105,0,105,-71.42857361
28/02/2008 17:39,2007,2006,Other UK Airports,BLACKPOOL,NEWCASTLE,177,0,177,0,0,0,
28/02/2008 17:39,2007,2006,Other UK Airports,BLACKPOOL,SOUTH MARSTON,0,0,0,23,0,23,
28/02/2008 17:39,2007,2006,Other UK Airports,BLACKPOOL,SOUTHAMPTON,30,0,30,0,0,0,
28/02/2008 17:39,2007,2006,Other UK Airports,BOURNEMOUTH,BRISTOL,57,0,57,0,0,0,
28/02/2008 17:39,2007,2006,Other UK Airports,BOURNEMOUTH,GUERNSEY,2072,2072,0,1440,1209,231,43.88888931
28/02/2008 17:39,2007,2006,Other UK Airports,BOURNEMOUTH,INVERNESS,154,0,154,0,0,0,
28/02/2008 17:39,2007,2006,Other UK Airports,BOURNEMOUTH,ISLE OF MAN,248,0,248,258,0,258,-3.875968933
28/02/2008 17:39,2007,2006,Other UK Airports,BOURNEMOUTH,JERSEY,6918,3811,3107,7134,4675,2459,-3.027754307
28/02/2008 17:39,2007,2006,Other UK Airports,BOURNEMOUTH,LIVERPOOL,0,0,0,78,0,78,
28/02/2008 17:39,2007,2006,Other UK Airports,BOURNEMOUTH,MANCHESTER,35,0,35,0,0,0,
28/02/2008 17:39,2007,2006,Other UK Airports,BOURNEMOUTH,PRESTWICK,94118,94118,0,93294,93294,0,0.883229375
28/02/2008 17:39,2007,2006,Other UK Airports,BRISTOL,CARDIFF WALES,19,18,1,0,0,0,
28/02/2008 17:39,2007,2006,Other UK Airports,BRISTOL,CITY OF DERRY (EGLINTON),7190,7190,0,0,0,0,
28/02/2008 17:39,2007,2006,Other UK Airports,BRISTOL,DUNDEE,0,0,0,2,2,0,
28/02/2008 17:39,2007,2006,Other UK Airports,BRISTOL,DURHAM TEES VALLEY,37,0,37,3288,3288,0,-98.87469482
28/02/2008 17:39,2007,2006,Other UK Airports,BRISTOL,EDINBURGH,260591,260591,0,318169,318169,0,-18.09667206
28/02/2008 17:39,2007,2006,Other UK Airports,BRISTOL,GLASGOW,243065,243065,0,279870,279870,0,-13.15074825
28/02/2008 17:39,2007,2006,Other UK Airports,BRISTOL,GUERNSEY,30952,30952,0,28783,28783,0,7.535697937
28/02/2008 17:39,2007,2006,Other UK Airports,BRISTOL,HUMBERSIDE,87,0,87,0,0,0,
28/02/2008 17:39,2007,2006,Other UK Airports,BRISTOL,INVERNESS,82123,82123,0,82487,82487,0,-0.441281646
28/02/2008 17:39,2007,2006,Other UK Airports,BRISTOL,ISLE OF MAN,10680,10680,0,11577,11577,0,-7.748121262
28/02/2008 17:39,2007,2006,Other UK Airports,BRISTOL,ISLES OF SCILLY (ST.MARYS),4510,4510,0,4673,4673,0,-3.488123178
28/02/2008 17:39,2007,2006,Other UK Airports,BRISTOL,JERSEY,39729,39536,193,42418,42418,0,-6.339290142
28/02/2008 17:39,2007,2006,Other UK Airports,BRISTOL,LANDS END (ST JUST),27,27,0,0,0,0,
28/02/2008 17:39,2007,2006,Other UK Airports,BRISTOL,LEEDS BRADFORD,36910,36910,0,33449,33449,0,10.34709549
28/02/2008 17:39,2007,2006,Other UK Airports,BRISTOL,MANCHESTER,32483,32483,0,33006,33006,0,-1.584560394
28/02/2008 17:39,2007,2006,Other UK Airports,BRISTOL,NEWCASTLE,246808,246764,44,246253,246253,0,0.225377962
28/02/2008 17:39,2007,2006,Other UK Airports,BRISTOL,NEWQUAY,14867,14867,0,8619,8619,0,72.49100494
28/02/2008 17:39,2007,2006,Other UK Airports,BRISTOL,NORWICH,450,450,0,13043,13043,0,-96.54987335
28/02/2008 17:39,2007,2006,Other UK Airports,BRISTOL,PLYMOUTH,6653,6653,0,7951,7951,0,-16.32499123
28/02/2008 17:39,2007,2006,Other UK Airports,BRISTOL,PRESTWICK,0,0,0,22,0,22,
28/02/2008 17:39,2007,2006,Other UK Airports,BRISTOL,WICK,0,0,0,7,0,7,
28/02/2008 17:39,2007,2006,Other UK Airports,CAMBRIDGE,NEWQUAY,80,0,80,0,0,0,
28/02/2008 17:39,2007,2006,Other UK Airports,CAMBRIDGE,PLYMOUTH,100,0,100,0,0,0,
28/02/2008 17:39,2007,2006,Other UK Airports,CAMPBELTOWN,GLASGOW,8643,8643,0,8773,8773,0,-1.481819272
28/02/2008 17:39,2007,2006,Other UK Airports,CAMPBELTOWN,ISLAY,69,69,0,132,132,0,-47.72727203
28/02/2008 17:39,2007,2006,Other UK Airports,CAMPBELTOWN,MANCHESTER,164,0,164,0,0,0,
28/02/2008 17:39,2007,2006,Other UK Airports,CARDIFF WALES,DURHAM TEES VALLEY,38,0,38,0,0,0,
28/02/2008 17:39,2007,2006,Other UK Airports,CARDIFF WALES,EDINBURGH,158142,153053,5089,156332,156272,60,1.157792449
28/02/2008 17:39,2007,2006,Other UK Airports,CARDIFF WALES,GLASGOW,76948,76915,33,82460,82342,118,-6.684453011
28/02/2008 17:39,2007,2006,Other UK Airports,CARDIFF WALES,GUERNSEY,190,169,21,27,27,0,603.7036743
28/02/2008 17:39,2007,2006,Other UK Airports,CARDIFF WALES,HUMBERSIDE,80,0,80,0,0,0,
28/02/2008 17:39,2007,2006,Other UK Airports,CARDIFF WALES,JERSEY,34544,34544,0,16170,16070,100,113.6301804
28/02/2008 17:39,2007,2006,Other UK Airports,CARDIFF WALES,LIVERPOOL,93,0,93,371,0,371,-74.93261719
28/02/2008 17:39,2007,2006,Other UK Airports,CARDIFF WALES,MANCHESTER,6719,6719,0,12757,11869,888,-47.3308754
28/02/2008 17:39,2007,2006,Other UK Airports,CARDIFF WALES,NEWCASTLE,16110,16110,0,19112,19112,0,-15.70740891
28/02/2008 17:39,2007,2006,Other UK Airports,CARDIFF WALES,NEWQUAY,4345,4345,0,8095,8095,0,-46.32489014
28/02/2008 17:39,2007,2006,Other UK Airports,CARDIFF WALES,NORWICH,92,0,92,97,0,97,-5.154639244
28/02/2008 17:39,2007,2006,Other UK Airports,CARDIFF WALES,PLYMOUTH,0,0,0,190,190,0,
28/02/2008 17:39,2007,2006,Other UK Airports,CARDIFF WALES,PRESTWICK,0,0,0,4873,4848,25,
28/02/2008 17:39,2007,2006,Other UK Airports,CARDIFF WALES,VALLEY,8553,8553,0,0,0,0,
28/02/2008 17:39,2007,2006,Other UK Airports,CITY OF DERRY (EGLINTON),EDINBURGH,0,0,0,102,0,102,
28/02/2008 17:39,2007,2006,Other UK Airports,CITY OF DERRY (EGLINTON),GLASGOW,11949,11949,0,15858,15858,0,-24.65001869
28/02/2008 17:39,2007,2006,Other UK Airports,CITY OF DERRY (EGLINTON),LIVERPOOL,81699,81699,0,69533,69533,0,17.4967289
28/02/2008 17:39,2007,2006,Other UK Airports,CITY OF DERRY (EGLINTON),MANCHESTER,0,0,0,287,287,0,
28/02/2008 17:39,2007,2006,Other UK Airports,CITY OF DERRY (EGLINTON),NOTTINGHAM EAST MIDLANDS INT'L,68504,68504,0,51008,51008,0,34.30050278
28/02/2008 17:39,2007,2006,Other UK Airports,CITY OF DERRY (EGLINTON),PRESTWICK,58563,58563,0,2783,2783,0,2004.31189
28/02/2008 17:39,2007,2006,Other UK Airports,CITY OF DERRY (EGLINTON),STORNOWAY,0,0,0,95,0,95,
28/02/2008 17:39,2007,2006,Other UK Airports,COVENTRY,DONCASTER SHEFFIELD,0,0,0,130,130,0,
28/02/2008 17:39,2007,2006,Other UK Airports,COVENTRY,GUERNSEY,79,0,79,0,0,0,
28/02/2008 17:39,2007,2006,Other UK Airports,COVENTRY,ISLE OF MAN,0,0,0,44,0,44,
28/02/2008 17:39,2007,2006,Other UK Airports,COVENTRY,JERSEY,58954,58954,0,60071,60071,0,-1.859466314
28/02/2008 17:39,2007,2006,Other UK Airports,COVENTRY,NEWCASTLE,0,0,0,42,0,42,
28/02/2008 17:39,2007,2006,Other UK Airports,DONCASTER SHEFFIELD,EDINBURGH,73,0,73,0,0,0,
28/02/2008 17:39,2007,2006,Other UK Airports,DONCASTER SHEFFIELD,FARNBOROUGH,0,0,0,70,0,70,
28/02/2008 17:39,2007,2006,Other UK Airports,DONCASTER SHEFFIELD,GLASGOW,0,0,0,125,0,125,
28/02/2008 17:39,2007,2006,Other UK Airports,DONCASTER SHEFFIELD,JERSEY,63411,63411,0,59780,59780,0,6.073937893
28/02/2008 17:39,2007,2006,Other UK Airports,DONCASTER SHEFFIELD,NORWICH,70,0,70,0,0,0,
28/02/2008 17:39,2007,2006,Other UK Airports,DONCASTER SHEFFIELD,PLYMOUTH,178,0,178,0,0,0,
28/02/2008 17:39,2007,2006,Other UK Airports,DONCASTER SHEFFIELD,SOUTHAMPTON,69,0,69,45,45,0,53.33333206
28/02/2008 17:39,2007,2006,Other UK Airports,DUNDEE,EDINBURGH,0,0,0,4,0,4,
28/02/2008 17:39,2007,2006,Other UK Airports,DUNDEE,GUERNSEY,1750,0,1750,1007,0,1007,73.78351593
28/02/2008 17:39,2007,2006,Other UK Airports,DUNDEE,HUMBERSIDE,0,0,0,16,16,0,
28/02/2008 17:39,2007,2006,Other UK Airports,DUNDEE,JERSEY,79,0,79,625,0,625,-87.36000061
28/02/2008 17:39,2007,2006,Other UK Airports,DUNDEE,MANCHESTER,0,0,0,14,14,0,
28/02/2008 17:39,2007,2006,Other UK Airports,DUNKESWELL,JERSEY,1,0,1,1,0,1,0
28/02/2008 17:39,2007,2006,Other UK Airports,DURHAM TEES VALLEY,EXETER,70,0,70,0,0,0,
28/02/2008 17:39,2007,2006,Other UK Airports,DURHAM TEES VALLEY,FAIRFORD,0,0,0,96,0,96,
28/02/2008 17:39,2007,2006,Other UK Airports,DURHAM TEES VALLEY,FARNBOROUGH,65,0,65,0,0,0,
28/02/2008 17:39,2007,2006,Other UK Airports,DURHAM TEES VALLEY,GLASGOW,329,0,329,243,0,243,35.39094543
28/02/2008 17:39,2007,2006,Other UK Airports,DURHAM TEES VALLEY,JERSEY,3320,3320,0,22751,22751,0,-85.40723419
28/02/2008 17:39,2007,2006,Other UK Airports,DURHAM TEES VALLEY,LEEDS BRADFORD,169,0,169,0,0,0,
28/02/2008 17:39,2007,2006,Other UK Airports,DURHAM TEES VALLEY,LIVERPOOL,17,0,17,0,0,0,
28/02/2008 17:39,2007,2006,Other UK Airports,DURHAM TEES VALLEY,NEWQUAY,0,0,0,24019,24019,0,
28/02/2008 17:39,2007,2006,Other UK Airports,DURHAM TEES VALLEY,PLYMOUTH,0,0,0,98,0,98,
28/02/2008 17:39,2007,2006,Other UK Airports,DURHAM TEES VALLEY,SOUTHAMPTON,57,0,57,0,0,0,
28/02/2008 17:39,2007,2006,Other UK Airports,DURHAM TEES VALLEY,WICK,0,0,0,1,0,1,
28/02/2008 17:39,2007,2006,Other UK Airports,DUXFORD,JERSEY,42,0,42,0,0,0,
28/02/2008 17:39,2007,2006,Other UK Airports,EDAY,KIRKWALL,454,454,0,471,471,0,-3.60934186
28/02/2008 17:39,2007,2006,Other UK Airports,EDINBURGH,EXETER,67739,67672,67,82910,82910,0,-18.29815483
28/02/2008 17:39,2007,2006,Other UK Airports,EDINBURGH,FARNBOROUGH,0,0,0,16,0,16,
28/02/2008 17:39,2007,2006,Other UK Airports,EDINBURGH,INVERNESS,10513,10513,0,15315,15315,0,-31.35488129
28/02/2008 17:39,2007,2006,Other UK Airports,EDINBURGH,ISLE OF MAN,11909,11737,172,5971,5971,0,99.44732666
28/02/2008 17:39,2007,2006,Other UK Airports,EDINBURGH,JERSEY,31055,31055,0,26549,25694,855,16.97239113
28/02/2008 17:39,2007,2006,Other UK Airports,EDINBURGH,KIRKWALL,29229,29229,0,23226,23226,0,25.846035
28/02/2008 17:39,2007,2006,Other UK Airports,EDINBURGH,LEEDS BRADFORD,51313,51313,0,50771,50771,0,1.0675385
28/02/2008 17:39,2007,2006,Other UK Airports,EDINBURGH,MANCHESTER,237836,237836,0,257595,257595,0,-7.670567989
28/02/2008 17:39,2007,2006,Other UK Airports,EDINBURGH,NEWQUAY,20353,20353,0,5443,5443,0,273.9298096
28/02/2008 17:39,2007,2006,Other UK Airports,EDINBURGH,NORWICH,57314,57277,37,64043,64043,0,-10.50700283
28/02/2008 17:39,2007,2006,Other UK Airports,EDINBURGH,NOTTINGHAM EAST MIDLANDS INT'L,169840,169840,0,175810,175002,808,-3.395711184
28/02/2008 17:39,2007,2006,Other UK Airports,EDINBURGH,SOUTHAMPTON,208074,208074,0,237463,237463,0,-12.37624359
28/02/2008 17:39,2007,2006,Other UK Airports,EDINBURGH,STORNOWAY,25249,25249,0,27136,27136,0,-6.95386219
28/02/2008 17:39,2007,2006,Other UK Airports,EDINBURGH,SUMBURGH,26749,26749,0,23297,23297,0,14.81735802
28/02/2008 17:39,2007,2006,Other UK Airports,EDINBURGH,WICK,6066,5976,90,4761,4761,0,27.41020775
28/02/2008 17:39,2007,2006,Other UK Airports,EXETER,GLASGOW,56303,56303,0,53111,53111,0,6.010054588
28/02/2008 17:39,2007,2006,Other UK Airports,EXETER,GUERNSEY,26478,26478,0,27936,27936,0,-5.219072342
28/02/2008 17:39,2007,2006,Other UK Airports,EXETER,ISLES OF SCILLY (ST.MARYS),4014,4014,0,4199,4199,0,-4.405810833
28/02/2008 17:39,2007,2006,Other UK Airports,EXETER,JERSEY,33135,33135,0,34554,34554,0,-4.106615543
28/02/2008 17:39,2007,2006,Other UK Airports,EXETER,LEEDS BRADFORD,23790,23790,0,33797,33797,0,-29.60913658
28/02/2008 17:39,2007,2006,Other UK Airports,EXETER,LIVERPOOL,0,0,0,1356,1356,0,
28/02/2008 17:39,2007,2006,Other UK Airports,EXETER,MANCHESTER,53942,53942,0,49499,49499,0,8.975938797
28/02/2008 17:39,2007,2006,Other UK Airports,EXETER,NEWCASTLE,56150,56150,0,54249,54249,0,3.504212141
28/02/2008 17:39,2007,2006,Other UK Airports,EXETER,NORWICH,29719,29719,0,19985,19924,61,48.70653152
28/02/2008 17:39,2007,2006,Other UK Airports,FAIR ISLE,KIRKWALL,43,43,0,0,0,0,
28/02/2008 17:39,2007,2006,Other UK Airports,FAIR ISLE,LERWICK (TINGWALL),2728,2728,0,2327,2327,0,17.23248863
28/02/2008 17:39,2007,2006,Other UK Airports,FAIR ISLE,SUMBURGH,139,139,0,94,94,0,47.87234116
28/02/2008 17:39,2007,2006,Other UK Airports,FARNBOROUGH,GLASGOW,43,0,43,67,0,67,-35.82089615
28/02/2008 17:39,2007,2006,Other UK Airports,FARNBOROUGH,HUMBERSIDE,52,0,52,0,0,0,
28/02/2008 17:39,2007,2006,Other UK Airports,FARNBOROUGH,INVERNESS,0,0,0,47,0,47,
28/02/2008 17:39,2007,2006,Other UK Airports,FARNBOROUGH,ISLE OF MAN,34,0,34,0,0,0,
28/02/2008 17:39,2007,2006,Other UK Airports,FARNBOROUGH,LIVERPOOL,0,0,0,110,0,110,
28/02/2008 17:39,2007,2006,Other UK Airports,FARNBOROUGH,MANCHESTER,61,0,61,53,0,53,15.09433937
28/02/2008 17:39,2007,2006,Other UK Airports,FARNBOROUGH,NEWCASTLE,41,0,41,67,0,67,-38.80596924
28/02/2008 17:39,2007,2006,Other UK Airports,FOULA,LERWICK (TINGWALL),1407,1407,0,1342,1342,0,4.843517303
28/02/2008 17:39,2007,2006,Other UK Airports,GLASGOW,GUERNSEY,36,0,36,0,0,0,
28/02/2008 17:39,2007,2006,Other UK Airports,GLASGOW,INVERNESS,84,0,84,1943,1897,46,-95.67678833
28/02/2008 17:39,2007,2006,Other UK Airports,GLASGOW,ISLAY,28443,28443,0,26073,25993,80,9.089862823
28/02/2008 17:39,2007,2006,Other UK Airports,GLASGOW,ISLE OF MAN,18455,18455,0,21840,21840,0,-15.49908447
28/02/2008 17:39,2007,2006,Other UK Airports,GLASGOW,JERSEY,6348,6191,157,7449,6546,903,-14.78050709
28/02/2008 17:39,2007,2006,Other UK Airports,GLASGOW,KIRKWALL,15466,15466,0,11649,11649,0,32.76676178
28/02/2008 17:39,2007,2006,Other UK Airports,GLASGOW,LEEDS BRADFORD,38690,38590,100,40959,40959,0,-5.539686203
28/02/2008 17:39,2007,2006,Other UK Airports,GLASGOW,MANCHESTER,167160,166886,274,171150,170375,775,-2.331288338
28/02/2008 17:39,2007,2006,Other UK Airports,GLASGOW,NEWCASTLE,0,0,0,13,13,0,
28/02/2008 17:39,2007,2006,Other UK Airports,GLASGOW,NORWICH,25872,25872,0,30012,30012,0,-13.79448223
28/02/2008 17:39,2007,2006,Other UK Airports,GLASGOW,NOTTINGHAM EAST MIDLANDS INT'L,172637,172597,40,184030,184030,0,-6.190838337
28/02/2008 17:39,2007,2006,Other UK Airports,GLASGOW,PRESTWICK,0,0,0,23,23,0,
28/02/2008 17:39,2007,2006,Other UK Airports,GLASGOW,SOUTHAMPTON,166454,166454,0,202642,202597,45,-17.85809517
28/02/2008 17:39,2007,2006,Other UK Airports,GLASGOW,STORNOWAY,53790,53790,0,50238,50238,0,7.070344925
28/02/2008 17:39,2007,2006,Other UK Airports,GLASGOW,SUMBURGH,16489,16489,0,15104,15104,0,9.169755936
28/02/2008 17:39,2007,2006,Other UK Airports,GLASGOW,TIREE,7417,7417,0,7015,7015,0,5.730577469
28/02/2008 17:39,2007,2006,Other UK Airports,GLASGOW,WICK,0,0,0,46,0,46,
28/02/2008 17:39,2007,2006,Other UK Airports,GLOUCESTERSHIRE,ISLE OF MAN,4610,4610,0,0,0,0,
28/02/2008 17:39,2007,2006,Other UK Airports,GLOUCESTERSHIRE,JERSEY,590,590,0,0,0,0,
28/02/2008 17:39,2007,2006,Other UK Airports,GUERNSEY,ISLE OF MAN,3196,3196,0,1737,1737,0,83.99539185
28/02/2008 17:39,2007,2006,Other UK Airports,GUERNSEY,JERSEY,138091,137956,135,128738,128706,32,7.265143394
28/02/2008 17:39,2007,2006,Other UK Airports,GUERNSEY,MANCHESTER,76663,76663,0,65657,65657,0,16.7628746
28/02/2008 17:39,2007,2006,Other UK Airports,GUERNSEY,NEWQUAY,0,0,0,108,0,108,
28/02/2008 17:39,2007,2006,Other UK Airports,GUERNSEY,NORWICH,6774,6774,0,8731,8731,0,-22.41438484
28/02/2008 17:39,2007,2006,Other UK Airports,GUERNSEY,SHOREHAM,0,0,0,731,731,0,
28/02/2008 17:39,2007,2006,Other UK Airports,GUERNSEY,SOUTHAMPTON,125943,125943,0,124705,124705,0,0.992742896
28/02/2008 17:39,2007,2006,Other UK Airports,HUMBERSIDE,INVERNESS,100,0,100,0,0,0,
28/02/2008 17:39,2007,2006,Other UK Airports,HUMBERSIDE,ISLE OF MAN,182,0,182,0,0,0,
28/02/2008 17:39,2007,2006,Other UK Airports,HUMBERSIDE,JERSEY,1387,0,1387,1607,0,1607,-13.69010544
28/02/2008 17:39,2007,2006,Other UK Airports,HUMBERSIDE,KENT INTERNATIONAL,2,0,2,0,0,0,
28/02/2008 17:39,2007,2006,Other UK Airports,HUMBERSIDE,NORWICH,43,0,43,16,0,16,168.75
28/02/2008 17:39,2007,2006,Other UK Airports,HUMBERSIDE,PLYMOUTH,97,0,97,0,0,0,
28/02/2008 17:39,2007,2006,Other UK Airports,HUMBERSIDE,SOUTHAMPTON,0,0,0,210,0,210,
28/02/2008 17:39,2007,2006,Other UK Airports,INVERNESS,ISLE OF MAN,13,0,13,0,0,0,
28/02/2008 17:39,2007,2006,Other UK Airports,INVERNESS,KIRKWALL,25867,25867,0,22014,22014,0,17.50249863
28/02/2008 17:39,2007,2006,Other UK Airports,INVERNESS,LEEDS BRADFORD,2352,2231,121,4685,4685,0,-49.79722595
28/02/2008 17:39,2007,2006,Other UK Airports,INVERNESS,LIVERPOOL,43760,43760,0,14464,14464,0,202.5442505
28/02/2008 17:39,2007,2006,Other UK Airports,INVERNESS,MANCHESTER,16719,16719,0,20630,20630,0,-18.95782852
28/02/2008 17:39,2007,2006,Other UK Airports,INVERNESS,NEWCASTLE,36,0,36,1137,916,221,-96.83377075
28/02/2008 17:39,2007,2006,Other UK Airports,INVERNESS,NOTTINGHAM EAST MIDLANDS INT'L,33514,33514,0,0,0,0,
28/02/2008 17:39,2007,2006,Other UK Airports,INVERNESS,SOUTH MARSTON,12,0,12,0,0,0,
28/02/2008 17:39,2007,2006,Other UK Airports,INVERNESS,SOUTHAMPTON,3330,3330,0,0,0,0,
28/02/2008 17:39,2007,2006,Other UK Airports,INVERNESS,STORNOWAY,36403,36403,0,32385,32385,0,12.40697861
28/02/2008 17:39,2007,2006,Other UK Airports,INVERNESS,SUMBURGH,80,80,0,158,158,0,-49.36708832
28/02/2008 17:39,2007,2006,Other UK Airports,ISLE OF MAN,JERSEY,5252,5252,0,2242,2242,0,134.255127
28/02/2008 17:39,2007,2006,Other UK Airports,ISLE OF MAN,LEEDS BRADFORD,9771,9771,0,1460,1460,0,569.246582
28/02/2008 17:39,2007,2006,Other UK Airports,ISLE OF MAN,LIVERPOOL,141924,141924,0,169755,169755,0,-16.394804
28/02/2008 17:39,2007,2006,Other UK Airports,ISLE OF MAN,LYDD,0,0,0,100,100,0,
28/02/2008 17:39,2007,2006,Other UK Airports,ISLE OF MAN,MANCHESTER,148703,148703,0,166570,166570,0,-10.72642136
28/02/2008 17:39,2007,2006,Other UK Airports,ISLE OF MAN,NEWCASTLE,6876,6876,0,7084,7084,0,-2.936194181
28/02/2008 17:39,2007,2006,Other UK Airports,ISLE OF MAN,NEWQUAY,0,0,0,100,0,100,
28/02/2008 17:39,2007,2006,Other UK Airports,ISLE OF MAN,SOUTHAMPTON,18337,18337,0,8284,8284,0,121.3544159
28/02/2008 17:39,2007,2006,Other UK Airports,ISLES OF SCILLY (ST.MARYS),NEWQUAY,16586,16586,0,16324,16324,0,1.604998827
28/02/2008 17:39,2007,2006,Other UK Airports,ISLES OF SCILLY (ST.MARYS),SOUTHAMPTON,3110,3110,0,2544,2544,0,22.24842834
28/02/2008 17:39,2007,2006,Other UK Airports,JERSEY,LEEDS BRADFORD,1646,0,1646,1815,180,1635,-9.311294556
28/02/2008 17:39,2007,2006,Other UK Airports,JERSEY,LIVERPOOL,2724,2724,0,4320,4320,0,-36.94444275
28/02/2008 17:39,2007,2006,Other UK Airports,JERSEY,MANCHESTER,117666,115131,2535,113557,107690,5867,3.618447065
28/02/2008 17:39,2007,2006,Other UK Airports,JERSEY,NEWCASTLE,4537,4464,73,3212,3212,0,41.2515564
28/02/2008 17:39,2007,2006,Other UK Airports,JERSEY,NORWICH,17048,17039,9,18357,18357,0,-7.130795002
28/02/2008 17:39,2007,2006,Other UK Airports,JERSEY,NOTTINGHAM EAST MIDLANDS INT'L,57476,57476,0,69210,68350,860,-16.95419693
28/02/2008 17:39,2007,2006,Other UK Airports,JERSEY,PLYMOUTH,17035,17035,0,17925,17925,0,-4.965132713
28/02/2008 17:39,2007,2006,Other UK Airports,JERSEY,SOUTHAMPTON,141714,141600,114,150752,150628,124,-5.995276928
28/02/2008 17:39,2007,2006,Other UK Airports,KENT INTERNATIONAL,PRESTWICK,69,0,69,0,0,0,
28/02/2008 17:39,2007,2006,Other UK Airports,KIRKWALL,NORTH RONALDSAY,6807,6807,0,5846,5846,0,16.438591
28/02/2008 17:39,2007,2006,Other UK Airports,KIRKWALL,PAPA WESTRAY,4113,4113,0,3835,3835,0,7.249022007
28/02/2008 17:39,2007,2006,Other UK Airports,KIRKWALL,SANDAY,3188,3188,0,2733,2733,0,16.64837265
28/02/2008 17:39,2007,2006,Other UK Airports,KIRKWALL,STRONSAY,2976,2976,0,2907,2907,0,2.373580933
28/02/2008 17:39,2007,2006,Other UK Airports,KIRKWALL,SUMBURGH,8998,8998,0,7045,7045,0,27.72178841
28/02/2008 17:39,2007,2006,Other UK Airports,KIRKWALL,WESTRAY,3551,3551,0,3210,3210,0,10.6230526
28/02/2008 17:39,2007,2006,Other UK Airports,KIRKWALL,WICK,2190,2190,0,4962,4962,0,-55.86457062
28/02/2008 17:39,2007,2006,Other UK Airports,LANDS END (ST JUST),NEWQUAY,0,0,0,107,107,0,
28/02/2008 17:39,2007,2006,Other UK Airports,LEEDS BRADFORD,NEWQUAY,30718,30718,0,27415,27415,0,12.04814911
28/02/2008 17:39,2007,2006,Other UK Airports,LEEDS BRADFORD,PLYMOUTH,2888,2888,0,10875,10875,0,-73.44367981
28/02/2008 17:39,2007,2006,Other UK Airports,LEEDS BRADFORD,SOUTHAMPTON,85842,85811,31,77787,77787,0,10.35520077
28/02/2008 17:39,2007,2006,Other UK Airports,LEEDS BRADFORD,WICK,72,0,72,0,0,0,
28/02/2008 17:39,2007,2006,Other UK Airports,LERWICK (TINGWALL),OUT SKERRIES,694,694,0,486,486,0,42.7983551
28/02/2008 17:39,2007,2006,Other UK Airports,LERWICK (TINGWALL),PAPA STOUR,155,155,0,225,225,0,-31.11111069
28/02/2008 17:39,2007,2006,Other UK Airports,LIVERPOOL,MANCHESTER,0,0,0,338,128,210,
28/02/2008 17:39,2007,2006,Other UK Airports,LIVERPOOL,SOUTHAMPTON,14270,14132,138,33158,33128,30,-56.96362686
28/02/2008 17:39,2007,2006,Other UK Airports,LYDD,NEWQUAY,86,0,86,0,0,0,
28/02/2008 17:39,2007,2006,Other UK Airports,MANCHESTER,NEWCASTLE,185,0,185,21,0,21,780.9523926
28/02/2008 17:39,2007,2006,Other UK Airports,MANCHESTER,NEWQUAY,58566,58566,0,65000,64961,39,-9.898461342
28/02/2008 17:39,2007,2006,Other UK Airports,MANCHESTER,NORWICH,47043,47043,0,39142,39142,0,20.18547821
28/02/2008 17:39,2007,2006,Other UK Airports,MANCHESTER,NOTTINGHAM EAST MIDLANDS INT'L,0,0,0,84,84,0,
28/02/2008 17:39,2007,2006,Other UK Airports,MANCHESTER,PLYMOUTH,36835,36835,0,26915,26915,0,36.85676956
28/02/2008 17:39,2007,2006,Other UK Airports,MANCHESTER,SOUTHAMPTON,161457,161108,349,199407,199141,266,-19.03142738
28/02/2008 17:39,2007,2006,Other UK Airports,MANCHESTER,WICK,0,0,0,63,0,63,
28/02/2008 17:39,2007,2006,Other UK Airports,NEWCASTLE,PLYMOUTH,0,0,0,1725,1725,0,
28/02/2008 17:39,2007,2006,Other UK Airports,NEWCASTLE,SOUTHAMPTON,119527,119527,0,123378,123336,42,-3.121302128
28/02/2008 17:39,2007,2006,Other UK Airports,NEWQUAY,PLYMOUTH,4740,4740,0,18432,18432,0,-74.28385162
28/02/2008 17:39,2007,2006,Other UK Airports,NORWICH,PLYMOUTH,309,0,309,0,0,0,
28/02/2008 17:39,2007,2006,Other UK Airports,NOTTINGHAM EAST MIDLANDS INT'L,SOUTHAMPTON,98,0,98,26,0,26,276.9230652
28/02/2008 17:39,2007,2006,Other UK Airports,SCATSTA,WOODVALE,48,0,48,0,0,0,
28/02/2008 17:39,2007,2006,Other UK Airports,SOUTH MARSTON,WICK,79,0,79,38,0,38,107.8947372
28/02/2008 17:39,2007,2006,Other UK Airports,SUMBURGH,WICK,0,0,0,3393,3393,0,
