rundate,this_period,last_period,grp_cd,grp_name,apt1_apt_name,apt2_apt_name,total_pax_tp,total_pax_shd_tp,total_pax_cht_tp,total_pax_lp,total_pax_shd_lp,total_pax_cht_lp,total_pax_pc
10/13/2008 13:11,1992,1991,A,London Area Airports,GATWICK,ABERDEEN,159811,159811,0,154046,154046,0,3.742388725
10/13/2008 13:11,1992,1991,A,London Area Airports,GATWICK,ALDERNEY,0,0,0,2,0,2,
10/13/2008 13:11,1992,1991,A,London Area Airports,GATWICK,ANGLESEY (VALLEY),0,0,0,238,0,238,
10/13/2008 13:11,1992,1991,A,London Area Airports,GATWICK,BELFAST INTERNATIONAL,1914,1438,476,20121,19993,128,-90.48754883
10/13/2008 13:11,1992,1991,A,London Area Airports,GATWICK,BIRMINGHAM,0,0,0,3243,2962,281,
10/13/2008 13:11,1992,1991,A,London Area Airports,GATWICK,BOURNEMOUTH,13,0,13,0,0,0,
10/13/2008 13:11,1992,1991,A,London Area Airports,GATWICK,CARDIFF WALES,802,0,802,0,0,0,
10/13/2008 13:11,1992,1991,A,London Area Airports,GATWICK,DURHAM TEES VALLEY,0,0,0,2282,2282,0,
10/13/2008 13:11,1992,1991,A,London Area Airports,GATWICK,EAST MIDLANDS INTERNATIONAL,0,0,0,206,0,206,
10/13/2008 13:11,1992,1991,A,London Area Airports,GATWICK,EDINBURGH,173019,172970,49,181032,180828,204,-4.426289082
10/13/2008 13:11,1992,1991,A,London Area Airports,GATWICK,EXETER,0,0,0,10,10,0,
10/13/2008 13:11,1992,1991,A,London Area Airports,GATWICK,GLASGOW,167441,167435,6,169378,169025,353,-1.143595934
10/13/2008 13:11,1992,1991,A,London Area Airports,GATWICK,GUERNSEY,153383,153278,105,88691,85348,3343,72.94088745
10/13/2008 13:11,1992,1991,A,London Area Airports,GATWICK,HUMBERSIDE,198,0,198,0,0,0,
10/13/2008 13:11,1992,1991,A,London Area Airports,GATWICK,INVERNESS,0,0,0,200,200,0,
10/13/2008 13:11,1992,1991,A,London Area Airports,GATWICK,ISLE OF MAN,33,0,33,0,0,0,
10/13/2008 13:11,1992,1991,A,London Area Airports,GATWICK,JERSEY,238967,235985,2982,140353,139744,609,70.26141357
10/13/2008 13:11,1992,1991,A,London Area Airports,GATWICK,LUTON,11,0,11,94,0,94,-88.29787445
10/13/2008 13:11,1992,1991,A,London Area Airports,GATWICK,MANCHESTER,186951,185691,1260,165627,164599,1028,12.87471199
10/13/2008 13:11,1992,1991,A,London Area Airports,GATWICK,NEWCASTLE,66074,65851,223,81044,81043,1,-18.47144699
10/13/2008 13:11,1992,1991,A,London Area Airports,GATWICK,NEWQUAY,0,0,0,80,0,80,
10/13/2008 13:11,1992,1991,A,London Area Airports,GATWICK,PLYMOUTH,38,0,38,2494,2494,0,-98.47634125
10/13/2008 13:11,1992,1991,A,London Area Airports,GATWICK,PRESTWICK,0,0,0,27,0,27,
10/13/2008 13:11,1992,1991,A,London Area Airports,GATWICK,SOUTHEND,1,0,1,0,0,0,
10/13/2008 13:11,1992,1991,A,London Area Airports,GATWICK,STANSTED,52,0,52,0,0,0,
10/13/2008 13:11,1992,1991,A,London Area Airports,HEATHROW,ABERDEEN,463438,463423,15,437792,437728,64,5.85803318
10/13/2008 13:11,1992,1991,A,London Area Airports,HEATHROW,BELFAST INTERNATIONAL,1173780,1173767,13,1159730,1159730,0,1.211488843
10/13/2008 13:11,1992,1991,A,London Area Airports,HEATHROW,BIRMINGHAM,63609,62944,665,79664,79314,350,-20.1533947
10/13/2008 13:11,1992,1991,A,London Area Airports,HEATHROW,CARDIFF WALES,201,0,201,300,0,300,-33
10/13/2008 13:11,1992,1991,A,London Area Airports,HEATHROW,CARLISLE,0,0,0,116,0,116,
10/13/2008 13:11,1992,1991,A,London Area Airports,HEATHROW,DURHAM TEES VALLEY,172527,172514,13,173551,173477,74,-0.590028286
10/13/2008 13:11,1992,1991,A,London Area Airports,HEATHROW,EAST MIDLANDS INTERNATIONAL,56875,56201,674,66227,65900,327,-14.12112904
10/13/2008 13:11,1992,1991,A,London Area Airports,HEATHROW,EDINBURGH,1307585,1307585,0,1277693,1277614,79,2.339529037
10/13/2008 13:11,1992,1991,A,London Area Airports,HEATHROW,EXETER,0,0,0,98,0,98,
10/13/2008 13:11,1992,1991,A,London Area Airports,HEATHROW,GLASGOW,1301662,1301468,194,1277221,1277117,104,1.913607717
10/13/2008 13:11,1992,1991,A,London Area Airports,HEATHROW,GUERNSEY,75975,75966,9,98783,98783,0,-23.08899307
10/13/2008 13:11,1992,1991,A,London Area Airports,HEATHROW,HUMBERSIDE,201,0,201,0,0,0,
10/13/2008 13:11,1992,1991,A,London Area Airports,HEATHROW,INVERNESS,151914,151861,53,147697,147697,0,2.855169773
10/13/2008 13:11,1992,1991,A,London Area Airports,HEATHROW,ISLE OF MAN,103257,103188,69,104948,104948,0,-1.611274123
10/13/2008 13:11,1992,1991,A,London Area Airports,HEATHROW,JERSEY,264352,264027,325,303601,303479,122,-12.92782307
10/13/2008 13:11,1992,1991,A,London Area Airports,HEATHROW,KENT INTERNATIONAL,401,0,401,595,0,595,-32.6050415
10/13/2008 13:11,1992,1991,A,London Area Airports,HEATHROW,LEEDS BRADFORD,187936,187106,830,191528,191102,426,-1.875443816
10/13/2008 13:11,1992,1991,A,London Area Airports,HEATHROW,LEUCHARS,101,0,101,0,0,0,
10/13/2008 13:11,1992,1991,A,London Area Airports,HEATHROW,LIVERPOOL,18014,17701,313,80117,80117,0,-77.51538086
10/13/2008 13:11,1992,1991,A,London Area Airports,HEATHROW,MANCHESTER,915860,914845,1015,887615,885933,1682,3.182122946
10/13/2008 13:11,1992,1991,A,London Area Airports,HEATHROW,NEWCASTLE,377181,377157,24,353448,353448,0,6.714707851
10/13/2008 13:11,1992,1991,A,London Area Airports,HEATHROW,NEWQUAY,32140,32140,0,31514,31386,128,1.986418724
10/13/2008 13:11,1992,1991,A,London Area Airports,HEATHROW,PLYMOUTH,40821,40754,67,39521,39521,0,3.289390564
10/13/2008 13:11,1992,1991,A,London Area Airports,HEATHROW,PRESTWICK,0,0,0,69,69,0,
10/13/2008 13:11,1992,1991,A,London Area Airports,HEATHROW,STANSTED,354,0,354,0,0,0,
10/13/2008 13:11,1992,1991,A,London Area Airports,LONDON CITY,BLACKPOOL,0,0,0,88,0,88,
10/13/2008 13:11,1992,1991,A,London Area Airports,LONDON CITY,COVENTRY,0,0,0,90,0,90,
10/13/2008 13:11,1992,1991,A,London Area Airports,LONDON CITY,DURHAM TEES VALLEY,0,0,0,183,0,183,
10/13/2008 13:11,1992,1991,A,London Area Airports,LONDON CITY,GUERNSEY,0,0,0,16,16,0,
10/13/2008 13:11,1992,1991,A,London Area Airports,LONDON CITY,JERSEY,2595,341,2254,7712,4091,3621,-66.35114288
10/13/2008 13:11,1992,1991,A,London Area Airports,LONDON CITY,LIVERPOOL,0,0,0,44,0,44,
10/13/2008 13:11,1992,1991,A,London Area Airports,LONDON CITY,MANCHESTER,0,0,0,87,0,87,
10/13/2008 13:11,1992,1991,A,London Area Airports,LONDON CITY,NEWCASTLE,92,0,92,0,0,0,
10/13/2008 13:11,1992,1991,A,London Area Airports,LONDON CITY,PLYMOUTH,0,0,0,92,92,0,
10/13/2008 13:11,1992,1991,A,London Area Airports,LUTON,ABERDEEN,0,0,0,142,0,142,
10/13/2008 13:11,1992,1991,A,London Area Airports,LUTON,BELFAST CITY (GEORGE BEST),4561,4561,0,11,0,11,41363.63672
10/13/2008 13:11,1992,1991,A,London Area Airports,LUTON,BELFAST INTERNATIONAL,150384,149538,846,172582,172024,558,-12.86229134
10/13/2008 13:11,1992,1991,A,London Area Airports,LUTON,BIRMINGHAM,0,0,0,63,0,63,
10/13/2008 13:11,1992,1991,A,London Area Airports,LUTON,BRISTOL,0,0,0,1,0,1,
10/13/2008 13:11,1992,1991,A,London Area Airports,LUTON,CAMBRIDGE,15,0,15,1,0,1,1400
10/13/2008 13:11,1992,1991,A,London Area Airports,LUTON,EAST MIDLANDS INTERNATIONAL,0,0,0,1,0,1,
10/13/2008 13:11,1992,1991,A,London Area Airports,LUTON,EDINBURGH,424,0,424,785,0,785,-45.98726273
10/13/2008 13:11,1992,1991,A,London Area Airports,LUTON,EXETER,8,0,8,2,0,2,300
10/13/2008 13:11,1992,1991,A,London Area Airports,LUTON,GLASGOW,0,0,0,21,0,21,
10/13/2008 13:11,1992,1991,A,London Area Airports,LUTON,GUERNSEY,0,0,0,1633,1633,0,
10/13/2008 13:11,1992,1991,A,London Area Airports,LUTON,ISLE OF MAN,14911,14911,0,15308,15241,67,-2.59341526
10/13/2008 13:11,1992,1991,A,London Area Airports,LUTON,JERSEY,15694,12613,3081,18142,14738,3404,-13.49355125
10/13/2008 13:11,1992,1991,A,London Area Airports,LUTON,KINLOSS,0,0,0,144,0,144,
10/13/2008 13:11,1992,1991,A,London Area Airports,LUTON,LIVERPOOL,2,1,1,1,0,1,100
10/13/2008 13:11,1992,1991,A,London Area Airports,LUTON,MANCHESTER,114,0,114,104,0,104,9.615385056
10/13/2008 13:11,1992,1991,A,London Area Airports,LUTON,NEWCASTLE,2,0,2,7,0,7,-71.42857361
10/13/2008 13:11,1992,1991,A,London Area Airports,LUTON,NEWQUAY,0,0,0,72,0,72,
10/13/2008 13:11,1992,1991,A,London Area Airports,LUTON,SOUTHAMPTON,9,0,9,0,0,0,
10/13/2008 13:11,1992,1991,A,London Area Airports,LUTON,SOUTHEND,2,0,2,0,0,0,
10/13/2008 13:11,1992,1991,A,London Area Airports,SOUTHEND,ABERDEEN,0,0,0,69,0,69,
10/13/2008 13:11,1992,1991,A,London Area Airports,SOUTHEND,BOURNEMOUTH,0,0,0,29,0,29,
10/13/2008 13:11,1992,1991,A,London Area Airports,SOUTHEND,EXETER,0,0,0,120,0,120,
10/13/2008 13:11,1992,1991,A,London Area Airports,SOUTHEND,GLASGOW,90,0,90,4,0,4,2150
10/13/2008 13:11,1992,1991,A,London Area Airports,SOUTHEND,JERSEY,9762,0,9762,10575,7,10568,-7.687943459
10/13/2008 13:11,1992,1991,A,London Area Airports,SOUTHEND,LIVERPOOL,160,0,160,0,0,0,
10/13/2008 13:11,1992,1991,A,London Area Airports,SOUTHEND,MANCHESTER,0,0,0,123,0,123,
10/13/2008 13:11,1992,1991,A,London Area Airports,SOUTHEND,NEWCASTLE,78,0,78,148,0,148,-47.29729843
10/13/2008 13:11,1992,1991,A,London Area Airports,STANSTED,ABERDEEN,68736,68736,0,32565,32536,29,111.0732346
10/13/2008 13:11,1992,1991,A,London Area Airports,STANSTED,BELFAST INTERNATIONAL,259,0,259,0,0,0,
10/13/2008 13:11,1992,1991,A,London Area Airports,STANSTED,BIRMINGHAM,2,0,2,452,0,452,-99.55752563
10/13/2008 13:11,1992,1991,A,London Area Airports,STANSTED,BRISTOL,124,0,124,2,0,2,6100
10/13/2008 13:11,1992,1991,A,London Area Airports,STANSTED,CITY OF DERRY (EGLINTON),22,0,22,0,0,0,
10/13/2008 13:11,1992,1991,A,London Area Airports,STANSTED,DUNDEE,142,0,142,0,0,0,
10/13/2008 13:11,1992,1991,A,London Area Airports,STANSTED,DURHAM TEES VALLEY,25,0,25,0,0,0,
10/13/2008 13:11,1992,1991,A,London Area Airports,STANSTED,EAST MIDLANDS INTERNATIONAL,49,0,49,0,0,0,
10/13/2008 13:11,1992,1991,A,London Area Airports,STANSTED,EDINBURGH,33653,33653,0,66968,66895,73,-49.74764252
10/13/2008 13:11,1992,1991,A,London Area Airports,STANSTED,EXETER,33,0,33,0,0,0,
10/13/2008 13:11,1992,1991,A,London Area Airports,STANSTED,FILTON,2,0,2,0,0,0,
10/13/2008 13:11,1992,1991,A,London Area Airports,STANSTED,GLASGOW,105450,105396,54,77438,77383,55,36.17345428
10/13/2008 13:11,1992,1991,A,London Area Airports,STANSTED,GLOUCESTERSHIRE,5,0,5,1,0,1,400
10/13/2008 13:11,1992,1991,A,London Area Airports,STANSTED,GUERNSEY,28485,28351,134,31488,31450,38,-9.536966324
10/13/2008 13:11,1992,1991,A,London Area Airports,STANSTED,JERSEY,38866,38027,839,41400,40542,858,-6.120772839
10/13/2008 13:11,1992,1991,A,London Area Airports,STANSTED,LEEDS BRADFORD,0,0,0,142,9,133,
10/13/2008 13:11,1992,1991,A,London Area Airports,STANSTED,LIVERPOOL,3,0,3,31,0,31,-90.32257843
10/13/2008 13:11,1992,1991,A,London Area Airports,STANSTED,MANCHESTER,58,0,58,38,0,38,52.63158035
10/13/2008 13:11,1992,1991,A,London Area Airports,STANSTED,NEWCASTLE,129,0,129,145,26,119,-11.03448296
10/13/2008 13:11,1992,1991,A,London Area Airports,STANSTED,NORWICH,3,0,3,141,141,0,-97.87233734
10/13/2008 13:11,1992,1991,A,London Area Airports,STANSTED,PENZANCE HELIPORT,0,0,0,26,0,26,
10/13/2008 13:11,1992,1991,A,London Area Airports,STANSTED,PRESTWICK,0,0,0,76,0,76,
10/13/2008 13:11,1992,1991,A,London Area Airports,STANSTED,SOUTHAMPTON,0,0,0,22,0,22,
10/13/2008 13:11,1992,1991,A,London Area Airports,STANSTED,STORNOWAY,139,0,139,0,0,0,
10/13/2008 13:11,1992,1991,A,London Area Airports,STANSTED,SUMBURGH,0,0,0,5,0,5,
10/13/2008 13:11,1992,1991,A,London Area Airports,STANSTED,WOODVALE,0,0,0,28,0,28,
10/13/2008 13:11,1992,1991,B,Other UK Airports,ABERDEEN,BELFAST CITY (GEORGE BEST),3042,3018,24,0,0,0,
10/13/2008 13:11,1992,1991,B,Other UK Airports,ABERDEEN,BENBECULA,48,0,48,81,0,81,-40.74074173
10/13/2008 13:11,1992,1991,B,Other UK Airports,ABERDEEN,BIRMINGHAM,38712,38642,70,32680,32626,54,18.45777321
10/13/2008 13:11,1992,1991,B,Other UK Airports,ABERDEEN,BRISTOL,8900,8829,71,4536,4436,100,96.20811462
10/13/2008 13:11,1992,1991,B,Other UK Airports,ABERDEEN,CAMPBELTOWN,0,0,0,46,0,46,
10/13/2008 13:11,1992,1991,B,Other UK Airports,ABERDEEN,COVENTRY,64,0,64,0,0,0,
10/13/2008 13:11,1992,1991,B,Other UK Airports,ABERDEEN,DOUNREAY,21,0,21,0,0,0,
10/13/2008 13:11,1992,1991,B,Other UK Airports,ABERDEEN,DUNDEE,636,610,26,1751,1739,12,-63.67789841
10/13/2008 13:11,1992,1991,B,Other UK Airports,ABERDEEN,DURHAM TEES VALLEY,8360,8266,94,3105,3099,6,169.2431488
10/13/2008 13:11,1992,1991,B,Other UK Airports,ABERDEEN,EAST MIDLANDS INTERNATIONAL,9963,9698,265,8690,8587,103,14.6490221
10/13/2008 13:11,1992,1991,B,Other UK Airports,ABERDEEN,EDINBURGH,6660,6583,77,50653,50468,185,-86.85171509
10/13/2008 13:11,1992,1991,B,Other UK Airports,ABERDEEN,FLOTTA,20,0,20,0,0,0,
10/13/2008 13:11,1992,1991,B,Other UK Airports,ABERDEEN,GLASGOW,39687,39410,277,40020,39883,137,-0.832083941
10/13/2008 13:11,1992,1991,B,Other UK Airports,ABERDEEN,HUMBERSIDE,26271,26271,0,18528,18315,213,41.790802
10/13/2008 13:11,1992,1991,B,Other UK Airports,ABERDEEN,INVERNESS,434,406,28,1285,1156,129,-66.22567749
10/13/2008 13:11,1992,1991,B,Other UK Airports,ABERDEEN,ISLE OF SKYE,0,0,0,8,0,8,
10/13/2008 13:11,1992,1991,B,Other UK Airports,ABERDEEN,JERSEY,1743,0,1743,3344,1400,1944,-47.87679291
10/13/2008 13:11,1992,1991,B,Other UK Airports,ABERDEEN,KINLOSS,24,0,24,7,0,7,242.8571472
10/13/2008 13:11,1992,1991,B,Other UK Airports,ABERDEEN,KIRKWALL,24769,24666,103,25786,25106,680,-3.944000721
10/13/2008 13:11,1992,1991,B,Other UK Airports,ABERDEEN,LEEDS BRADFORD,0,0,0,3745,3745,0,
10/13/2008 13:11,1992,1991,B,Other UK Airports,ABERDEEN,LEUCHARS,0,0,0,113,0,113,
10/13/2008 13:11,1992,1991,B,Other UK Airports,ABERDEEN,LIVERPOOL,2,0,2,0,0,0,
10/13/2008 13:11,1992,1991,B,Other UK Airports,ABERDEEN,MANCHESTER,67652,67567,85,53147,52998,149,27.29222679
10/13/2008 13:11,1992,1991,B,Other UK Airports,ABERDEEN,NEWCASTLE,28528,28367,161,21842,21754,88,30.6107502
10/13/2008 13:11,1992,1991,B,Other UK Airports,ABERDEEN,NORWICH,65248,65214,34,80278,80249,29,-18.72243881
10/13/2008 13:11,1992,1991,B,Other UK Airports,ABERDEEN,PERTH (UK),0,0,0,6,0,6,
10/13/2008 13:11,1992,1991,B,Other UK Airports,ABERDEEN,PETERHEAD,49,0,49,99,0,99,-50.50505066
10/13/2008 13:11,1992,1991,B,Other UK Airports,ABERDEEN,PLYMOUTH,1,0,1,0,0,0,
10/13/2008 13:11,1992,1991,B,Other UK Airports,ABERDEEN,PRIVATE STRIPS/HELIPADS,0,0,0,12,0,12,
10/13/2008 13:11,1992,1991,B,Other UK Airports,ABERDEEN,SCATSTA,13705,0,13705,13751,0,13751,-0.334521115
10/13/2008 13:11,1992,1991,B,Other UK Airports,ABERDEEN,STORNOWAY,62,61,1,74,55,19,-16.21621704
10/13/2008 13:11,1992,1991,B,Other UK Airports,ABERDEEN,SUMBURGH,231011,75498,155513,239660,70827,168833,-3.608862638
10/13/2008 13:11,1992,1991,B,Other UK Airports,ABERDEEN,TIREE,0,0,0,24,0,24,
10/13/2008 13:11,1992,1991,B,Other UK Airports,ABERDEEN,UNST,38907,0,38907,39866,0,39866,-2.405558586
10/13/2008 13:11,1992,1991,B,Other UK Airports,ABERDEEN,WICK,16304,16176,128,14765,14765,0,10.42329788
10/13/2008 13:11,1992,1991,B,Other UK Airports,ALDERNEY,BOURNEMOUTH,1085,1085,0,4,4,0,27025
10/13/2008 13:11,1992,1991,B,Other UK Airports,ALDERNEY,GUERNSEY,34991,34991,0,2306,2306,0,1417.389404
10/13/2008 13:11,1992,1991,B,Other UK Airports,ALDERNEY,JERSEY,14235,14235,0,544,544,0,2516.728027
10/13/2008 13:11,1992,1991,B,Other UK Airports,ALDERNEY,SOUTHAMPTON,28011,28011,0,1995,1995,0,1304.060181
10/13/2008 13:11,1992,1991,B,Other UK Airports,ANGLESEY (VALLEY),CARDIFF WALES,39,0,39,0,0,0,
10/13/2008 13:11,1992,1991,B,Other UK Airports,BARRA,BENBECULA,1614,1614,0,1537,1537,0,5.009759426
10/13/2008 13:11,1992,1991,B,Other UK Airports,BARRA,GLASGOW,6125,6125,0,5616,5616,0,9.063390732
10/13/2008 13:11,1992,1991,B,Other UK Airports,BARRA,STORNOWAY,4295,4295,0,2873,2873,0,49.49530029
10/13/2008 13:11,1992,1991,B,Other UK Airports,BARRA,TIREE,152,152,0,150,150,0,1.333333373
10/13/2008 13:11,1992,1991,B,Other UK Airports,BARROW-IN-FURNESS,BLACKPOOL,17,17,0,7,7,0,142.8571472
10/13/2008 13:11,1992,1991,B,Other UK Airports,BARROW-IN-FURNESS,MANCHESTER,287,287,0,96,96,0,198.9583282
10/13/2008 13:11,1992,1991,B,Other UK Airports,BECCLES,HUMBERSIDE,2,0,2,0,0,0,
10/13/2008 13:11,1992,1991,B,Other UK Airports,BECCLES,NORWICH,11,0,11,20,0,20,-45
10/13/2008 13:11,1992,1991,B,Other UK Airports,BELFAST CITY (GEORGE BEST),BELFAST CITY (GEORGE BEST),57,0,57,0,0,0,
10/13/2008 13:11,1992,1991,B,Other UK Airports,BELFAST CITY (GEORGE BEST),BIRMINGHAM,61094,61094,0,44841,44841,0,36.24584579
10/13/2008 13:11,1992,1991,B,Other UK Airports,BELFAST CITY (GEORGE BEST),BLACKPOOL,49713,49713,0,43651,43582,69,13.88742542
10/13/2008 13:11,1992,1991,B,Other UK Airports,BELFAST CITY (GEORGE BEST),BRISTOL,32173,32173,0,18771,18771,0,71.39736938
10/13/2008 13:11,1992,1991,B,Other UK Airports,BELFAST CITY (GEORGE BEST),CARDIFF WALES,12721,12721,0,7995,7995,0,59.11194611
10/13/2008 13:11,1992,1991,B,Other UK Airports,BELFAST CITY (GEORGE BEST),CARLISLE,0,0,0,2,0,2,
10/13/2008 13:11,1992,1991,B,Other UK Airports,BELFAST CITY (GEORGE BEST),COVENTRY,0,0,0,38,0,38,
10/13/2008 13:11,1992,1991,B,Other UK Airports,BELFAST CITY (GEORGE BEST),DURHAM TEES VALLEY,539,539,0,0,0,0,
10/13/2008 13:11,1992,1991,B,Other UK Airports,BELFAST CITY (GEORGE BEST),EAST MIDLANDS INTERNATIONAL,73,73,0,0,0,0,
10/13/2008 13:11,1992,1991,B,Other UK Airports,BELFAST CITY (GEORGE BEST),EDINBURGH,64096,64096,0,66921,66895,26,-4.221395493
10/13/2008 13:11,1992,1991,B,Other UK Airports,BELFAST CITY (GEORGE BEST),EXETER,14412,14412,0,11594,11594,0,24.30567551
10/13/2008 13:11,1992,1991,B,Other UK Airports,BELFAST CITY (GEORGE BEST),GLASGOW,64828,64828,0,74319,74255,64,-12.77062416
10/13/2008 13:11,1992,1991,B,Other UK Airports,BELFAST CITY (GEORGE BEST),GUERNSEY,426,426,0,145,105,40,193.7931061
10/13/2008 13:11,1992,1991,B,Other UK Airports,BELFAST CITY (GEORGE BEST),ISLE OF MAN,15806,15759,47,25118,25004,114,-37.07301712
10/13/2008 13:11,1992,1991,B,Other UK Airports,BELFAST CITY (GEORGE BEST),JERSEY,3019,2523,496,7937,7937,0,-61.96295929
10/13/2008 13:11,1992,1991,B,Other UK Airports,BELFAST CITY (GEORGE BEST),LEEDS BRADFORD,62833,62833,0,29615,29615,0,112.1661301
10/13/2008 13:11,1992,1991,B,Other UK Airports,BELFAST CITY (GEORGE BEST),LIVERPOOL,77669,77669,0,79232,79196,36,-1.97268784
10/13/2008 13:11,1992,1991,B,Other UK Airports,BELFAST CITY (GEORGE BEST),MANCHESTER,89099,89099,0,92034,92034,0,-3.189038754
10/13/2008 13:11,1992,1991,B,Other UK Airports,BELFAST CITY (GEORGE BEST),NEWCASTLE,36643,36612,31,24583,24583,0,49.05829239
10/13/2008 13:11,1992,1991,B,Other UK Airports,BELFAST CITY (GEORGE BEST),SOUTHAMPTON,18246,18246,0,8655,8655,0,110.8145599
10/13/2008 13:11,1992,1991,B,Other UK Airports,BELFAST INTERNATIONAL,BELFAST INTERNATIONAL,0,0,0,1,0,1,
10/13/2008 13:11,1992,1991,B,Other UK Airports,BELFAST INTERNATIONAL,BIRMINGHAM,100547,99974,573,89112,88210,902,12.83216667
10/13/2008 13:11,1992,1991,B,Other UK Airports,BELFAST INTERNATIONAL,BLACKPOOL,0,0,0,39,0,39,
10/13/2008 13:11,1992,1991,B,Other UK Airports,BELFAST INTERNATIONAL,BOURNEMOUTH,0,0,0,84,0,84,
10/13/2008 13:11,1992,1991,B,Other UK Airports,BELFAST INTERNATIONAL,BRISTOL,0,0,0,1740,1690,50,
10/13/2008 13:11,1992,1991,B,Other UK Airports,BELFAST INTERNATIONAL,CARDIFF WALES,288,0,288,1620,1492,128,-82.22222137
10/13/2008 13:11,1992,1991,B,Other UK Airports,BELFAST INTERNATIONAL,COVENTRY,1,0,1,67,0,67,-98.50746155
10/13/2008 13:11,1992,1991,B,Other UK Airports,BELFAST INTERNATIONAL,DURHAM TEES VALLEY,0,0,0,78,36,42,
10/13/2008 13:11,1992,1991,B,Other UK Airports,BELFAST INTERNATIONAL,EAST MIDLANDS INTERNATIONAL,53337,53337,0,62230,61544,686,-14.29053497
10/13/2008 13:11,1992,1991,B,Other UK Airports,BELFAST INTERNATIONAL,EDINBURGH,236,0,236,213,200,13,10.79812241
10/13/2008 13:11,1992,1991,B,Other UK Airports,BELFAST INTERNATIONAL,EXETER,0,0,0,51,51,0,
10/13/2008 13:11,1992,1991,B,Other UK Airports,BELFAST INTERNATIONAL,GLASGOW,64352,64230,122,56432,55869,563,14.03459072
10/13/2008 13:11,1992,1991,B,Other UK Airports,BELFAST INTERNATIONAL,GLOUCESTERSHIRE,60,0,60,0,0,0,
10/13/2008 13:11,1992,1991,B,Other UK Airports,BELFAST INTERNATIONAL,HUMBERSIDE,841,841,0,0,0,0,
10/13/2008 13:11,1992,1991,B,Other UK Airports,BELFAST INTERNATIONAL,ISLE OF MAN,0,0,0,93,69,24,
10/13/2008 13:11,1992,1991,B,Other UK Airports,BELFAST INTERNATIONAL,JERSEY,21134,20923,211,21166,21083,83,-0.15118587
10/13/2008 13:11,1992,1991,B,Other UK Airports,BELFAST INTERNATIONAL,LEEDS BRADFORD,16330,16330,0,52020,51928,92,-68.60823059
10/13/2008 13:11,1992,1991,B,Other UK Airports,BELFAST INTERNATIONAL,LIVERPOOL,0,0,0,1109,142,967,
10/13/2008 13:11,1992,1991,B,Other UK Airports,BELFAST INTERNATIONAL,MANCHESTER,127190,127177,13,130845,130404,441,-2.793381453
10/13/2008 13:11,1992,1991,B,Other UK Airports,BELFAST INTERNATIONAL,NEWCASTLE,8232,8059,173,9993,9737,256,-17.62233543
10/13/2008 13:11,1992,1991,B,Other UK Airports,BELFAST INTERNATIONAL,PRESTWICK,0,0,0,51,0,51,
10/13/2008 13:11,1992,1991,B,Other UK Airports,BEMBRIDGE,JERSEY,43,0,43,620,0,620,-93.06451416
10/13/2008 13:11,1992,1991,B,Other UK Airports,BENBECULA,BLACKPOOL,0,0,0,23,0,23,
10/13/2008 13:11,1992,1991,B,Other UK Airports,BENBECULA,GLASGOW,20522,20522,0,19055,19055,0,7.698766708
10/13/2008 13:11,1992,1991,B,Other UK Airports,BENBECULA,INVERNESS,9,0,9,0,0,0,
10/13/2008 13:11,1992,1991,B,Other UK Airports,BENBECULA,PRIVATE STRIPS/HELIPADS,39,0,39,0,0,0,
10/13/2008 13:11,1992,1991,B,Other UK Airports,BENBECULA,ST KILDA,395,0,395,380,0,380,3.947368383
10/13/2008 13:11,1992,1991,B,Other UK Airports,BENBECULA,STORNOWAY,9667,9667,0,9447,9431,16,2.328781605
10/13/2008 13:11,1992,1991,B,Other UK Airports,BIGGIN HILL,GLOUCESTERSHIRE,90,0,90,0,0,0,
10/13/2008 13:11,1992,1991,B,Other UK Airports,BIRMINGHAM,BIRMINGHAM,0,0,0,60,0,60,
10/13/2008 13:11,1992,1991,B,Other UK Airports,BIRMINGHAM,BLACKPOOL,59,0,59,0,0,0,
10/13/2008 13:11,1992,1991,B,Other UK Airports,BIRMINGHAM,BRISTOL,648,157,491,0,0,0,
10/13/2008 13:11,1992,1991,B,Other UK Airports,BIRMINGHAM,DUNDEE,0,0,0,66,0,66,
10/13/2008 13:11,1992,1991,B,Other UK Airports,BIRMINGHAM,DURHAM TEES VALLEY,19,0,19,0,0,0,
10/13/2008 13:11,1992,1991,B,Other UK Airports,BIRMINGHAM,EAST MIDLANDS INTERNATIONAL,1042,697,345,727,727,0,43.3287468
10/13/2008 13:11,1992,1991,B,Other UK Airports,BIRMINGHAM,EDINBURGH,159096,158879,217,148322,147591,731,7.263925552
10/13/2008 13:11,1992,1991,B,Other UK Airports,BIRMINGHAM,GLASGOW,145621,144865,756,138663,138405,258,5.017920971
10/13/2008 13:11,1992,1991,B,Other UK Airports,BIRMINGHAM,GUERNSEY,14645,14497,148,33776,33776,0,-56.64081192
10/13/2008 13:11,1992,1991,B,Other UK Airports,BIRMINGHAM,ISLE OF MAN,33480,33480,0,31854,31854,0,5.104539394
10/13/2008 13:11,1992,1991,B,Other UK Airports,BIRMINGHAM,JERSEY,76339,67664,8675,76350,65466,10884,-0.014407335
10/13/2008 13:11,1992,1991,B,Other UK Airports,BIRMINGHAM,KIRKWALL,599,599,0,0,0,0,
10/13/2008 13:11,1992,1991,B,Other UK Airports,BIRMINGHAM,LIVERPOOL,0,0,0,54,0,54,
10/13/2008 13:11,1992,1991,B,Other UK Airports,BIRMINGHAM,MANCHESTER,211,0,211,570,0,570,-62.98245621
10/13/2008 13:11,1992,1991,B,Other UK Airports,BIRMINGHAM,NEWCASTLE,16617,16259,358,12043,12037,6,37.98056793
10/13/2008 13:11,1992,1991,B,Other UK Airports,BIRMINGHAM,NORTHOLT,72,0,72,0,0,0,
10/13/2008 13:11,1992,1991,B,Other UK Airports,BIRMINGHAM,NORWICH,342,0,342,145,0,145,135.8620758
10/13/2008 13:11,1992,1991,B,Other UK Airports,BIRMINGHAM,PLYMOUTH,133,0,133,0,0,0,
10/13/2008 13:11,1992,1991,B,Other UK Airports,BIRMINGHAM,PRESTWICK,0,0,0,2,0,2,
10/13/2008 13:11,1992,1991,B,Other UK Airports,BIRMINGHAM,SUMBURGH,0,0,0,20,20,0,
10/13/2008 13:11,1992,1991,B,Other UK Airports,BIRMINGHAM,WICK,0,0,0,44,0,44,
10/13/2008 13:11,1992,1991,B,Other UK Airports,BLACKPOOL,CARDIFF WALES,61,0,61,0,0,0,
10/13/2008 13:11,1992,1991,B,Other UK Airports,BLACKPOOL,ISLE OF MAN,14854,14815,39,41256,41212,44,-63.99554062
10/13/2008 13:11,1992,1991,B,Other UK Airports,BLACKPOOL,JERSEY,3381,3381,0,3381,3248,133,0
10/13/2008 13:11,1992,1991,B,Other UK Airports,BLACKPOOL,MANCHESTER,30,30,0,298,26,272,-89.93288422
10/13/2008 13:11,1992,1991,B,Other UK Airports,BLACKPOOL,NORTHOLT,137,0,137,0,0,0,
10/13/2008 13:11,1992,1991,B,Other UK Airports,BOURNEMOUTH,DOUNREAY,1,0,1,0,0,0,
10/13/2008 13:11,1992,1991,B,Other UK Airports,BOURNEMOUTH,EDINBURGH,0,0,0,35,0,35,
10/13/2008 13:11,1992,1991,B,Other UK Airports,BOURNEMOUTH,EXETER,51,0,51,0,0,0,
10/13/2008 13:11,1992,1991,B,Other UK Airports,BOURNEMOUTH,GLASGOW,998,0,998,37,0,37,2597.297363
10/13/2008 13:11,1992,1991,B,Other UK Airports,BOURNEMOUTH,GUERNSEY,3685,1080,2605,20225,19177,1048,-81.77997589
10/13/2008 13:11,1992,1991,B,Other UK Airports,BOURNEMOUTH,JERSEY,25300,20007,5293,36541,34686,1855,-30.76270485
10/13/2008 13:11,1992,1991,B,Other UK Airports,BOURNEMOUTH,LEEDS BRADFORD,0,0,0,94,0,94,
10/13/2008 13:11,1992,1991,B,Other UK Airports,BOURNEMOUTH,NORWICH,95,0,95,0,0,0,
10/13/2008 13:11,1992,1991,B,Other UK Airports,BOURNEMOUTH,SOUTHAMPTON,0,0,0,6,0,6,
10/13/2008 13:11,1992,1991,B,Other UK Airports,BRISTOL,CARDIFF WALES,80,0,80,140,0,140,-42.8571434
10/13/2008 13:11,1992,1991,B,Other UK Airports,BRISTOL,EAST MIDLANDS INTERNATIONAL,0,0,0,46,0,46,
10/13/2008 13:11,1992,1991,B,Other UK Airports,BRISTOL,EDINBURGH,32097,32097,0,25304,25285,19,26.84555817
10/13/2008 13:11,1992,1991,B,Other UK Airports,BRISTOL,EXETER,103,103,0,277,277,0,-62.81588364
10/13/2008 13:11,1992,1991,B,Other UK Airports,BRISTOL,GLASGOW,39827,39827,0,29095,29053,42,36.88606262
10/13/2008 13:11,1992,1991,B,Other UK Airports,BRISTOL,GUERNSEY,11604,11604,0,19116,19059,57,-39.29692459
10/13/2008 13:11,1992,1991,B,Other UK Airports,BRISTOL,HAWARDEN,54,0,54,0,0,0,
10/13/2008 13:11,1992,1991,B,Other UK Airports,BRISTOL,HUMBERSIDE,0,0,0,82,0,82,
10/13/2008 13:11,1992,1991,B,Other UK Airports,BRISTOL,JERSEY,25859,25378,481,31048,26939,4109,-16.7128315
10/13/2008 13:11,1992,1991,B,Other UK Airports,BRISTOL,LIVERPOOL,31,0,31,21,0,21,47.61904907
10/13/2008 13:11,1992,1991,B,Other UK Airports,BRISTOL,MANCHESTER,1,0,1,6028,5998,30,-99.9834137
10/13/2008 13:11,1992,1991,B,Other UK Airports,BRISTOL,NEWCASTLE,109,109,0,380,48,332,-71.31578827
10/13/2008 13:11,1992,1991,B,Other UK Airports,BRISTOL,NORTHOLT,69,0,69,0,0,0,
10/13/2008 13:11,1992,1991,B,Other UK Airports,BRISTOL,NORWICH,72,0,72,13,0,13,453.8461609
10/13/2008 13:11,1992,1991,B,Other UK Airports,BRISTOL,PENZANCE HELIPORT,0,0,0,6,0,6,
10/13/2008 13:11,1992,1991,B,Other UK Airports,BRISTOL,PLYMOUTH,3784,3784,0,2720,2719,1,39.11764526
10/13/2008 13:11,1992,1991,B,Other UK Airports,BRISTOL,PRIVATE STRIPS/HELIPADS,0,0,0,5,0,5,
10/13/2008 13:11,1992,1991,B,Other UK Airports,CAMBRIDGE,EAST MIDLANDS INTERNATIONAL,46,0,46,0,0,0,
10/13/2008 13:11,1992,1991,B,Other UK Airports,CAMBRIDGE,JERSEY,3986,3671,315,3683,3683,0,8.226988792
10/13/2008 13:11,1992,1991,B,Other UK Airports,CAMBRIDGE,MANCHESTER,6345,6345,0,6944,6849,95,-8.626152039
10/13/2008 13:11,1992,1991,B,Other UK Airports,CAMBRIDGE,SOUTHAMPTON,4,0,4,0,0,0,
10/13/2008 13:11,1992,1991,B,Other UK Airports,CAMPBELTOWN,GLASGOW,9472,9472,0,10041,10041,0,-5.666766167
10/13/2008 13:11,1992,1991,B,Other UK Airports,CAMPBELTOWN,ISLAY,198,197,1,0,0,0,
10/13/2008 13:11,1992,1991,B,Other UK Airports,CAMPBELTOWN,KIRKWALL,99,0,99,92,0,92,7.608695507
10/13/2008 13:11,1992,1991,B,Other UK Airports,CARDIFF WALES,EDINBURGH,40,0,40,5836,0,5836,-99.31459808
10/13/2008 13:11,1992,1991,B,Other UK Airports,CARDIFF WALES,GLASGOW,15838,15481,357,9928,9806,122,59.52860641
10/13/2008 13:11,1992,1991,B,Other UK Airports,CARDIFF WALES,GUERNSEY,3179,2984,195,1540,1540,0,106.4285736
10/13/2008 13:11,1992,1991,B,Other UK Airports,CARDIFF WALES,ISLE OF MAN,1073,1073,0,1514,1514,0,-29.12813759
10/13/2008 13:11,1992,1991,B,Other UK Airports,CARDIFF WALES,JERSEY,25585,19539,6046,20401,14879,5522,25.41051865
10/13/2008 13:11,1992,1991,B,Other UK Airports,CARDIFF WALES,LEEDS BRADFORD,14,0,14,0,0,0,
10/13/2008 13:11,1992,1991,B,Other UK Airports,CARDIFF WALES,LIVERPOOL,0,0,0,1860,1855,5,
10/13/2008 13:11,1992,1991,B,Other UK Airports,CARDIFF WALES,MANCHESTER,284,0,284,622,21,601,-54.34083557
10/13/2008 13:11,1992,1991,B,Other UK Airports,CARDIFF WALES,NEWCASTLE,347,0,347,183,0,183,89.61748505
10/13/2008 13:11,1992,1991,B,Other UK Airports,CARDIFF WALES,PRIVATE STRIPS/HELIPADS,0,0,0,1,0,1,
10/13/2008 13:11,1992,1991,B,Other UK Airports,CARLISLE,EDINBURGH,14,0,14,0,0,0,
10/13/2008 13:11,1992,1991,B,Other UK Airports,CARLISLE,MANCHESTER,0,0,0,42,0,42,
10/13/2008 13:11,1992,1991,B,Other UK Airports,CARLISLE,NORWICH,38,0,38,0,0,0,
10/13/2008 13:11,1992,1991,B,Other UK Airports,CITY OF DERRY (EGLINTON),GLASGOW,36,36,0,0,0,0,
10/13/2008 13:11,1992,1991,B,Other UK Airports,CITY OF DERRY (EGLINTON),MANCHESTER,16,16,0,0,0,0,
10/13/2008 13:11,1992,1991,B,Other UK Airports,COVENTRY,EDINBURGH,17,0,17,0,0,0,
10/13/2008 13:11,1992,1991,B,Other UK Airports,COVENTRY,JERSEY,0,0,0,74,0,74,
10/13/2008 13:11,1992,1991,B,Other UK Airports,COVENTRY,NEWCASTLE,0,0,0,58,0,58,
10/13/2008 13:11,1992,1991,B,Other UK Airports,COVENTRY,NORTH WEALD,23,0,23,0,0,0,
10/13/2008 13:11,1992,1991,B,Other UK Airports,CRANFIELD,JERSEY,0,0,0,84,0,84,
10/13/2008 13:11,1992,1991,B,Other UK Airports,DORNOCH,GLASGOW,65,65,0,0,0,0,
10/13/2008 13:11,1992,1991,B,Other UK Airports,DUNDEE,HUMBERSIDE,0,0,0,50,0,50,
10/13/2008 13:11,1992,1991,B,Other UK Airports,DUNDEE,JERSEY,646,0,646,0,0,0,
10/13/2008 13:11,1992,1991,B,Other UK Airports,DUNDEE,LIVERPOOL,0,0,0,12,0,12,
10/13/2008 13:11,1992,1991,B,Other UK Airports,DUNDEE,MANCHESTER,45,45,0,14,14,0,221.4285736
10/13/2008 13:11,1992,1991,B,Other UK Airports,DUNKESWELL,JERSEY,142,0,142,0,0,0,
10/13/2008 13:11,1992,1991,B,Other UK Airports,DURHAM TEES VALLEY,EDINBURGH,63,0,63,42,0,42,50
10/13/2008 13:11,1992,1991,B,Other UK Airports,DURHAM TEES VALLEY,GLASGOW,96,0,96,0,0,0,
10/13/2008 13:11,1992,1991,B,Other UK Airports,DURHAM TEES VALLEY,HUMBERSIDE,333,333,0,415,349,66,-19.75903702
10/13/2008 13:11,1992,1991,B,Other UK Airports,DURHAM TEES VALLEY,INVERNESS,0,0,0,64,0,64,
10/13/2008 13:11,1992,1991,B,Other UK Airports,DURHAM TEES VALLEY,JERSEY,9453,9453,0,11002,10916,86,-14.07925797
10/13/2008 13:11,1992,1991,B,Other UK Airports,DURHAM TEES VALLEY,LEEDS BRADFORD,0,0,0,2,0,2,
10/13/2008 13:11,1992,1991,B,Other UK Airports,DURHAM TEES VALLEY,LIVERPOOL,0,0,0,141,0,141,
10/13/2008 13:11,1992,1991,B,Other UK Airports,DURHAM TEES VALLEY,MANCHESTER,0,0,0,41,0,41,
10/13/2008 13:11,1992,1991,B,Other UK Airports,DURHAM TEES VALLEY,NEWCASTLE,53,27,26,78,37,41,-32.05128098
10/13/2008 13:11,1992,1991,B,Other UK Airports,DURHAM TEES VALLEY,NORTHOLT,62,0,62,0,0,0,
10/13/2008 13:11,1992,1991,B,Other UK Airports,DURHAM TEES VALLEY,NORWICH,2311,2310,1,6521,6521,0,-64.56065369
10/13/2008 13:11,1992,1991,B,Other UK Airports,DURHAM TEES VALLEY,PLYMOUTH,0,0,0,172,0,172,
10/13/2008 13:11,1992,1991,B,Other UK Airports,DURHAM TEES VALLEY,PRESTWICK,0,0,0,30,0,30,
10/13/2008 13:11,1992,1991,B,Other UK Airports,EAST MIDLANDS INTERNATIONAL,EDINBURGH,21549,21484,65,21046,21039,7,2.390002966
10/13/2008 13:11,1992,1991,B,Other UK Airports,EAST MIDLANDS INTERNATIONAL,GLASGOW,75854,75642,212,78051,77914,137,-2.81482625
10/13/2008 13:11,1992,1991,B,Other UK Airports,EAST MIDLANDS INTERNATIONAL,GUERNSEY,17585,17540,45,23811,23811,0,-26.14757919
10/13/2008 13:11,1992,1991,B,Other UK Airports,EAST MIDLANDS INTERNATIONAL,INVERNESS,32,0,32,0,0,0,
10/13/2008 13:11,1992,1991,B,Other UK Airports,EAST MIDLANDS INTERNATIONAL,ISLE OF MAN,0,0,0,61,0,61,
10/13/2008 13:11,1992,1991,B,Other UK Airports,EAST MIDLANDS INTERNATIONAL,JERSEY,60479,56885,3594,71685,67921,3764,-15.63228035
10/13/2008 13:11,1992,1991,B,Other UK Airports,EAST MIDLANDS INTERNATIONAL,MANCHESTER,90,0,90,206,0,206,-56.31068039
10/13/2008 13:11,1992,1991,B,Other UK Airports,EAST MIDLANDS INTERNATIONAL,NEWQUAY,0,0,0,123,0,123,
10/13/2008 13:11,1992,1991,B,Other UK Airports,EAST MIDLANDS INTERNATIONAL,NORTHOLT,129,0,129,0,0,0,
10/13/2008 13:11,1992,1991,B,Other UK Airports,EAST MIDLANDS INTERNATIONAL,NORWICH,0,0,0,15,0,15,
10/13/2008 13:11,1992,1991,B,Other UK Airports,EDAY,KIRKWALL,2261,2261,0,2279,2279,0,-0.789820075
10/13/2008 13:11,1992,1991,B,Other UK Airports,EDINBURGH,GLASGOW,726,726,0,245,237,8,196.3265381
10/13/2008 13:11,1992,1991,B,Other UK Airports,EDINBURGH,GLOUCESTERSHIRE,30,0,30,0,0,0,
10/13/2008 13:11,1992,1991,B,Other UK Airports,EDINBURGH,GUERNSEY,2203,2203,0,2352,2352,0,-6.335033894
10/13/2008 13:11,1992,1991,B,Other UK Airports,EDINBURGH,HUMBERSIDE,1741,1741,0,230,230,0,656.956543
10/13/2008 13:11,1992,1991,B,Other UK Airports,EDINBURGH,INVERNESS,0,0,0,22,22,0,
10/13/2008 13:11,1992,1991,B,Other UK Airports,EDINBURGH,ISLAY,303,0,303,30,0,30,910
10/13/2008 13:11,1992,1991,B,Other UK Airports,EDINBURGH,JERSEY,5766,2838,2928,7500,3188,4312,-23.12000084
10/13/2008 13:11,1992,1991,B,Other UK Airports,EDINBURGH,KIRKWALL,11760,11069,691,6072,5259,813,93.67588806
10/13/2008 13:11,1992,1991,B,Other UK Airports,EDINBURGH,LEEDS BRADFORD,22673,22613,60,27134,27072,62,-16.44062805
10/13/2008 13:11,1992,1991,B,Other UK Airports,EDINBURGH,LEEMING,32,0,32,0,0,0,
10/13/2008 13:11,1992,1991,B,Other UK Airports,EDINBURGH,LERWICK (TINGWALL),0,0,0,5652,5652,0,
10/13/2008 13:11,1992,1991,B,Other UK Airports,EDINBURGH,MANCHESTER,87445,87364,81,86698,86432,266,0.861611545
10/13/2008 13:11,1992,1991,B,Other UK Airports,EDINBURGH,NEWCASTLE,120,0,120,187,30,157,-35.8288765
10/13/2008 13:11,1992,1991,B,Other UK Airports,EDINBURGH,NORTHOLT,63,0,63,0,0,0,
10/13/2008 13:11,1992,1991,B,Other UK Airports,EDINBURGH,NORWICH,15589,15589,0,10422,10422,0,49.57781601
10/13/2008 13:11,1992,1991,B,Other UK Airports,EDINBURGH,PRESTWICK,38,0,38,49,0,49,-22.44898033
10/13/2008 13:11,1992,1991,B,Other UK Airports,EDINBURGH,SOUTHAMPTON,11933,11885,48,2117,1943,174,463.6750183
10/13/2008 13:11,1992,1991,B,Other UK Airports,EDINBURGH,STORNOWAY,0,0,0,21,0,21,
10/13/2008 13:11,1992,1991,B,Other UK Airports,EDINBURGH,SUMBURGH,11766,11712,54,1705,1667,38,590.0879517
10/13/2008 13:11,1992,1991,B,Other UK Airports,EDINBURGH,UNST,2510,2510,0,1657,1617,40,51.47857666
10/13/2008 13:11,1992,1991,B,Other UK Airports,EDINBURGH,WICK,2211,2155,56,10525,10436,89,-78.99287415
10/13/2008 13:11,1992,1991,B,Other UK Airports,EXETER,GLASGOW,66,0,66,134,0,134,-50.74626923
10/13/2008 13:11,1992,1991,B,Other UK Airports,EXETER,GUERNSEY,13597,13597,0,23206,23142,64,-41.40739441
10/13/2008 13:11,1992,1991,B,Other UK Airports,EXETER,ISLES OF SCILLY (ST.MARYS),6359,6359,0,1020,1020,0,523.4313965
10/13/2008 13:11,1992,1991,B,Other UK Airports,EXETER,JERSEY,37360,35463,1897,44504,44380,124,-16.05249023
10/13/2008 13:11,1992,1991,B,Other UK Airports,EXETER,LANDS END (ST JUST),1,1,0,0,0,0,
10/13/2008 13:11,1992,1991,B,Other UK Airports,EXETER,LEEDS BRADFORD,454,0,454,0,0,0,
10/13/2008 13:11,1992,1991,B,Other UK Airports,EXETER,LIVERPOOL,0,0,0,19,0,19,
10/13/2008 13:11,1992,1991,B,Other UK Airports,EXETER,MANCHESTER,400,0,400,7215,7179,36,-94.45599365
10/13/2008 13:11,1992,1991,B,Other UK Airports,EXETER,NEWCASTLE,118,0,118,450,0,450,-73.77777863
10/13/2008 13:11,1992,1991,B,Other UK Airports,EXETER,NORWICH,206,0,206,0,0,0,
10/13/2008 13:11,1992,1991,B,Other UK Airports,EXETER,PLYMOUTH,0,0,0,37,37,0,
10/13/2008 13:11,1992,1991,B,Other UK Airports,EXETER,TOLLERTON NOTTINGHAM,0,0,0,48,0,48,
10/13/2008 13:11,1992,1991,B,Other UK Airports,FAIR ISLE,KIRKWALL,56,56,0,154,154,0,-63.63636398
10/13/2008 13:11,1992,1991,B,Other UK Airports,FAIR ISLE,LERWICK (TINGWALL),17,17,0,3,3,0,466.6666565
10/13/2008 13:11,1992,1991,B,Other UK Airports,FAIR ISLE,SUMBURGH,219,116,103,46,0,46,376.0869446
10/13/2008 13:11,1992,1991,B,Other UK Airports,FAIROAKS,JERSEY,0,0,0,25,0,25,
10/13/2008 13:11,1992,1991,B,Other UK Airports,GLASGOW,GUERNSEY,2455,2455,0,2517,2117,400,-2.463249922
10/13/2008 13:11,1992,1991,B,Other UK Airports,GLASGOW,HATFIELD,0,0,0,150,0,150,
10/13/2008 13:11,1992,1991,B,Other UK Airports,GLASGOW,HUMBERSIDE,1184,1184,0,6,0,6,19633.33398
10/13/2008 13:11,1992,1991,B,Other UK Airports,GLASGOW,INVERNESS,2066,2066,0,11172,10975,197,-81.50733948
10/13/2008 13:11,1992,1991,B,Other UK Airports,GLASGOW,ISLAY,18733,18724,9,20740,20622,118,-9.676952362
10/13/2008 13:11,1992,1991,B,Other UK Airports,GLASGOW,ISLE OF MAN,18182,18164,18,19517,19517,0,-6.840190411
10/13/2008 13:11,1992,1991,B,Other UK Airports,GLASGOW,JERSEY,37383,30305,7078,40335,31708,8627,-7.318706036
10/13/2008 13:11,1992,1991,B,Other UK Airports,GLASGOW,KIRKWALL,32920,32920,0,11774,11648,126,179.5991211
10/13/2008 13:11,1992,1991,B,Other UK Airports,GLASGOW,LEEDS BRADFORD,22803,22753,50,25607,25458,149,-10.95013046
10/13/2008 13:11,1992,1991,B,Other UK Airports,GLASGOW,LIVERPOOL,0,0,0,4,0,4,
10/13/2008 13:11,1992,1991,B,Other UK Airports,GLASGOW,MANCHESTER,96378,96069,309,96676,96355,321,-0.308246106
10/13/2008 13:11,1992,1991,B,Other UK Airports,GLASGOW,NEWCASTLE,49,39,10,152,150,2,-67.76316071
10/13/2008 13:11,1992,1991,B,Other UK Airports,GLASGOW,NORWICH,0,0,0,77,51,26,
10/13/2008 13:11,1992,1991,B,Other UK Airports,GLASGOW,PLYMOUTH,5113,5113,0,0,0,0,
10/13/2008 13:11,1992,1991,B,Other UK Airports,GLASGOW,PRESTWICK,61,0,61,41,0,41,48.78048706
10/13/2008 13:11,1992,1991,B,Other UK Airports,GLASGOW,SOUTHAMPTON,20657,20657,0,6645,6645,0,210.8653107
10/13/2008 13:11,1992,1991,B,Other UK Airports,GLASGOW,STORNOWAY,50691,50691,0,44078,44078,0,15.00294971
10/13/2008 13:11,1992,1991,B,Other UK Airports,GLASGOW,SUMBURGH,5729,5651,78,12826,12457,369,-55.33291626
10/13/2008 13:11,1992,1991,B,Other UK Airports,GLASGOW,TIREE,4145,4145,0,4945,4945,0,-16.17795753
10/13/2008 13:11,1992,1991,B,Other UK Airports,GLASGOW,WICK,0,0,0,52,0,52,
10/13/2008 13:11,1992,1991,B,Other UK Airports,GLOUCESTERSHIRE,JERSEY,3208,0,3208,2629,0,2629,22.02358246
10/13/2008 13:11,1992,1991,B,Other UK Airports,GLOUCESTERSHIRE,NORTHOLT,66,0,66,0,0,0,
10/13/2008 13:11,1992,1991,B,Other UK Airports,GUERNSEY,JERSEY,192710,192380,330,101874,101835,39,89.16504669
10/13/2008 13:11,1992,1991,B,Other UK Airports,GUERNSEY,LEEDS BRADFORD,4729,4729,0,2376,2376,0,99.03199005
10/13/2008 13:11,1992,1991,B,Other UK Airports,GUERNSEY,MANCHESTER,26496,26496,0,18125,17895,230,46.1848259
10/13/2008 13:11,1992,1991,B,Other UK Airports,GUERNSEY,NORWICH,1904,1904,0,959,959,0,98.54014587
10/13/2008 13:11,1992,1991,B,Other UK Airports,GUERNSEY,PLYMOUTH,4327,4327,0,2516,2516,0,71.97933197
10/13/2008 13:11,1992,1991,B,Other UK Airports,GUERNSEY,SOUTHAMPTON,101622,100572,1050,66000,65795,205,53.97272873
10/13/2008 13:11,1992,1991,B,Other UK Airports,HATFIELD,NEWCASTLE,0,0,0,142,0,142,
10/13/2008 13:11,1992,1991,B,Other UK Airports,HUMBERSIDE,JERSEY,6142,1483,4659,5434,1769,3665,13.02907658
10/13/2008 13:11,1992,1991,B,Other UK Airports,HUMBERSIDE,KIRKWALL,54,0,54,33,0,33,63.63636398
10/13/2008 13:11,1992,1991,B,Other UK Airports,HUMBERSIDE,NORTHOLT,16,0,16,0,0,0,
10/13/2008 13:11,1992,1991,B,Other UK Airports,HUMBERSIDE,NORWICH,2301,2301,0,2853,2853,0,-19.34805489
10/13/2008 13:11,1992,1991,B,Other UK Airports,INVERNESS,KINLOSS,0,0,0,1,0,1,
10/13/2008 13:11,1992,1991,B,Other UK Airports,INVERNESS,KIRKWALL,7461,7461,0,10234,10149,85,-27.0959549
10/13/2008 13:11,1992,1991,B,Other UK Airports,INVERNESS,MANCHESTER,7582,7582,0,1841,1575,266,311.8414001
10/13/2008 13:11,1992,1991,B,Other UK Airports,INVERNESS,NEWCASTLE,0,0,0,107,0,107,
10/13/2008 13:11,1992,1991,B,Other UK Airports,INVERNESS,SCATSTA,0,0,0,61,0,61,
10/13/2008 13:11,1992,1991,B,Other UK Airports,INVERNESS,STORNOWAY,29052,29052,0,21158,20941,217,37.30976486
10/13/2008 13:11,1992,1991,B,Other UK Airports,INVERNESS,SUMBURGH,88,31,57,1762,1762,0,-95.00567627
10/13/2008 13:11,1992,1991,B,Other UK Airports,INVERNESS,UNST,0,0,0,37,0,37,
10/13/2008 13:11,1992,1991,B,Other UK Airports,ISLAY,ISLAY,0,0,0,12,0,12,
10/13/2008 13:11,1992,1991,B,Other UK Airports,ISLAY,LIVERPOOL,0,0,0,49,0,49,
10/13/2008 13:11,1992,1991,B,Other UK Airports,ISLAY,PRESTWICK,3,0,3,0,0,0,
10/13/2008 13:11,1992,1991,B,Other UK Airports,ISLE OF MAN,JERSEY,111,111,0,64,64,0,73.4375
10/13/2008 13:11,1992,1991,B,Other UK Airports,ISLE OF MAN,LEEDS BRADFORD,1692,1692,0,902,902,0,87.58314514
10/13/2008 13:11,1992,1991,B,Other UK Airports,ISLE OF MAN,LIVERPOOL,122306,122187,119,105169,105060,109,16.29472542
10/13/2008 13:11,1992,1991,B,Other UK Airports,ISLE OF MAN,MANCHESTER,70642,70608,34,66428,66311,117,6.343710423
10/13/2008 13:11,1992,1991,B,Other UK Airports,ISLE OF MAN,NEWCASTLE,963,963,0,1259,812,447,-23.51072311
10/13/2008 13:11,1992,1991,B,Other UK Airports,ISLE OF MAN,PORTSMOUTH (UK),0,0,0,38,0,38,
10/13/2008 13:11,1992,1991,B,Other UK Airports,ISLE OF MAN,PRESTWICK,0,0,0,30,0,30,
10/13/2008 13:11,1992,1991,B,Other UK Airports,ISLE OF MAN,SOUTHAMPTON,44,0,44,60,0,60,-26.66666603
10/13/2008 13:11,1992,1991,B,Other UK Airports,ISLE OF MAN,WELLESBOURNE MOUNTFORD,0,0,0,31,0,31,
10/13/2008 13:11,1992,1991,B,Other UK Airports,JERSEY,KENT INTERNATIONAL,1802,0,1802,1830,0,1830,-1.530054688
10/13/2008 13:11,1992,1991,B,Other UK Airports,JERSEY,LEEDS BRADFORD,22095,21973,122,19425,19332,93,13.74517345
10/13/2008 13:11,1992,1991,B,Other UK Airports,JERSEY,LIVERPOOL,10267,6740,3527,10420,10416,4,-1.468330145
10/13/2008 13:11,1992,1991,B,Other UK Airports,JERSEY,LYDD,0,0,0,1324,0,1324,
10/13/2008 13:11,1992,1991,B,Other UK Airports,JERSEY,MANCHESTER,111594,92595,18999,118041,103655,14386,-5.461661816
10/13/2008 13:11,1992,1991,B,Other UK Airports,JERSEY,NEWCASTLE,18208,17509,699,17383,17383,0,4.746016026
10/13/2008 13:11,1992,1991,B,Other UK Airports,JERSEY,NORWICH,8239,8239,0,8124,8124,0,1.415558815
10/13/2008 13:11,1992,1991,B,Other UK Airports,JERSEY,PLYMOUTH,13946,13946,0,9213,9213,0,51.37305832
10/13/2008 13:11,1992,1991,B,Other UK Airports,JERSEY,PRESTWICK,68,0,68,0,0,0,
10/13/2008 13:11,1992,1991,B,Other UK Airports,JERSEY,SHOREHAM,276,0,276,1332,0,1332,-79.27928162
10/13/2008 13:11,1992,1991,B,Other UK Airports,JERSEY,SOUTHAMPTON,157084,145092,11992,183719,182553,1166,-14.49768353
10/13/2008 13:11,1992,1991,B,Other UK Airports,JERSEY,STORNOWAY,75,0,75,0,0,0,
10/13/2008 13:11,1992,1991,B,Other UK Airports,KIRKWALL,NEWCASTLE,0,0,0,34,0,34,
10/13/2008 13:11,1992,1991,B,Other UK Airports,KIRKWALL,NORTH RONALDSAY,3376,3376,0,2523,2523,0,33.80895615
10/13/2008 13:11,1992,1991,B,Other UK Airports,KIRKWALL,PAPA WESTRAY,3044,3044,0,3005,3005,0,1.2978369
10/13/2008 13:11,1992,1991,B,Other UK Airports,KIRKWALL,SANDAY,4304,4304,0,5496,5496,0,-21.68850136
10/13/2008 13:11,1992,1991,B,Other UK Airports,KIRKWALL,SCATSTA,11,0,11,54,0,54,-79.62963104
10/13/2008 13:11,1992,1991,B,Other UK Airports,KIRKWALL,STORNOWAY,0,0,0,45,0,45,
10/13/2008 13:11,1992,1991,B,Other UK Airports,KIRKWALL,STRONSAY,3397,3397,0,4277,4277,0,-20.57516861
10/13/2008 13:11,1992,1991,B,Other UK Airports,KIRKWALL,SUMBURGH,11155,11155,0,9949,9906,43,12.1218214
10/13/2008 13:11,1992,1991,B,Other UK Airports,KIRKWALL,WESTRAY,5083,5083,0,5627,5627,0,-9.667674065
10/13/2008 13:11,1992,1991,B,Other UK Airports,KIRKWALL,WICK,8290,8272,18,17238,17238,0,-51.90857315
10/13/2008 13:11,1992,1991,B,Other UK Airports,LEEDS BRADFORD,LEEDS BRADFORD,0,0,0,103,0,103,
10/13/2008 13:11,1992,1991,B,Other UK Airports,LEEDS BRADFORD,MANCHESTER,222,0,222,0,0,0,
10/13/2008 13:11,1992,1991,B,Other UK Airports,LEEDS BRADFORD,NEWCASTLE,33,0,33,66,0,66,-50
10/13/2008 13:11,1992,1991,B,Other UK Airports,LEEDS BRADFORD,NORTHOLT,60,0,60,0,0,0,
10/13/2008 13:11,1992,1991,B,Other UK Airports,LEEDS BRADFORD,NORWICH,0,0,0,5611,5611,0,
10/13/2008 13:11,1992,1991,B,Other UK Airports,LEEDS BRADFORD,SOUTHAMPTON,54,0,54,0,0,0,
10/13/2008 13:11,1992,1991,B,Other UK Airports,LIVERPOOL,MANCHESTER,37,0,37,153,0,153,-75.81699371
10/13/2008 13:11,1992,1991,B,Other UK Airports,LIVERPOOL,NEWCASTLE,0,0,0,4,0,4,
10/13/2008 13:11,1992,1991,B,Other UK Airports,LIVERPOOL,PLYMOUTH,0,0,0,46,0,46,
10/13/2008 13:11,1992,1991,B,Other UK Airports,LIVERPOOL,PRESTWICK,90,0,90,36,0,36,150
10/13/2008 13:11,1992,1991,B,Other UK Airports,LIVERPOOL,SANDOWN,0,0,0,55,0,55,
10/13/2008 13:11,1992,1991,B,Other UK Airports,LYDD,SHOREHAM,0,0,0,91,0,91,
10/13/2008 13:11,1992,1991,B,Other UK Airports,MANCHESTER,MANCHESTER,54,0,54,0,0,0,
10/13/2008 13:11,1992,1991,B,Other UK Airports,MANCHESTER,NEWCASTLE,19845,19326,519,16489,16374,115,20.35296249
10/13/2008 13:11,1992,1991,B,Other UK Airports,MANCHESTER,NORTHOLT,73,0,73,0,0,0,
10/13/2008 13:11,1992,1991,B,Other UK Airports,MANCHESTER,NORWICH,446,0,446,247,0,247,80.56680298
10/13/2008 13:11,1992,1991,B,Other UK Airports,MANCHESTER,PRESTWICK,0,0,0,27,27,0,
10/13/2008 13:11,1992,1991,B,Other UK Airports,MANCHESTER,SOUTHAMPTON,44,0,44,251,0,251,-82.47012329
10/13/2008 13:11,1992,1991,B,Other UK Airports,MANCHESTER,SUMBURGH,42122,42122,0,35936,35936,0,17.21393585
10/13/2008 13:11,1992,1991,B,Other UK Airports,NEWCASTLE,NORTHOLT,28,0,28,0,0,0,
10/13/2008 13:11,1992,1991,B,Other UK Airports,NEWCASTLE,PLYMOUTH,100,0,100,0,0,0,
10/13/2008 13:11,1992,1991,B,Other UK Airports,NORTH RONALDSAY,SUMBURGH,12,0,12,0,0,0,
10/13/2008 13:11,1992,1991,B,Other UK Airports,NORWICH,PLYMOUTH,98,0,98,0,0,0,
10/13/2008 13:11,1992,1991,B,Other UK Airports,NORWICH,PRIVATE STRIPS/HELIPADS,0,0,0,15,0,15,
10/13/2008 13:11,1992,1991,B,Other UK Airports,NORWICH,SOUTHAMPTON,0,0,0,7,0,7,
10/13/2008 13:11,1992,1991,B,Other UK Airports,PRESTWICK,SHAWBURY,35,0,35,0,0,0,
10/13/2008 13:11,1992,1991,B,Other UK Airports,PRESTWICK,STORNOWAY,0,0,0,22,0,22,
10/13/2008 13:11,1992,1991,B,Other UK Airports,PRIVATE STRIPS/HELIPADS,SOUTHAMPTON,0,0,0,13,0,13,
10/13/2008 13:11,1992,1991,B,Other UK Airports,PRIVATE STRIPS/HELIPADS,SUMBURGH,0,0,0,1,0,1,
10/13/2008 13:11,1992,1991,B,Other UK Airports,SCATSTA,STORNOWAY,0,0,0,30,0,30,
10/13/2008 13:11,1992,1991,B,Other UK Airports,STORNOWAY,SUMBURGH,0,0,0,29,0,29,
10/13/2008 13:11,1992,1991,B,Other UK Airports,SUMBURGH,UNST,2943,2108,835,1249,0,1249,135.6285095
