rundate,this_period,last_period,grp_cd,grp_name,apt1_apt_name,apt2_apt_name,total_pax_tp,total_pax_shd_tp,total_pax_cht_tp,total_pax_lp,total_pax_shd_lp,total_pax_cht_lp,total_pax_pc
10/15/2008 10:35,1990,1989,A,London Area Airports,GATWICK,ABERDEEN,128772,128672,100,57994,57725,269,122.043663
10/15/2008 10:35,1990,1989,A,London Area Airports,GATWICK,BELFAST INTERNATIONAL,88966,88840,126,50431,50133,298,76.41133118
10/15/2008 10:35,1990,1989,A,London Area Airports,GATWICK,BIGGIN HILL,9,0,9,2,0,2,350
10/15/2008 10:35,1990,1989,A,London Area Airports,GATWICK,BIRMINGHAM,19732,19732,0,9279,9279,0,112.6522217
10/15/2008 10:35,1990,1989,A,London Area Airports,GATWICK,BRISTOL,9,0,9,2,0,2,350
10/15/2008 10:35,1990,1989,A,London Area Airports,GATWICK,CARDIFF WALES,0,0,0,892,0,892,
10/15/2008 10:35,1990,1989,A,London Area Airports,GATWICK,COAL ASTON,47,47,0,0,0,0,
10/15/2008 10:35,1990,1989,A,London Area Airports,GATWICK,CULDROSE,60,30,30,134,0,134,-55.22388077
10/15/2008 10:35,1990,1989,A,London Area Airports,GATWICK,EAST MIDLANDS INTERNATIONAL,2,0,2,0,0,0,
10/15/2008 10:35,1990,1989,A,London Area Airports,GATWICK,EDINBURGH,273839,273764,75,130018,129677,341,110.6162186
10/15/2008 10:35,1990,1989,A,London Area Airports,GATWICK,EXETER,0,0,0,9,0,9,
10/15/2008 10:35,1990,1989,A,London Area Airports,GATWICK,GATWICK,0,0,0,71,0,71,
10/15/2008 10:35,1990,1989,A,London Area Airports,GATWICK,GLASGOW,197082,196973,109,114077,114077,0,72.76226044
10/15/2008 10:35,1990,1989,A,London Area Airports,GATWICK,GUERNSEY,103630,103233,397,46557,46494,63,122.5873642
10/15/2008 10:35,1990,1989,A,London Area Airports,GATWICK,HAVERFORD WEST,190,0,190,0,0,0,
10/15/2008 10:35,1990,1989,A,London Area Airports,GATWICK,HEATHROW,161,0,161,39,0,39,312.8205261
10/15/2008 10:35,1990,1989,A,London Area Airports,GATWICK,INVERNESS,60041,60041,0,37237,36946,291,61.24016571
10/15/2008 10:35,1990,1989,A,London Area Airports,GATWICK,JERSEY,213814,212012,1802,130284,127486,2798,64.11378479
10/15/2008 10:35,1990,1989,A,London Area Airports,GATWICK,KENT INTERNATIONAL,476,0,476,0,0,0,
10/15/2008 10:35,1990,1989,A,London Area Airports,GATWICK,KINLOSS,0,0,0,75,75,0,
10/15/2008 10:35,1990,1989,A,London Area Airports,GATWICK,LASHAM,10,0,10,0,0,0,
10/15/2008 10:35,1990,1989,A,London Area Airports,GATWICK,LEEDS BRADFORD,13255,13243,12,14428,14401,27,-8.13002491
10/15/2008 10:35,1990,1989,A,London Area Airports,GATWICK,LERWICK (TINGWALL),42,42,0,0,0,0,
10/15/2008 10:35,1990,1989,A,London Area Airports,GATWICK,LEUCHARS,46,0,46,0,0,0,
10/15/2008 10:35,1990,1989,A,London Area Airports,GATWICK,LIVERPOOL,1,0,1,0,0,0,
10/15/2008 10:35,1990,1989,A,London Area Airports,GATWICK,LONDON CITY,22,0,22,0,0,0,
10/15/2008 10:35,1990,1989,A,London Area Airports,GATWICK,LUTON,50,0,50,107,107,0,-53.27102661
10/15/2008 10:35,1990,1989,A,London Area Airports,GATWICK,LYDD,7,0,7,0,0,0,
10/15/2008 10:35,1990,1989,A,London Area Airports,GATWICK,MANCHESTER,155910,153814,2096,74023,71698,2325,110.6237259
10/15/2008 10:35,1990,1989,A,London Area Airports,GATWICK,NEWCASTLE,90717,90716,1,40665,40585,80,123.0837326
10/15/2008 10:35,1990,1989,A,London Area Airports,GATWICK,PLYMOUTH,24022,24022,0,13088,13088,0,83.54217529
10/15/2008 10:35,1990,1989,A,London Area Airports,GATWICK,PRESTWICK,108,0,108,60,47,13,80
10/15/2008 10:35,1990,1989,A,London Area Airports,GATWICK,SOUTHEND,6,0,6,0,0,0,
10/15/2008 10:35,1990,1989,A,London Area Airports,GATWICK,STANSTED,3,0,3,82,0,82,-96.34146118
10/15/2008 10:35,1990,1989,A,London Area Airports,GATWICK,SUMBURGH,0,0,0,8,8,0,
10/15/2008 10:35,1990,1989,A,London Area Airports,HEATHROW,ABERDEEN,464649,464629,20,227141,227141,0,104.5641251
10/15/2008 10:35,1990,1989,A,London Area Airports,HEATHROW,BELFAST INTERNATIONAL,1116606,1113692,2914,617441,617344,97,80.84416199
10/15/2008 10:35,1990,1989,A,London Area Airports,HEATHROW,BIRMINGHAM,117082,117065,17,57053,56941,112,105.2162018
10/15/2008 10:35,1990,1989,A,London Area Airports,HEATHROW,BRISTOL,0,0,0,66,66,0,
10/15/2008 10:35,1990,1989,A,London Area Airports,HEATHROW,CARDIFF WALES,189,189,0,0,0,0,
10/15/2008 10:35,1990,1989,A,London Area Airports,HEATHROW,DURHAM TEES VALLEY,196722,196661,61,99246,99098,148,98.21655273
10/15/2008 10:35,1990,1989,A,London Area Airports,HEATHROW,EAST MIDLANDS INTERNATIONAL,88812,88534,278,47375,47307,68,87.46596527
10/15/2008 10:35,1990,1989,A,London Area Airports,HEATHROW,EDINBURGH,1394268,1394196,72,697959,697911,48,99.76359558
10/15/2008 10:35,1990,1989,A,London Area Airports,HEATHROW,EXETER,100,0,100,358,35,323,-72.06703949
10/15/2008 10:35,1990,1989,A,London Area Airports,HEATHROW,GLASGOW,1416159,1416122,37,687531,687531,0,105.977478
10/15/2008 10:35,1990,1989,A,London Area Airports,HEATHROW,GUERNSEY,131800,131800,0,73231,73231,0,79.97842407
10/15/2008 10:35,1990,1989,A,London Area Airports,HEATHROW,HEATHROW,96,45,51,0,0,0,
10/15/2008 10:35,1990,1989,A,London Area Airports,HEATHROW,HUMBERSIDE,24415,24378,37,19866,19865,1,22.89842033
10/15/2008 10:35,1990,1989,A,London Area Airports,HEATHROW,INVERNESS,133206,133206,0,68491,68491,0,94.48686981
10/15/2008 10:35,1990,1989,A,London Area Airports,HEATHROW,ISLE OF MAN,122960,122903,57,65001,64889,112,89.1663208
10/15/2008 10:35,1990,1989,A,London Area Airports,HEATHROW,JERSEY,288327,288237,90,137318,137318,0,109.9702911
10/15/2008 10:35,1990,1989,A,London Area Airports,HEATHROW,LEEDS BRADFORD,225341,225083,258,108938,108938,0,106.8525238
10/15/2008 10:35,1990,1989,A,London Area Airports,HEATHROW,LEUCHARS,0,0,0,130,0,130,
10/15/2008 10:35,1990,1989,A,London Area Airports,HEATHROW,LIVERPOOL,112076,112039,37,58329,58329,0,92.14456177
10/15/2008 10:35,1990,1989,A,London Area Airports,HEATHROW,LONDON CITY,17,17,0,0,0,0,
10/15/2008 10:35,1990,1989,A,London Area Airports,HEATHROW,LUTON,305,231,74,0,0,0,
10/15/2008 10:35,1990,1989,A,London Area Airports,HEATHROW,MANCHESTER,1036500,1036396,104,480679,480486,193,115.6324692
10/15/2008 10:35,1990,1989,A,London Area Airports,HEATHROW,NEWCASTLE,388923,388923,0,193945,193945,0,100.5326233
10/15/2008 10:35,1990,1989,A,London Area Airports,HEATHROW,NEWQUAY,41200,41200,0,19747,19747,0,108.6392899
10/15/2008 10:35,1990,1989,A,London Area Airports,HEATHROW,NORWICH,68,68,0,49,49,0,38.77550888
10/15/2008 10:35,1990,1989,A,London Area Airports,HEATHROW,PLYMOUTH,37149,37149,0,21136,21136,0,75.76173401
10/15/2008 10:35,1990,1989,A,London Area Airports,HEATHROW,SOUTHAMPTON,0,0,0,1,0,1,
10/15/2008 10:35,1990,1989,A,London Area Airports,HEATHROW,STANSTED,68,0,68,258,0,258,-73.64340973
10/15/2008 10:35,1990,1989,A,London Area Airports,LONDON CITY,BLACKPOOL,77,0,77,0,0,0,
10/15/2008 10:35,1990,1989,A,London Area Airports,LONDON CITY,EXETER,0,0,0,18,0,18,
10/15/2008 10:35,1990,1989,A,London Area Airports,LONDON CITY,GUERNSEY,0,0,0,45,45,0,
10/15/2008 10:35,1990,1989,A,London Area Airports,LONDON CITY,INVERNESS,88,0,88,0,0,0,
10/15/2008 10:35,1990,1989,A,London Area Airports,LONDON CITY,JERSEY,7447,7205,242,5216,5176,40,42.77223969
10/15/2008 10:35,1990,1989,A,London Area Airports,LONDON CITY,LIVERPOOL,160,0,160,0,0,0,
10/15/2008 10:35,1990,1989,A,London Area Airports,LONDON CITY,LYDD,11,11,0,0,0,0,
10/15/2008 10:35,1990,1989,A,London Area Airports,LONDON CITY,MANCHESTER,179,0,179,0,0,0,
10/15/2008 10:35,1990,1989,A,London Area Airports,LONDON CITY,NEWCASTLE,82,0,82,0,0,0,
10/15/2008 10:35,1990,1989,A,London Area Airports,LONDON CITY,NEWQUAY,86,86,0,0,0,0,
10/15/2008 10:35,1990,1989,A,London Area Airports,LONDON CITY,PLYMOUTH,92,92,0,16,16,0,475
10/15/2008 10:35,1990,1989,A,London Area Airports,LUTON,ABERDEEN,118,43,75,120,0,120,-1.666666627
10/15/2008 10:35,1990,1989,A,London Area Airports,LUTON,BELFAST CITY (GEORGE BEST),47837,47695,142,35571,35491,80,34.48314667
10/15/2008 10:35,1990,1989,A,London Area Airports,LUTON,BELFAST INTERNATIONAL,139560,139260,300,6020,5874,146,2218.272461
10/15/2008 10:35,1990,1989,A,London Area Airports,LUTON,BIRMINGHAM,518,0,518,542,0,542,-4.428044319
10/15/2008 10:35,1990,1989,A,London Area Airports,LUTON,BLACKPOOL,22,0,22,0,0,0,
10/15/2008 10:35,1990,1989,A,London Area Airports,LUTON,BRISTOL,98,0,98,260,0,260,-62.30769348
10/15/2008 10:35,1990,1989,A,London Area Airports,LUTON,CARDIFF WALES,0,0,0,84,0,84,
10/15/2008 10:35,1990,1989,A,London Area Airports,LUTON,DURHAM TEES VALLEY,180,0,180,0,0,0,
10/15/2008 10:35,1990,1989,A,London Area Airports,LUTON,EAST MIDLANDS INTERNATIONAL,0,0,0,59,0,59,
10/15/2008 10:35,1990,1989,A,London Area Airports,LUTON,EDINBURGH,372,0,372,161,0,161,131.0559082
10/15/2008 10:35,1990,1989,A,London Area Airports,LUTON,EXETER,56,0,56,2,0,2,2700
10/15/2008 10:35,1990,1989,A,London Area Airports,LUTON,GLASGOW,713,27,686,89,0,89,701.1235962
10/15/2008 10:35,1990,1989,A,London Area Airports,LUTON,GUERNSEY,2488,2069,419,2429,1986,443,2.428983212
10/15/2008 10:35,1990,1989,A,London Area Airports,LUTON,HUMBERSIDE,88,0,88,0,0,0,
10/15/2008 10:35,1990,1989,A,London Area Airports,LUTON,INVERNESS,102,0,102,101,101,0,0.990099013
10/15/2008 10:35,1990,1989,A,London Area Airports,LUTON,ISLE OF MAN,18540,18540,0,8637,7353,1284,114.6578674
10/15/2008 10:35,1990,1989,A,London Area Airports,LUTON,JERSEY,22915,17658,5257,15969,11483,4486,43.49677658
10/15/2008 10:35,1990,1989,A,London Area Airports,LUTON,LEEDS BRADFORD,1969,1969,0,0,0,0,
10/15/2008 10:35,1990,1989,A,London Area Airports,LUTON,LEUCHARS,21,0,21,0,0,0,
10/15/2008 10:35,1990,1989,A,London Area Airports,LUTON,LIVERPOOL,27,26,1,1,0,1,2600
10/15/2008 10:35,1990,1989,A,London Area Airports,LUTON,MANCHESTER,888,54,834,56,0,56,1485.714233
10/15/2008 10:35,1990,1989,A,London Area Airports,LUTON,NEWCASTLE,47,0,47,94,0,94,-50
10/15/2008 10:35,1990,1989,A,London Area Airports,LUTON,PRESTWICK,411,0,411,0,0,0,
10/15/2008 10:35,1990,1989,A,London Area Airports,LUTON,SOUTHAMPTON,1,0,1,2,0,2,-50
10/15/2008 10:35,1990,1989,A,London Area Airports,LUTON,SOUTHEND,0,0,0,271,0,271,
10/15/2008 10:35,1990,1989,A,London Area Airports,LUTON,STANSTED,130,0,130,0,0,0,
10/15/2008 10:35,1990,1989,A,London Area Airports,LUTON,WICK,0,0,0,19,19,0,
10/15/2008 10:35,1990,1989,A,London Area Airports,SOUTHEND,BELFAST INTERNATIONAL,68,2,66,48,48,0,41.66666794
10/15/2008 10:35,1990,1989,A,London Area Airports,SOUTHEND,BIRMINGHAM,12,0,12,22,22,0,-45.45454407
10/15/2008 10:35,1990,1989,A,London Area Airports,SOUTHEND,BOURNEMOUTH,78,0,78,0,0,0,
10/15/2008 10:35,1990,1989,A,London Area Airports,SOUTHEND,DURHAM TEES VALLEY,4,0,4,0,0,0,
10/15/2008 10:35,1990,1989,A,London Area Airports,SOUTHEND,EDINBURGH,0,0,0,26,26,0,
10/15/2008 10:35,1990,1989,A,London Area Airports,SOUTHEND,GLASGOW,161,47,114,45,41,4,257.777771
10/15/2008 10:35,1990,1989,A,London Area Airports,SOUTHEND,GUERNSEY,553,553,0,1702,1702,0,-67.50881195
10/15/2008 10:35,1990,1989,A,London Area Airports,SOUTHEND,HATFIELD,0,0,0,1,0,1,
10/15/2008 10:35,1990,1989,A,London Area Airports,SOUTHEND,ISLE OF MAN,8,8,0,0,0,0,
10/15/2008 10:35,1990,1989,A,London Area Airports,SOUTHEND,JERSEY,26236,7253,18983,13287,12853,434,97.4561615
10/15/2008 10:35,1990,1989,A,London Area Airports,SOUTHEND,LEEDS BRADFORD,14,14,0,24,24,0,-41.66666794
10/15/2008 10:35,1990,1989,A,London Area Airports,SOUTHEND,MANCHESTER,29,0,29,2179,1807,372,-98.66911316
10/15/2008 10:35,1990,1989,A,London Area Airports,SOUTHEND,NEWCASTLE,16,0,16,0,0,0,
10/15/2008 10:35,1990,1989,A,London Area Airports,SOUTHEND,NEWQUAY,25,0,25,0,0,0,
10/15/2008 10:35,1990,1989,A,London Area Airports,SOUTHEND,PRESTWICK,1,1,0,1,1,0,0
10/15/2008 10:35,1990,1989,A,London Area Airports,SOUTHEND,PRIVATE STRIPS/HELIPADS,0,0,0,26,26,0,
10/15/2008 10:35,1990,1989,A,London Area Airports,SOUTHEND,STANSTED,0,0,0,26,0,26,
10/15/2008 10:35,1990,1989,A,London Area Airports,STANSTED,ABERDEEN,202,202,0,0,0,0,
10/15/2008 10:35,1990,1989,A,London Area Airports,STANSTED,BELFAST INTERNATIONAL,721,0,721,0,0,0,
10/15/2008 10:35,1990,1989,A,London Area Airports,STANSTED,BIRMINGHAM,155,0,155,0,0,0,
10/15/2008 10:35,1990,1989,A,London Area Airports,STANSTED,CAMBRIDGE,82,0,82,0,0,0,
10/15/2008 10:35,1990,1989,A,London Area Airports,STANSTED,COVENTRY,69,69,0,0,0,0,
10/15/2008 10:35,1990,1989,A,London Area Airports,STANSTED,DUNDEE,41,0,41,0,0,0,
10/15/2008 10:35,1990,1989,A,London Area Airports,STANSTED,EAST MIDLANDS INTERNATIONAL,0,0,0,13,0,13,
10/15/2008 10:35,1990,1989,A,London Area Airports,STANSTED,EDINBURGH,7781,7781,0,7958,7958,0,-2.224176884
10/15/2008 10:35,1990,1989,A,London Area Airports,STANSTED,FAIRFORD,0,0,0,21,0,21,
10/15/2008 10:35,1990,1989,A,London Area Airports,STANSTED,GLASGOW,49796,49688,108,10770,10688,82,362.3583984
10/15/2008 10:35,1990,1989,A,London Area Airports,STANSTED,GUERNSEY,25524,25447,77,12834,12790,44,98.87798309
10/15/2008 10:35,1990,1989,A,London Area Airports,STANSTED,JERSEY,49035,46316,2719,25115,23455,1660,95.24188995
10/15/2008 10:35,1990,1989,A,London Area Airports,STANSTED,LEEDS BRADFORD,92,18,74,214,214,0,-57.00934601
10/15/2008 10:35,1990,1989,A,London Area Airports,STANSTED,LIVERPOOL,3,0,3,2,0,2,50
10/15/2008 10:35,1990,1989,A,London Area Airports,STANSTED,MANCHESTER,1624,0,1624,1209,0,1209,34.32588959
10/15/2008 10:35,1990,1989,A,London Area Airports,STANSTED,NEWCASTLE,167,0,167,138,0,138,21.01449203
10/15/2008 10:35,1990,1989,A,London Area Airports,STANSTED,NORWICH,209,209,0,29,29,0,620.6896362
10/15/2008 10:35,1990,1989,A,London Area Airports,STANSTED,SOUTHAMPTON,28,28,0,0,0,0,
10/15/2008 10:35,1990,1989,A,London Area Airports,STANSTED,WREXHAM,0,0,0,1,0,1,
10/15/2008 10:35,1990,1989,B,Other UK Airports,ABERDEEN,BENBECULA,82,0,82,13,0,13,530.7692261
10/15/2008 10:35,1990,1989,B,Other UK Airports,ABERDEEN,BIRMINGHAM,28543,28386,157,12746,12738,8,123.9369202
10/15/2008 10:35,1990,1989,B,Other UK Airports,ABERDEEN,BLACKPOOL,0,0,0,149,5,144,
10/15/2008 10:35,1990,1989,B,Other UK Airports,ABERDEEN,BOURNEMOUTH,12,0,12,0,0,0,
10/15/2008 10:35,1990,1989,B,Other UK Airports,ABERDEEN,BRAWDY,0,0,0,43,0,43,
10/15/2008 10:35,1990,1989,B,Other UK Airports,ABERDEEN,BRISTOL,41,0,41,0,0,0,
10/15/2008 10:35,1990,1989,B,Other UK Airports,ABERDEEN,CITY OF DERRY (EGLINTON),23,0,23,0,0,0,
10/15/2008 10:35,1990,1989,B,Other UK Airports,ABERDEEN,COLTISHALL,15,0,15,0,0,0,
10/15/2008 10:35,1990,1989,B,Other UK Airports,ABERDEEN,DENHAM,0,0,0,17,0,17,
10/15/2008 10:35,1990,1989,B,Other UK Airports,ABERDEEN,DONCASTER,1,1,0,0,0,0,
10/15/2008 10:35,1990,1989,B,Other UK Airports,ABERDEEN,DOUNREAY,95,0,95,0,0,0,
10/15/2008 10:35,1990,1989,B,Other UK Airports,ABERDEEN,DUNDEE,289,274,15,58,58,0,398.2758484
10/15/2008 10:35,1990,1989,B,Other UK Airports,ABERDEEN,DURHAM TEES VALLEY,926,871,55,292,292,0,217.123291
10/15/2008 10:35,1990,1989,B,Other UK Airports,ABERDEEN,EAST MIDLANDS INTERNATIONAL,13188,11965,1223,5416,5379,37,143.5007324
10/15/2008 10:35,1990,1989,B,Other UK Airports,ABERDEEN,EDINBURGH,13465,13340,125,1588,1457,131,747.921936
10/15/2008 10:35,1990,1989,B,Other UK Airports,ABERDEEN,GLASGOW,37918,37694,224,12941,12885,56,193.0067291
10/15/2008 10:35,1990,1989,B,Other UK Airports,ABERDEEN,HUMBERSIDE,20021,19867,154,9548,9548,0,109.6878891
10/15/2008 10:35,1990,1989,B,Other UK Airports,ABERDEEN,INVERNESS,1460,1410,50,1000,970,30,46
10/15/2008 10:35,1990,1989,B,Other UK Airports,ABERDEEN,JERSEY,2356,171,2185,3463,13,3450,-31.96650314
10/15/2008 10:35,1990,1989,B,Other UK Airports,ABERDEEN,KINLOSS,13,0,13,7,0,7,85.7142868
10/15/2008 10:35,1990,1989,B,Other UK Airports,ABERDEEN,KIRKWALL,26185,25720,465,9810,9723,87,166.9215088
10/15/2008 10:35,1990,1989,B,Other UK Airports,ABERDEEN,LEEDS BRADFORD,7119,7038,81,1234,1234,0,476.9043884
10/15/2008 10:35,1990,1989,B,Other UK Airports,ABERDEEN,LEUCHARS,50,0,50,32,0,32,56.25
10/15/2008 10:35,1990,1989,B,Other UK Airports,ABERDEEN,LIVERPOOL,0,0,0,56,56,0,
10/15/2008 10:35,1990,1989,B,Other UK Airports,ABERDEEN,MANCHESTER,54915,54564,351,29203,29116,87,88.04574585
10/15/2008 10:35,1990,1989,B,Other UK Airports,ABERDEEN,NEWCASTLE,19052,18860,192,7306,7306,0,160.7719727
10/15/2008 10:35,1990,1989,B,Other UK Airports,ABERDEEN,NORWICH,76335,76293,42,35064,35049,15,117.7019196
10/15/2008 10:35,1990,1989,B,Other UK Airports,ABERDEEN,PETERHEAD,14,0,14,42,0,42,-66.66666412
10/15/2008 10:35,1990,1989,B,Other UK Airports,ABERDEEN,PLYMOUTH,6,0,6,0,0,0,
10/15/2008 10:35,1990,1989,B,Other UK Airports,ABERDEEN,PRIVATE STRIPS/HELIPADS,26,0,26,0,0,0,
10/15/2008 10:35,1990,1989,B,Other UK Airports,ABERDEEN,SCATSTA,12525,3,12522,6904,0,6904,81.41657257
10/15/2008 10:35,1990,1989,B,Other UK Airports,ABERDEEN,STORNOWAY,2,0,2,45,43,2,-95.55555725
10/15/2008 10:35,1990,1989,B,Other UK Airports,ABERDEEN,SUMBURGH,234661,64730,169931,101828,31427,70401,130.44841
10/15/2008 10:35,1990,1989,B,Other UK Airports,ABERDEEN,UNST,36958,33,36925,18707,0,18707,97.56240845
10/15/2008 10:35,1990,1989,B,Other UK Airports,ABERDEEN,WICK,13254,13115,139,3811,3808,3,247.7827301
10/15/2008 10:35,1990,1989,B,Other UK Airports,ABERDEEN,WOLVERHAMPTON,17,0,17,0,0,0,
10/15/2008 10:35,1990,1989,B,Other UK Airports,ALDERNEY,MANCHESTER,35,0,35,0,0,0,
10/15/2008 10:35,1990,1989,B,Other UK Airports,ALDERNEY,SOUTHAMPTON,2,2,0,0,0,0,
10/15/2008 10:35,1990,1989,B,Other UK Airports,BARRA,BARRA,9,9,0,0,0,0,
10/15/2008 10:35,1990,1989,B,Other UK Airports,BARROW-IN-FURNESS,SOUTHAMPTON,0,0,0,81,81,0,
10/15/2008 10:35,1990,1989,B,Other UK Airports,BECCLES,NORWICH,4,0,4,0,0,0,
10/15/2008 10:35,1990,1989,B,Other UK Airports,BELFAST CITY (GEORGE BEST),BELFAST CITY (GEORGE BEST),0,0,0,28,16,12,
10/15/2008 10:35,1990,1989,B,Other UK Airports,BELFAST CITY (GEORGE BEST),BELFAST INTERNATIONAL,17,0,17,26,26,0,-34.61538315
10/15/2008 10:35,1990,1989,B,Other UK Airports,BELFAST CITY (GEORGE BEST),BIRMINGHAM,34463,34362,101,6007,6007,0,473.7139893
10/15/2008 10:35,1990,1989,B,Other UK Airports,BELFAST CITY (GEORGE BEST),BLACKPOOL,58383,57644,739,4047,4047,0,1342.624146
10/15/2008 10:35,1990,1989,B,Other UK Airports,BELFAST CITY (GEORGE BEST),BRISTOL,11845,11752,93,0,0,0,
10/15/2008 10:35,1990,1989,B,Other UK Airports,BELFAST CITY (GEORGE BEST),DURHAM TEES VALLEY,803,803,0,687,687,0,16.88500786
10/15/2008 10:35,1990,1989,B,Other UK Airports,BELFAST CITY (GEORGE BEST),EAST MIDLANDS INTERNATIONAL,1,0,1,90,90,0,-98.8888855
10/15/2008 10:35,1990,1989,B,Other UK Airports,BELFAST CITY (GEORGE BEST),EDINBURGH,66608,66576,32,10704,10704,0,522.2720337
10/15/2008 10:35,1990,1989,B,Other UK Airports,BELFAST CITY (GEORGE BEST),EXETER,9860,9860,0,1165,1165,0,746.3519287
10/15/2008 10:35,1990,1989,B,Other UK Airports,BELFAST CITY (GEORGE BEST),GLASGOW,77918,77904,14,12570,12570,0,519.8727417
10/15/2008 10:35,1990,1989,B,Other UK Airports,BELFAST CITY (GEORGE BEST),GUERNSEY,555,338,217,0,0,0,
10/15/2008 10:35,1990,1989,B,Other UK Airports,BELFAST CITY (GEORGE BEST),ISLE OF MAN,16324,15658,666,2118,2106,12,670.7271118
10/15/2008 10:35,1990,1989,B,Other UK Airports,BELFAST CITY (GEORGE BEST),JERSEY,22508,19392,3116,197,197,0,11325.38086
10/15/2008 10:35,1990,1989,B,Other UK Airports,BELFAST CITY (GEORGE BEST),LEEDS BRADFORD,28908,28775,133,10136,10136,0,185.2012634
10/15/2008 10:35,1990,1989,B,Other UK Airports,BELFAST CITY (GEORGE BEST),LIVERPOOL,64175,64129,46,10318,10318,0,521.9713135
10/15/2008 10:35,1990,1989,B,Other UK Airports,BELFAST CITY (GEORGE BEST),MANCHESTER,85560,85559,1,11648,11611,37,634.5466919
10/15/2008 10:35,1990,1989,B,Other UK Airports,BELFAST CITY (GEORGE BEST),NEWCASTLE,13473,13412,61,980,980,0,1274.795898
10/15/2008 10:35,1990,1989,B,Other UK Airports,BELFAST CITY (GEORGE BEST),PRESTWICK,0,0,0,36,36,0,
10/15/2008 10:35,1990,1989,B,Other UK Airports,BELFAST CITY (GEORGE BEST),SOUTHAMPTON,2461,2461,0,0,0,0,
10/15/2008 10:35,1990,1989,B,Other UK Airports,BELFAST CITY (GEORGE BEST),WICK,28,0,28,0,0,0,
10/15/2008 10:35,1990,1989,B,Other UK Airports,BELFAST INTERNATIONAL,BELFAST INTERNATIONAL,42,0,42,39,39,0,7.692307472
10/15/2008 10:35,1990,1989,B,Other UK Airports,BELFAST INTERNATIONAL,BIRMINGHAM,129811,129352,459,51367,51070,297,152.7128296
10/15/2008 10:35,1990,1989,B,Other UK Airports,BELFAST INTERNATIONAL,BLACKPOOL,9,0,9,1041,1041,0,-99.13544464
10/15/2008 10:35,1990,1989,B,Other UK Airports,BELFAST INTERNATIONAL,BRISTOL,8557,8494,63,3967,3967,0,115.7045593
10/15/2008 10:35,1990,1989,B,Other UK Airports,BELFAST INTERNATIONAL,CARDIFF WALES,8641,8617,24,3585,3585,0,141.032074
10/15/2008 10:35,1990,1989,B,Other UK Airports,BELFAST INTERNATIONAL,COVENTRY,2,0,2,0,0,0,
10/15/2008 10:35,1990,1989,B,Other UK Airports,BELFAST INTERNATIONAL,DURHAM TEES VALLEY,184,120,64,0,0,0,
10/15/2008 10:35,1990,1989,B,Other UK Airports,BELFAST INTERNATIONAL,EAST MIDLANDS INTERNATIONAL,69061,68773,288,25402,25402,0,171.8722992
10/15/2008 10:35,1990,1989,B,Other UK Airports,BELFAST INTERNATIONAL,EDINBURGH,488,78,410,326,186,140,49.69325256
10/15/2008 10:35,1990,1989,B,Other UK Airports,BELFAST INTERNATIONAL,EXETER,0,0,0,176,0,176,
10/15/2008 10:35,1990,1989,B,Other UK Airports,BELFAST INTERNATIONAL,GLASGOW,50107,49637,470,20441,20370,71,145.1298828
10/15/2008 10:35,1990,1989,B,Other UK Airports,BELFAST INTERNATIONAL,GUERNSEY,1055,1055,0,661,661,0,59.60665512
10/15/2008 10:35,1990,1989,B,Other UK Airports,BELFAST INTERNATIONAL,HUMBERSIDE,54,0,54,19,19,0,184.2105255
10/15/2008 10:35,1990,1989,B,Other UK Airports,BELFAST INTERNATIONAL,ISLE OF MAN,308,85,223,51,51,0,503.9215698
10/15/2008 10:35,1990,1989,B,Other UK Airports,BELFAST INTERNATIONAL,JERSEY,24133,23758,375,10635,9627,1008,126.9205475
10/15/2008 10:35,1990,1989,B,Other UK Airports,BELFAST INTERNATIONAL,KENT INTERNATIONAL,0,0,0,58,58,0,
10/15/2008 10:35,1990,1989,B,Other UK Airports,BELFAST INTERNATIONAL,LEEDS BRADFORD,75014,74856,158,22264,22191,73,236.9295654
10/15/2008 10:35,1990,1989,B,Other UK Airports,BELFAST INTERNATIONAL,LIVERPOOL,682,194,488,648,648,0,5.246913433
10/15/2008 10:35,1990,1989,B,Other UK Airports,BELFAST INTERNATIONAL,MANCHESTER,127889,127452,437,47122,46986,136,171.399765
10/15/2008 10:35,1990,1989,B,Other UK Airports,BELFAST INTERNATIONAL,NEWCASTLE,16388,16354,34,6421,6421,0,155.2250366
10/15/2008 10:35,1990,1989,B,Other UK Airports,BELFAST INTERNATIONAL,NEWQUAY,64,0,64,0,0,0,
10/15/2008 10:35,1990,1989,B,Other UK Airports,BELFAST INTERNATIONAL,PRESTWICK,120,38,82,0,0,0,
10/15/2008 10:35,1990,1989,B,Other UK Airports,BELFAST INTERNATIONAL,SOUTHAMPTON,24,0,24,0,0,0,
10/15/2008 10:35,1990,1989,B,Other UK Airports,BEMBRIDGE,JERSEY,324,0,324,264,0,264,22.72727203
10/15/2008 10:35,1990,1989,B,Other UK Airports,BEMBRIDGE,SOUTHAMPTON,0,0,0,71,71,0,
10/15/2008 10:35,1990,1989,B,Other UK Airports,BENBECULA,GLASGOW,20031,20031,0,10926,10926,0,83.33333588
10/15/2008 10:35,1990,1989,B,Other UK Airports,BENBECULA,GLENROTHES,55,55,0,0,0,0,
10/15/2008 10:35,1990,1989,B,Other UK Airports,BENBECULA,INVERNESS,32,15,17,0,0,0,
10/15/2008 10:35,1990,1989,B,Other UK Airports,BENBECULA,ST KILDA,390,0,390,25,0,25,1460
10/15/2008 10:35,1990,1989,B,Other UK Airports,BENBECULA,STORNOWAY,9783,9706,77,4217,4157,60,131.989563
10/15/2008 10:35,1990,1989,B,Other UK Airports,BENBECULA,TIREE,35,35,0,0,0,0,
10/15/2008 10:35,1990,1989,B,Other UK Airports,BIGGIN HILL,DURHAM TEES VALLEY,3,0,3,0,0,0,
10/15/2008 10:35,1990,1989,B,Other UK Airports,BIGGIN HILL,EDINBURGH,24,0,24,0,0,0,
10/15/2008 10:35,1990,1989,B,Other UK Airports,BIGGIN HILL,JERSEY,36,0,36,0,0,0,
10/15/2008 10:35,1990,1989,B,Other UK Airports,BIGGIN HILL,MANCHESTER,18,0,18,0,0,0,
10/15/2008 10:35,1990,1989,B,Other UK Airports,BIGGIN HILL,SOUTHAMPTON,17,0,17,0,0,0,
10/15/2008 10:35,1990,1989,B,Other UK Airports,BIRMINGHAM,BRISTOL,298,0,298,329,0,329,-9.422492027
10/15/2008 10:35,1990,1989,B,Other UK Airports,BIRMINGHAM,CARDIFF WALES,2,0,2,0,0,0,
10/15/2008 10:35,1990,1989,B,Other UK Airports,BIRMINGHAM,COVENTRY,0,0,0,48,48,0,
10/15/2008 10:35,1990,1989,B,Other UK Airports,BIRMINGHAM,DUNDEE,22,0,22,0,0,0,
10/15/2008 10:35,1990,1989,B,Other UK Airports,BIRMINGHAM,EAST MIDLANDS INTERNATIONAL,2763,2740,23,80,80,0,3353.75
10/15/2008 10:35,1990,1989,B,Other UK Airports,BIRMINGHAM,EDINBURGH,139071,138810,261,67439,67396,43,106.2174683
10/15/2008 10:35,1990,1989,B,Other UK Airports,BIRMINGHAM,EXETER,58,0,58,0,0,0,
10/15/2008 10:35,1990,1989,B,Other UK Airports,BIRMINGHAM,GLASGOW,165255,164702,553,71648,71078,570,130.6484528
10/15/2008 10:35,1990,1989,B,Other UK Airports,BIRMINGHAM,GUERNSEY,20093,19895,198,11135,10688,447,80.44903564
10/15/2008 10:35,1990,1989,B,Other UK Airports,BIRMINGHAM,INVERNESS,0,0,0,198,0,198,
10/15/2008 10:35,1990,1989,B,Other UK Airports,BIRMINGHAM,ISLE OF MAN,31933,31933,0,11633,11633,0,174.5035706
10/15/2008 10:35,1990,1989,B,Other UK Airports,BIRMINGHAM,JERSEY,105026,83288,21738,53213,40623,12590,97.36906433
10/15/2008 10:35,1990,1989,B,Other UK Airports,BIRMINGHAM,KIRKWALL,0,0,0,46,0,46,
10/15/2008 10:35,1990,1989,B,Other UK Airports,BIRMINGHAM,LIVERPOOL,68,22,46,41,41,0,65.85366058
10/15/2008 10:35,1990,1989,B,Other UK Airports,BIRMINGHAM,MANCHESTER,200,11,189,60,60,0,233.3333282
10/15/2008 10:35,1990,1989,B,Other UK Airports,BIRMINGHAM,NEWCASTLE,17972,16264,1708,5643,5569,74,218.483078
10/15/2008 10:35,1990,1989,B,Other UK Airports,BIRMINGHAM,NORWICH,0,0,0,144,0,144,
10/15/2008 10:35,1990,1989,B,Other UK Airports,BIRMINGHAM,PRESTWICK,57,0,57,90,0,90,-36.66666794
10/15/2008 10:35,1990,1989,B,Other UK Airports,BIRMINGHAM,SOUTHAMPTON,1405,1405,0,3232,3232,0,-56.52846527
10/15/2008 10:35,1990,1989,B,Other UK Airports,BLACKBUSHE,JERSEY,103,0,103,48,0,48,114.5833359
10/15/2008 10:35,1990,1989,B,Other UK Airports,BLACKPOOL,BRISTOL,17,0,17,0,0,0,
10/15/2008 10:35,1990,1989,B,Other UK Airports,BLACKPOOL,CITY OF DERRY (EGLINTON),0,0,0,486,486,0,
10/15/2008 10:35,1990,1989,B,Other UK Airports,BLACKPOOL,EDINBURGH,32,0,32,0,0,0,
10/15/2008 10:35,1990,1989,B,Other UK Airports,BLACKPOOL,EXETER,17,17,0,83,59,24,-79.51807404
10/15/2008 10:35,1990,1989,B,Other UK Airports,BLACKPOOL,GLASGOW,0,0,0,68,17,51,
10/15/2008 10:35,1990,1989,B,Other UK Airports,BLACKPOOL,GUERNSEY,0,0,0,87,0,87,
10/15/2008 10:35,1990,1989,B,Other UK Airports,BLACKPOOL,HATFIELD,0,0,0,63,0,63,
10/15/2008 10:35,1990,1989,B,Other UK Airports,BLACKPOOL,INVERNESS,0,0,0,8,0,8,
10/15/2008 10:35,1990,1989,B,Other UK Airports,BLACKPOOL,ISLE OF MAN,19619,19607,12,12034,11961,73,63.02975082
10/15/2008 10:35,1990,1989,B,Other UK Airports,BLACKPOOL,JERSEY,2747,2747,0,1990,1867,123,38.04019928
10/15/2008 10:35,1990,1989,B,Other UK Airports,BLACKPOOL,KINLOSS,0,0,0,7,0,7,
10/15/2008 10:35,1990,1989,B,Other UK Airports,BLACKPOOL,LEUCHARS,48,22,26,0,0,0,
10/15/2008 10:35,1990,1989,B,Other UK Airports,BLACKPOOL,MANCHESTER,379,0,379,0,0,0,
10/15/2008 10:35,1990,1989,B,Other UK Airports,BLACKPOOL,NEWCASTLE,0,0,0,14,0,14,
10/15/2008 10:35,1990,1989,B,Other UK Airports,BLACKPOOL,SCATSTA,32,32,0,0,0,0,
10/15/2008 10:35,1990,1989,B,Other UK Airports,BLACKPOOL,STORNOWAY,0,0,0,2,0,2,
10/15/2008 10:35,1990,1989,B,Other UK Airports,BOURNEMOUTH,DUNDEE,20,0,20,0,0,0,
10/15/2008 10:35,1990,1989,B,Other UK Airports,BOURNEMOUTH,EXETER,33,33,0,0,0,0,
10/15/2008 10:35,1990,1989,B,Other UK Airports,BOURNEMOUTH,GUERNSEY,39521,38532,989,10722,10240,482,268.59729
10/15/2008 10:35,1990,1989,B,Other UK Airports,BOURNEMOUTH,JERSEY,28879,27676,1203,29486,28492,994,-2.058604002
10/15/2008 10:35,1990,1989,B,Other UK Airports,BOURNEMOUTH,KENT INTERNATIONAL,33,0,33,0,0,0,
10/15/2008 10:35,1990,1989,B,Other UK Airports,BOURNEMOUTH,LEEDS BRADFORD,14,0,14,0,0,0,
10/15/2008 10:35,1990,1989,B,Other UK Airports,BOURNEMOUTH,MANCHESTER,1113,1035,78,2995,2995,0,-62.83806229
10/15/2008 10:35,1990,1989,B,Other UK Airports,BOURNEMOUTH,SOUTHAMPTON,88,0,88,42,9,33,109.5238113
10/15/2008 10:35,1990,1989,B,Other UK Airports,BRISTOL,CARDIFF WALES,17,0,17,71,0,71,-76.05633545
10/15/2008 10:35,1990,1989,B,Other UK Airports,BRISTOL,DURHAM TEES VALLEY,271,0,271,38,0,38,613.1578979
10/15/2008 10:35,1990,1989,B,Other UK Airports,BRISTOL,EAST MIDLANDS INTERNATIONAL,30,0,30,0,0,0,
10/15/2008 10:35,1990,1989,B,Other UK Airports,BRISTOL,EDINBURGH,1405,1381,24,0,0,0,
10/15/2008 10:35,1990,1989,B,Other UK Airports,BRISTOL,EXETER,83,45,38,0,0,0,
10/15/2008 10:35,1990,1989,B,Other UK Airports,BRISTOL,GLASGOW,8255,8171,84,5587,5587,0,47.75371552
10/15/2008 10:35,1990,1989,B,Other UK Airports,BRISTOL,GUERNSEY,10597,10448,149,2877,2820,57,268.335083
10/15/2008 10:35,1990,1989,B,Other UK Airports,BRISTOL,ISLES OF SCILLY (ST.MARYS),671,671,0,366,366,0,83.33333588
10/15/2008 10:35,1990,1989,B,Other UK Airports,BRISTOL,JERSEY,23320,20414,2906,14836,14782,54,57.18522644
10/15/2008 10:35,1990,1989,B,Other UK Airports,BRISTOL,LEEDS BRADFORD,72,72,0,37,37,0,94.59459686
10/15/2008 10:35,1990,1989,B,Other UK Airports,BRISTOL,MANCHESTER,7915,7714,201,0,0,0,
10/15/2008 10:35,1990,1989,B,Other UK Airports,BRISTOL,NEWCASTLE,0,0,0,67,0,67,
10/15/2008 10:35,1990,1989,B,Other UK Airports,BRISTOL,PERTH (UK),47,0,47,0,0,0,
10/15/2008 10:35,1990,1989,B,Other UK Airports,BRISTOL,PLYMOUTH,117,105,12,0,0,0,
10/15/2008 10:35,1990,1989,B,Other UK Airports,BRISTOL,PRIVATE STRIPS/HELIPADS,4,0,4,38,0,38,-89.47368622
10/15/2008 10:35,1990,1989,B,Other UK Airports,BRIZE NORTON,EAST MIDLANDS INTERNATIONAL,0,0,0,1,0,1,
10/15/2008 10:35,1990,1989,B,Other UK Airports,CAMBRIDGE,GUERNSEY,1685,1645,40,1073,1020,53,57.03634644
10/15/2008 10:35,1990,1989,B,Other UK Airports,CAMBRIDGE,JERSEY,4948,4948,0,3125,50,3075,58.33599854
10/15/2008 10:35,1990,1989,B,Other UK Airports,CAMBRIDGE,LEEDS BRADFORD,0,0,0,10,10,0,
10/15/2008 10:35,1990,1989,B,Other UK Airports,CAMBRIDGE,LIVERPOOL,0,0,0,66,66,0,
10/15/2008 10:35,1990,1989,B,Other UK Airports,CAMBRIDGE,MANCHESTER,8242,8242,0,3355,3355,0,145.6631927
10/15/2008 10:35,1990,1989,B,Other UK Airports,CAMBRIDGE,NORWICH,6,6,0,0,0,0,
10/15/2008 10:35,1990,1989,B,Other UK Airports,CAMBRIDGE,PRESTWICK,0,0,0,31,0,31,
10/15/2008 10:35,1990,1989,B,Other UK Airports,CAMBRIDGE,PRIVATE STRIPS/HELIPADS,18,18,0,0,0,0,
10/15/2008 10:35,1990,1989,B,Other UK Airports,CAMPBELTOWN,GLASGOW,10896,10896,0,5758,5758,0,89.2323761
10/15/2008 10:35,1990,1989,B,Other UK Airports,CAMPBELTOWN,KIRKWALL,0,0,0,7,7,0,
10/15/2008 10:35,1990,1989,B,Other UK Airports,CARDIFF WALES,EDINBURGH,188,0,188,0,0,0,
10/15/2008 10:35,1990,1989,B,Other UK Airports,CARDIFF WALES,GLASGOW,113,9,104,0,0,0,
10/15/2008 10:35,1990,1989,B,Other UK Airports,CARDIFF WALES,GLOUCESTERSHIRE,0,0,0,32,0,32,
10/15/2008 10:35,1990,1989,B,Other UK Airports,CARDIFF WALES,GUERNSEY,3280,3280,0,2051,2051,0,59.92198944
10/15/2008 10:35,1990,1989,B,Other UK Airports,CARDIFF WALES,ISLE OF MAN,199,13,186,0,0,0,
10/15/2008 10:35,1990,1989,B,Other UK Airports,CARDIFF WALES,JERSEY,13675,8306,5369,19918,19846,72,-31.34350777
10/15/2008 10:35,1990,1989,B,Other UK Airports,CARDIFF WALES,LEEDS BRADFORD,6210,6210,0,5745,5745,0,8.093995094
10/15/2008 10:35,1990,1989,B,Other UK Airports,CARDIFF WALES,LIVERPOOL,4925,4443,482,0,0,0,
10/15/2008 10:35,1990,1989,B,Other UK Airports,CARDIFF WALES,MANCHESTER,503,26,477,219,0,219,129.6803589
10/15/2008 10:35,1990,1989,B,Other UK Airports,CARDIFF WALES,NEWCASTLE,647,0,647,30,0,30,2056.666748
10/15/2008 10:35,1990,1989,B,Other UK Airports,CARDIFF WALES,PRESTWICK,0,0,0,2,2,0,
10/15/2008 10:35,1990,1989,B,Other UK Airports,CARLISLE,DURHAM TEES VALLEY,5,0,5,0,0,0,
10/15/2008 10:35,1990,1989,B,Other UK Airports,CITY OF DERRY (EGLINTON),MANCHESTER,0,0,0,7,7,0,
10/15/2008 10:35,1990,1989,B,Other UK Airports,COVENTRY,GLASGOW,27,27,0,45,45,0,-40
10/15/2008 10:35,1990,1989,B,Other UK Airports,COVENTRY,JERSEY,72,0,72,4505,4446,59,-98.40177917
10/15/2008 10:35,1990,1989,B,Other UK Airports,COVENTRY,KENT INTERNATIONAL,12,0,12,0,0,0,
10/15/2008 10:35,1990,1989,B,Other UK Airports,COVENTRY,MANCHESTER,2,2,0,0,0,0,
10/15/2008 10:35,1990,1989,B,Other UK Airports,COVENTRY,NEWCASTLE,7,7,0,12,12,0,-41.66666794
10/15/2008 10:35,1990,1989,B,Other UK Airports,COVENTRY,PRESTWICK,0,0,0,78,0,78,
10/15/2008 10:35,1990,1989,B,Other UK Airports,DONCASTER SHEFFIELD,HUMBERSIDE,35,0,35,0,0,0,
10/15/2008 10:35,1990,1989,B,Other UK Airports,DUNDEE,MANCHESTER,0,0,0,12,12,0,
10/15/2008 10:35,1990,1989,B,Other UK Airports,DURHAM TEES VALLEY,DURHAM TEES VALLEY,27,0,27,0,0,0,
10/15/2008 10:35,1990,1989,B,Other UK Airports,DURHAM TEES VALLEY,DUXFORD,12,0,12,0,0,0,
10/15/2008 10:35,1990,1989,B,Other UK Airports,DURHAM TEES VALLEY,EAST MIDLANDS INTERNATIONAL,55,55,0,0,0,0,
10/15/2008 10:35,1990,1989,B,Other UK Airports,DURHAM TEES VALLEY,EDINBURGH,49,0,49,5,5,0,880
10/15/2008 10:35,1990,1989,B,Other UK Airports,DURHAM TEES VALLEY,GLASGOW,0,0,0,98,98,0,
10/15/2008 10:35,1990,1989,B,Other UK Airports,DURHAM TEES VALLEY,GUERNSEY,77,77,0,0,0,0,
10/15/2008 10:35,1990,1989,B,Other UK Airports,DURHAM TEES VALLEY,HUMBERSIDE,510,510,0,444,441,3,14.8648653
10/15/2008 10:35,1990,1989,B,Other UK Airports,DURHAM TEES VALLEY,INVERNESS,24,24,0,0,0,0,
10/15/2008 10:35,1990,1989,B,Other UK Airports,DURHAM TEES VALLEY,JERSEY,13577,11175,2402,7638,7384,254,77.75595856
10/15/2008 10:35,1990,1989,B,Other UK Airports,DURHAM TEES VALLEY,LEEDS BRADFORD,133,133,0,47,47,0,182.9787292
10/15/2008 10:35,1990,1989,B,Other UK Airports,DURHAM TEES VALLEY,MANCHESTER,109,109,0,15,15,0,626.666687
10/15/2008 10:35,1990,1989,B,Other UK Airports,DURHAM TEES VALLEY,NEWCASTLE,224,224,0,91,91,0,146.1538391
10/15/2008 10:35,1990,1989,B,Other UK Airports,DURHAM TEES VALLEY,NORWICH,7760,7760,0,3609,3590,19,115.018013
10/15/2008 10:35,1990,1989,B,Other UK Airports,DURHAM TEES VALLEY,PRIVATE STRIPS/HELIPADS,165,37,128,85,85,0,94.11764526
10/15/2008 10:35,1990,1989,B,Other UK Airports,DURHAM TEES VALLEY,SWANSEA,0,0,0,43,0,43,
10/15/2008 10:35,1990,1989,B,Other UK Airports,EAST MIDLANDS INTERNATIONAL,EDINBURGH,17534,17123,411,2906,2704,202,503.372345
10/15/2008 10:35,1990,1989,B,Other UK Airports,EAST MIDLANDS INTERNATIONAL,EXETER,82,0,82,63,0,63,30.15872955
10/15/2008 10:35,1990,1989,B,Other UK Airports,EAST MIDLANDS INTERNATIONAL,GLASGOW,88796,88609,187,41825,41634,191,112.3036499
10/15/2008 10:35,1990,1989,B,Other UK Airports,EAST MIDLANDS INTERNATIONAL,GUERNSEY,25265,25008,257,16141,15777,364,56.52685547
10/15/2008 10:35,1990,1989,B,Other UK Airports,EAST MIDLANDS INTERNATIONAL,INVERNESS,0,0,0,43,20,23,
10/15/2008 10:35,1990,1989,B,Other UK Airports,EAST MIDLANDS INTERNATIONAL,JERSEY,82180,77330,4850,55428,49481,5947,48.26441574
10/15/2008 10:35,1990,1989,B,Other UK Airports,EAST MIDLANDS INTERNATIONAL,LEEDS BRADFORD,26,0,26,13,5,8,100
10/15/2008 10:35,1990,1989,B,Other UK Airports,EAST MIDLANDS INTERNATIONAL,LIVERPOOL,26,26,0,79,79,0,-67.08860779
10/15/2008 10:35,1990,1989,B,Other UK Airports,EAST MIDLANDS INTERNATIONAL,MANCHESTER,379,0,379,0,0,0,
10/15/2008 10:35,1990,1989,B,Other UK Airports,EAST MIDLANDS INTERNATIONAL,NEWCASTLE,277,0,277,0,0,0,
10/15/2008 10:35,1990,1989,B,Other UK Airports,EAST MIDLANDS INTERNATIONAL,PRESTWICK,502,0,502,0,0,0,
10/15/2008 10:35,1990,1989,B,Other UK Airports,EDAY,KIRKWALL,2740,2740,0,1297,1297,0,111.2567444
10/15/2008 10:35,1990,1989,B,Other UK Airports,EDINBURGH,EXETER,79,0,79,0,0,0,
10/15/2008 10:35,1990,1989,B,Other UK Airports,EDINBURGH,FAIROAKS,0,0,0,13,0,13,
10/15/2008 10:35,1990,1989,B,Other UK Airports,EDINBURGH,GLASGOW,136,127,9,417,397,20,-67.38609314
10/15/2008 10:35,1990,1989,B,Other UK Airports,EDINBURGH,GLOUCESTERSHIRE,17,0,17,0,0,0,
10/15/2008 10:35,1990,1989,B,Other UK Airports,EDINBURGH,GUERNSEY,2159,2159,0,1401,1401,0,54.1042099
10/15/2008 10:35,1990,1989,B,Other UK Airports,EDINBURGH,HUMBERSIDE,97,97,0,3369,3369,0,-97.12080383
10/15/2008 10:35,1990,1989,B,Other UK Airports,EDINBURGH,INVERNESS,369,16,353,29,29,0,1172.413818
10/15/2008 10:35,1990,1989,B,Other UK Airports,EDINBURGH,ISLAY,0,0,0,13,0,13,
10/15/2008 10:35,1990,1989,B,Other UK Airports,EDINBURGH,ISLE OF MAN,169,68,101,711,711,0,-76.23065948
10/15/2008 10:35,1990,1989,B,Other UK Airports,EDINBURGH,JERSEY,8545,2829,5716,7707,3284,4423,10.87323189
10/15/2008 10:35,1990,1989,B,Other UK Airports,EDINBURGH,KINLOSS,60,0,60,0,0,0,
10/15/2008 10:35,1990,1989,B,Other UK Airports,EDINBURGH,KIRKWALL,1839,1839,0,585,481,104,214.3589783
10/15/2008 10:35,1990,1989,B,Other UK Airports,EDINBURGH,LEEDS BRADFORD,41558,41482,76,17335,17095,240,139.7346344
10/15/2008 10:35,1990,1989,B,Other UK Airports,EDINBURGH,LERWICK (TINGWALL),8463,8318,145,4673,4673,0,81.10421753
10/15/2008 10:35,1990,1989,B,Other UK Airports,EDINBURGH,LIVERPOOL,24,0,24,735,0,735,-96.73469543
10/15/2008 10:35,1990,1989,B,Other UK Airports,EDINBURGH,MANCHESTER,98825,98508,317,48142,47926,216,105.2781372
10/15/2008 10:35,1990,1989,B,Other UK Airports,EDINBURGH,NEWCASTLE,110,31,79,87,29,58,26.43678093
10/15/2008 10:35,1990,1989,B,Other UK Airports,EDINBURGH,NORWICH,10169,10169,0,5345,5345,0,90.25257111
10/15/2008 10:35,1990,1989,B,Other UK Airports,EDINBURGH,PORTSMOUTH (UK),128,0,128,0,0,0,
10/15/2008 10:35,1990,1989,B,Other UK Airports,EDINBURGH,PRESTWICK,0,0,0,91,0,91,
10/15/2008 10:35,1990,1989,B,Other UK Airports,EDINBURGH,SOUTHAMPTON,0,0,0,468,0,468,
10/15/2008 10:35,1990,1989,B,Other UK Airports,EDINBURGH,STORNOWAY,168,0,168,0,0,0,
10/15/2008 10:35,1990,1989,B,Other UK Airports,EDINBURGH,SUMBURGH,0,0,0,28,28,0,
10/15/2008 10:35,1990,1989,B,Other UK Airports,EDINBURGH,UNST,18,18,0,10,10,0,80
10/15/2008 10:35,1990,1989,B,Other UK Airports,EDINBURGH,WICK,12342,12316,26,5799,5799,0,112.8297958
10/15/2008 10:35,1990,1989,B,Other UK Airports,EXETER,GUERNSEY,40726,40714,12,29008,29008,0,40.39575195
10/15/2008 10:35,1990,1989,B,Other UK Airports,EXETER,ISLES OF SCILLY (ST.MARYS),517,517,0,0,0,0,
10/15/2008 10:35,1990,1989,B,Other UK Airports,EXETER,JERSEY,48313,48285,28,22317,22278,39,116.4851913
10/15/2008 10:35,1990,1989,B,Other UK Airports,EXETER,LEEDS BRADFORD,0,0,0,14,0,14,
10/15/2008 10:35,1990,1989,B,Other UK Airports,EXETER,LIVERPOOL,22,22,0,0,0,0,
10/15/2008 10:35,1990,1989,B,Other UK Airports,EXETER,LYDD,40,0,40,0,0,0,
10/15/2008 10:35,1990,1989,B,Other UK Airports,EXETER,MANCHESTER,5095,5094,1,4476,4321,155,13.82931232
10/15/2008 10:35,1990,1989,B,Other UK Airports,EXETER,NEWCASTLE,0,0,0,204,160,44,
10/15/2008 10:35,1990,1989,B,Other UK Airports,EXETER,NEWQUAY,79,21,58,0,0,0,
10/15/2008 10:35,1990,1989,B,Other UK Airports,EXETER,NORWICH,262,0,262,29,29,0,803.4483032
10/15/2008 10:35,1990,1989,B,Other UK Airports,EXETER,PLYMOUTH,915,915,0,432,432,0,111.8055573
10/15/2008 10:35,1990,1989,B,Other UK Airports,EXETER,REDHILL,36,36,0,0,0,0,
10/15/2008 10:35,1990,1989,B,Other UK Airports,EXETER,WHITE WALTHAM,46,46,0,0,0,0,
10/15/2008 10:35,1990,1989,B,Other UK Airports,FAIR ISLE,KIRKWALL,254,254,0,170,170,0,49.41176605
10/15/2008 10:35,1990,1989,B,Other UK Airports,FAIR ISLE,SUMBURGH,569,26,543,2,2,0,28350
10/15/2008 10:35,1990,1989,B,Other UK Airports,FAIROAKS,JERSEY,43,0,43,33,0,33,30.30303001
10/15/2008 10:35,1990,1989,B,Other UK Airports,FETLAR,SUMBURGH,2,0,2,0,0,0,
10/15/2008 10:35,1990,1989,B,Other UK Airports,GLASGOW,GLASGOW,0,0,0,46,22,24,
10/15/2008 10:35,1990,1989,B,Other UK Airports,GLASGOW,GUERNSEY,2352,1605,747,5895,5544,351,-60.10177994
10/15/2008 10:35,1990,1989,B,Other UK Airports,GLASGOW,HUMBERSIDE,66,0,66,0,0,0,
10/15/2008 10:35,1990,1989,B,Other UK Airports,GLASGOW,INVERNESS,6731,6599,132,3081,2583,498,118.4680328
10/15/2008 10:35,1990,1989,B,Other UK Airports,GLASGOW,ISLAY,20711,20684,27,12821,12795,26,61.53966141
10/15/2008 10:35,1990,1989,B,Other UK Airports,GLASGOW,ISLE OF MAN,22449,21699,750,12256,12013,243,83.16742706
10/15/2008 10:35,1990,1989,B,Other UK Airports,GLASGOW,ISLE OF SKYE,0,0,0,6,5,1,
10/15/2008 10:35,1990,1989,B,Other UK Airports,GLASGOW,JERSEY,46580,20705,25875,29972,16216,13756,55.41171646
10/15/2008 10:35,1990,1989,B,Other UK Airports,GLASGOW,KIRKWALL,7052,7052,0,3803,3803,0,85.43255615
10/15/2008 10:35,1990,1989,B,Other UK Airports,GLASGOW,LEEDS BRADFORD,17364,16068,1296,5060,5043,17,243.1620483
10/15/2008 10:35,1990,1989,B,Other UK Airports,GLASGOW,LIVERPOOL,852,813,39,174,16,158,389.6551819
10/15/2008 10:35,1990,1989,B,Other UK Airports,GLASGOW,MANCHESTER,113345,112419,926,53779,53655,124,110.760704
10/15/2008 10:35,1990,1989,B,Other UK Airports,GLASGOW,NEWCASTLE,16,16,0,68,4,64,-76.47058868
10/15/2008 10:35,1990,1989,B,Other UK Airports,GLASGOW,NORWICH,0,0,0,24,24,0,
10/15/2008 10:35,1990,1989,B,Other UK Airports,GLASGOW,PRESTWICK,272,0,272,1651,40,1611,-83.52513885
10/15/2008 10:35,1990,1989,B,Other UK Airports,GLASGOW,PRIVATE STRIPS/HELIPADS,14,0,14,0,0,0,
10/15/2008 10:35,1990,1989,B,Other UK Airports,GLASGOW,SOUTHAMPTON,124,94,30,0,0,0,
10/15/2008 10:35,1990,1989,B,Other UK Airports,GLASGOW,STORNOWAY,42381,42381,0,19733,19691,42,114.7722092
10/15/2008 10:35,1990,1989,B,Other UK Airports,GLASGOW,SUMBURGH,30785,30694,91,17371,17340,31,77.22065735
10/15/2008 10:35,1990,1989,B,Other UK Airports,GLASGOW,TIREE,1287,1287,0,521,521,0,147.0249481
10/15/2008 10:35,1990,1989,B,Other UK Airports,GLASGOW,WICK,0,0,0,32,0,32,
10/15/2008 10:35,1990,1989,B,Other UK Airports,GLOUCESTERSHIRE,GUERNSEY,705,0,705,1725,26,1699,-59.13043594
10/15/2008 10:35,1990,1989,B,Other UK Airports,GLOUCESTERSHIRE,JERSEY,2784,0,2784,717,0,717,288.2845154
10/15/2008 10:35,1990,1989,B,Other UK Airports,GLOUCESTERSHIRE,SOUTHAMPTON,34,0,34,0,0,0,
10/15/2008 10:35,1990,1989,B,Other UK Airports,GUERNSEY,JERSEY,121,121,0,0,0,0,
10/15/2008 10:35,1990,1989,B,Other UK Airports,GUERNSEY,LEEDS BRADFORD,2,2,0,0,0,0,
10/15/2008 10:35,1990,1989,B,Other UK Airports,GUERNSEY,NEWCASTLE,46,46,0,0,0,0,
10/15/2008 10:35,1990,1989,B,Other UK Airports,GUERNSEY,NORWICH,22,22,0,0,0,0,
10/15/2008 10:35,1990,1989,B,Other UK Airports,GUERNSEY,SOUTHAMPTON,74,74,0,0,0,0,
10/15/2008 10:35,1990,1989,B,Other UK Airports,HATFIELD,KIRKWALL,3,3,0,0,0,0,
10/15/2008 10:35,1990,1989,B,Other UK Airports,HUCKNALL,LIVERPOOL,36,0,36,36,0,36,0
10/15/2008 10:35,1990,1989,B,Other UK Airports,HUMBERSIDE,JERSEY,6619,2494,4125,4412,1128,3284,50.02266693
10/15/2008 10:35,1990,1989,B,Other UK Airports,HUMBERSIDE,LEEDS BRADFORD,52,0,52,0,0,0,
10/15/2008 10:35,1990,1989,B,Other UK Airports,HUMBERSIDE,NORWICH,9466,9466,0,14111,14111,0,-32.91758347
10/15/2008 10:35,1990,1989,B,Other UK Airports,HUMBERSIDE,SOUTHAMPTON,36,0,36,0,0,0,
10/15/2008 10:35,1990,1989,B,Other UK Airports,INVERNESS,KIRKWALL,7963,7471,492,235,206,29,3288.510742
10/15/2008 10:35,1990,1989,B,Other UK Airports,INVERNESS,LEEDS BRADFORD,0,0,0,14,14,0,
10/15/2008 10:35,1990,1989,B,Other UK Airports,INVERNESS,LIVERPOOL,0,0,0,41,41,0,
10/15/2008 10:35,1990,1989,B,Other UK Airports,INVERNESS,MANCHESTER,878,878,0,350,203,147,150.8571472
10/15/2008 10:35,1990,1989,B,Other UK Airports,INVERNESS,NEWCASTLE,42,27,15,0,0,0,
10/15/2008 10:35,1990,1989,B,Other UK Airports,INVERNESS,STORNOWAY,22121,22044,77,12241,12130,111,80.71235657
10/15/2008 10:35,1990,1989,B,Other UK Airports,INVERNESS,SUMBURGH,10782,10692,90,5715,5686,29,88.6614151
10/15/2008 10:35,1990,1989,B,Other UK Airports,INVERNESS,WICK,39,39,0,0,0,0,
10/15/2008 10:35,1990,1989,B,Other UK Airports,ISLAY,ISLAY,13,13,0,0,0,0,
10/15/2008 10:35,1990,1989,B,Other UK Airports,ISLE OF MAN,JERSEY,890,361,529,67,67,0,1228.358154
10/15/2008 10:35,1990,1989,B,Other UK Airports,ISLE OF MAN,KIRKWALL,20,20,0,0,0,0,
10/15/2008 10:35,1990,1989,B,Other UK Airports,ISLE OF MAN,LEEDS BRADFORD,1655,1354,301,1755,867,888,-5.698005676
10/15/2008 10:35,1990,1989,B,Other UK Airports,ISLE OF MAN,LIVERPOOL,136041,135542,499,75415,74909,506,80.38983917
10/15/2008 10:35,1990,1989,B,Other UK Airports,ISLE OF MAN,MANCHESTER,79509,79363,146,40110,39970,140,98.22737122
10/15/2008 10:35,1990,1989,B,Other UK Airports,ISLE OF MAN,NEWCASTLE,1171,1171,0,766,766,0,52.87206268
10/15/2008 10:35,1990,1989,B,Other UK Airports,ISLE OF MAN,PRESTWICK,0,0,0,72,35,37,
10/15/2008 10:35,1990,1989,B,Other UK Airports,ISLE OF MAN,PRIVATE STRIPS/HELIPADS,0,0,0,43,0,43,
10/15/2008 10:35,1990,1989,B,Other UK Airports,ISLE OF MAN,SOUTHAMPTON,48,0,48,0,0,0,
10/15/2008 10:35,1990,1989,B,Other UK Airports,JERSEY,JERSEY,89,89,0,0,0,0,
10/15/2008 10:35,1990,1989,B,Other UK Airports,JERSEY,KENT INTERNATIONAL,2174,0,2174,1420,0,1420,53.09859085
10/15/2008 10:35,1990,1989,B,Other UK Airports,JERSEY,LANDS END (ST JUST),0,0,0,23,0,23,
10/15/2008 10:35,1990,1989,B,Other UK Airports,JERSEY,LEEDS BRADFORD,24929,22257,2672,18396,18372,24,35.51315689
10/15/2008 10:35,1990,1989,B,Other UK Airports,JERSEY,LIVERPOOL,16973,10581,6392,12001,6760,5241,41.42988205
10/15/2008 10:35,1990,1989,B,Other UK Airports,JERSEY,LYDD,1905,158,1747,1079,0,1079,76.55236053
10/15/2008 10:35,1990,1989,B,Other UK Airports,JERSEY,MANCHESTER,122804,107111,15693,63031,41998,21033,94.83111572
10/15/2008 10:35,1990,1989,B,Other UK Airports,JERSEY,NEWCASTLE,16399,16399,0,12388,12388,0,32.37810898
10/15/2008 10:35,1990,1989,B,Other UK Airports,JERSEY,NORWICH,14357,10776,3581,8691,7883,808,65.19387817
10/15/2008 10:35,1990,1989,B,Other UK Airports,JERSEY,PLYMOUTH,17501,17409,92,12055,12016,39,45.17627716
10/15/2008 10:35,1990,1989,B,Other UK Airports,JERSEY,SANDOWN,0,0,0,43,0,43,
10/15/2008 10:35,1990,1989,B,Other UK Airports,JERSEY,SHOBDON,91,0,91,0,0,0,
10/15/2008 10:35,1990,1989,B,Other UK Airports,JERSEY,SOUTHAMPTON,243555,242161,1394,145285,144336,949,67.63946533
10/15/2008 10:35,1990,1989,B,Other UK Airports,JERSEY,SWANSEA,95,0,95,56,0,56,69.64286041
10/15/2008 10:35,1990,1989,B,Other UK Airports,JERSEY,TOLLERTON NOTTINGHAM,0,0,0,64,0,64,
10/15/2008 10:35,1990,1989,B,Other UK Airports,JERSEY,WOODFORD,44,0,44,0,0,0,
10/15/2008 10:35,1990,1989,B,Other UK Airports,KENT INTERNATIONAL,LEEDS BRADFORD,0,0,0,62,0,62,
10/15/2008 10:35,1990,1989,B,Other UK Airports,KENT INTERNATIONAL,LYDD,81,0,81,0,0,0,
10/15/2008 10:35,1990,1989,B,Other UK Airports,KINLOSS,KIRKWALL,0,0,0,59,59,0,
10/15/2008 10:35,1990,1989,B,Other UK Airports,KINLOSS,STORNOWAY,0,0,0,39,39,0,
10/15/2008 10:35,1990,1989,B,Other UK Airports,KIRKWALL,NORTH RONALDSAY,2905,2905,0,1603,1603,0,81.22270966
10/15/2008 10:35,1990,1989,B,Other UK Airports,KIRKWALL,PAPA WESTRAY,2647,2647,0,1168,1168,0,126.626709
10/15/2008 10:35,1990,1989,B,Other UK Airports,KIRKWALL,ROCHESTER (UK),0,0,0,7,7,0,
10/15/2008 10:35,1990,1989,B,Other UK Airports,KIRKWALL,SANDAY,6103,6103,0,2979,2979,0,104.8674088
10/15/2008 10:35,1990,1989,B,Other UK Airports,KIRKWALL,STORNOWAY,82,19,63,17,0,17,382.3529358
10/15/2008 10:35,1990,1989,B,Other UK Airports,KIRKWALL,STRONSAY,5354,5354,0,2547,2547,0,110.2080917
10/15/2008 10:35,1990,1989,B,Other UK Airports,KIRKWALL,SUMBURGH,11375,11365,10,5490,5416,74,107.1949005
10/15/2008 10:35,1990,1989,B,Other UK Airports,KIRKWALL,UNST,19,0,19,0,0,0,
10/15/2008 10:35,1990,1989,B,Other UK Airports,KIRKWALL,WESTRAY,6642,6533,109,3314,3314,0,100.4224472
10/15/2008 10:35,1990,1989,B,Other UK Airports,KIRKWALL,WICK,17518,17498,20,9409,9409,0,86.18344116
10/15/2008 10:35,1990,1989,B,Other UK Airports,KIRKWALL,WYTON,2,2,0,0,0,0,
10/15/2008 10:35,1990,1989,B,Other UK Airports,LEEDS BRADFORD,LEEDS BRADFORD,11,11,0,0,0,0,
10/15/2008 10:35,1990,1989,B,Other UK Airports,LEEDS BRADFORD,LIVERPOOL,0,0,0,85,85,0,
10/15/2008 10:35,1990,1989,B,Other UK Airports,LEEDS BRADFORD,MANCHESTER,75,75,0,40,40,0,87.5
10/15/2008 10:35,1990,1989,B,Other UK Airports,LEEDS BRADFORD,METRO LONDON HELIPORT,11,0,11,0,0,0,
10/15/2008 10:35,1990,1989,B,Other UK Airports,LEEDS BRADFORD,NEWCASTLE,25,16,9,4,0,4,525
10/15/2008 10:35,1990,1989,B,Other UK Airports,LEEDS BRADFORD,NORWICH,5385,5385,0,336,336,0,1502.678589
10/15/2008 10:35,1990,1989,B,Other UK Airports,LEEDS BRADFORD,PRESTWICK,2,2,0,62,62,0,-96.77419281
10/15/2008 10:35,1990,1989,B,Other UK Airports,LEEDS BRADFORD,PRIVATE STRIPS/HELIPADS,9,9,0,38,29,9,-76.31578827
10/15/2008 10:35,1990,1989,B,Other UK Airports,LEEDS BRADFORD,SOUTHAMPTON,4012,4012,0,0,0,0,
10/15/2008 10:35,1990,1989,B,Other UK Airports,LEUCHARS,NEWCASTLE,36,0,36,0,0,0,
10/15/2008 10:35,1990,1989,B,Other UK Airports,LIVERPOOL,LIVERPOOL,0,0,0,1,1,0,
10/15/2008 10:35,1990,1989,B,Other UK Airports,LIVERPOOL,MANCHESTER,196,0,196,472,0,472,-58.47457504
10/15/2008 10:35,1990,1989,B,Other UK Airports,LIVERPOOL,NEWTOWNARDS,0,0,0,35,0,35,
10/15/2008 10:35,1990,1989,B,Other UK Airports,LIVERPOOL,NORTHOLT,3,0,3,0,0,0,
10/15/2008 10:35,1990,1989,B,Other UK Airports,MANCHESTER,MANCHESTER,0,0,0,291,9,282,
10/15/2008 10:35,1990,1989,B,Other UK Airports,MANCHESTER,NEWCASTLE,13857,13429,428,5566,5566,0,148.957962
10/15/2008 10:35,1990,1989,B,Other UK Airports,MANCHESTER,NORTHOLT,0,0,0,25,25,0,
10/15/2008 10:35,1990,1989,B,Other UK Airports,MANCHESTER,PLYMOUTH,38,0,38,0,0,0,
10/15/2008 10:35,1990,1989,B,Other UK Airports,MANCHESTER,PRESTWICK,70,0,70,60,60,0,16.66666603
10/15/2008 10:35,1990,1989,B,Other UK Airports,MANCHESTER,SOUTHAMPTON,836,0,836,0,0,0,
10/15/2008 10:35,1990,1989,B,Other UK Airports,MANCHESTER,SUMBURGH,37183,37110,73,19296,19296,0,92.69796753
10/15/2008 10:35,1990,1989,B,Other UK Airports,NEWCASTLE,NEWCASTLE,0,0,0,9,9,0,
10/15/2008 10:35,1990,1989,B,Other UK Airports,NEWCASTLE,NORWICH,5,0,5,0,0,0,
10/15/2008 10:35,1990,1989,B,Other UK Airports,NEWCASTLE,PLYMOUTH,131,0,131,0,0,0,
10/15/2008 10:35,1990,1989,B,Other UK Airports,NEWCASTLE,PRESTWICK,0,0,0,60,0,60,
10/15/2008 10:35,1990,1989,B,Other UK Airports,NEWCASTLE,SOUTHAMPTON,91,0,91,0,0,0,
10/15/2008 10:35,1990,1989,B,Other UK Airports,NEWQUAY,NORWICH,0,0,0,75,0,75,
10/15/2008 10:35,1990,1989,B,Other UK Airports,NEWQUAY,SOUTHAMPTON,0,0,0,33,0,33,
10/15/2008 10:35,1990,1989,B,Other UK Airports,NORWICH,NORWICH,0,0,0,10,0,10,
10/15/2008 10:35,1990,1989,B,Other UK Airports,NORWICH,PRIVATE STRIPS/HELIPADS,3,0,3,0,0,0,
10/15/2008 10:35,1990,1989,B,Other UK Airports,NORWICH,SOUTHAMPTON,40,40,0,0,0,0,
10/15/2008 10:35,1990,1989,B,Other UK Airports,NORWICH,THRUXTON,0,0,0,36,36,0,
10/15/2008 10:35,1990,1989,B,Other UK Airports,NORWICH,WICK,0,0,0,30,30,0,
10/15/2008 10:35,1990,1989,B,Other UK Airports,PLYMOUTH,SOUTHAMPTON,46,0,46,1,0,1,4500
10/15/2008 10:35,1990,1989,B,Other UK Airports,PRESTWICK,STORNOWAY,41,0,41,13,0,13,215.384613
10/15/2008 10:35,1990,1989,B,Other UK Airports,PRESTWICK,SUMBURGH,0,0,0,72,0,72,
10/15/2008 10:35,1990,1989,B,Other UK Airports,PRESTWICK,WICK,0,0,0,30,0,30,
10/15/2008 10:35,1990,1989,B,Other UK Airports,PRIVATE STRIPS/HELIPADS,SOUTHAMPTON,51,51,0,48,48,0,6.25
10/15/2008 10:35,1990,1989,B,Other UK Airports,PRIVATE STRIPS/HELIPADS,SUMBURGH,52,0,52,0,0,0,
10/15/2008 10:35,1990,1989,B,Other UK Airports,PRIVATE STRIPS/HELIPADS,WICK,0,0,0,44,0,44,
10/15/2008 10:35,1990,1989,B,Other UK Airports,SOUTHAMPTON,WHITE WALTHAM,0,0,0,201,201,0,
10/15/2008 10:35,1990,1989,B,Other UK Airports,SOUTHAMPTON,WOODVALE,0,0,0,76,76,0,
10/15/2008 10:35,1990,1989,B,Other UK Airports,STORNOWAY,SUMBURGH,63,0,63,0,0,0,
10/15/2008 10:35,1990,1989,B,Other UK Airports,STRONSAY,WICK,1,1,0,0,0,0,
10/15/2008 10:35,1990,1989,B,Other UK Airports,SUMBURGH,UNST,3195,17,3178,952,0,952,235.6092377
10/15/2008 10:35,1990,1989,B,Other UK Airports,SUMBURGH,WELLESBOURNE MOUNTFORD,16,0,16,0,0,0,
10/15/2008 10:35,1990,1989,B,Other UK Airports,SUMBURGH,WICK,2599,2482,117,6181,6017,164,-57.95178604
