rundate,this_period,last_period,grp_cd,grp_name,apt1_apt_name,apt2_apt_name,total_pax_tp,total_pax_shd_tp,total_pax_cht_tp,total_pax_lp,total_pax_shd_lp,total_pax_cht_lp,total_pax_pc
31/03/2004 18:09,2003,2002,A,London Area Airports,GATWICK,ABERDEEN,254671,254669,2,241050,241050,0,5.650694847
31/03/2004 18:09,2003,2002,A,London Area Airports,GATWICK,BELFAST CITY,239864,239796,68,286971,286971,0,-16.41524696
31/03/2004 18:09,2003,2002,A,London Area Airports,GATWICK,BELFAST INTERNATIONAL,219460,219460,0,0,0,0,
31/03/2004 18:09,2003,2002,A,London Area Airports,GATWICK,BLACKPOOL,0,0,0,47,0,47,
31/03/2004 18:09,2003,2002,A,London Area Airports,GATWICK,BOURNEMOUTH,0,0,0,5,0,5,
31/03/2004 18:09,2003,2002,A,London Area Airports,GATWICK,BRISTOL,0,0,0,5253,5253,0,
31/03/2004 18:09,2003,2002,A,London Area Airports,GATWICK,CARDIFF WALES,75,0,75,1568,0,1568,-95.21683502
31/03/2004 18:09,2003,2002,A,London Area Airports,GATWICK,EAST MIDLANDS,147,0,147,0,0,0,
31/03/2004 18:09,2003,2002,A,London Area Airports,GATWICK,EDINBURGH,771050,770486,564,679439,679428,11,13.48332977
31/03/2004 18:09,2003,2002,A,London Area Airports,GATWICK,GLASGOW,387840,387151,689,338463,337315,1148,14.58859634
31/03/2004 18:09,2003,2002,A,London Area Airports,GATWICK,GUERNSEY,326893,326893,0,314017,314017,0,4.100414753
31/03/2004 18:09,2003,2002,A,London Area Airports,GATWICK,INVERNESS,224472,224426,46,158929,158852,77,41.24042892
31/03/2004 18:09,2003,2002,A,London Area Airports,GATWICK,ISLE OF MAN,121587,121587,0,85979,85979,0,41.4147644
31/03/2004 18:09,2003,2002,A,London Area Airports,GATWICK,JERSEY,545313,544833,480,534081,533672,409,2.103051901
31/03/2004 18:09,2003,2002,A,London Area Airports,GATWICK,LEEDS BRADFORD,8392,8384,8,35955,35931,24,-76.65971375
31/03/2004 18:09,2003,2002,A,London Area Airports,GATWICK,MANCHESTER,442020,437963,4057,426083,421914,4169,3.740350962
31/03/2004 18:09,2003,2002,A,London Area Airports,GATWICK,NEWCASTLE,256387,256387,0,210832,210561,271,21.60725212
31/03/2004 18:09,2003,2002,A,London Area Airports,GATWICK,NEWQUAY,48349,48349,0,47637,47637,0,1.494636536
31/03/2004 18:09,2003,2002,A,London Area Airports,GATWICK,PLYMOUTH,57445,57445,0,58553,58553,0,-1.892302752
31/03/2004 18:09,2003,2002,A,London Area Airports,GATWICK,WADDINGTON,0,0,0,47,0,47,
31/03/2004 18:09,2003,2002,A,London Area Airports,HEATHROW,ABERDEEN,507290,507290,0,514703,514703,0,-1.440248013
31/03/2004 18:09,2003,2002,A,London Area Airports,HEATHROW,BELFAST CITY,784822,784822,0,670837,670837,0,16.9914608
31/03/2004 18:09,2003,2002,A,London Area Airports,HEATHROW,BELFAST INTERNATIONAL,26835,26327,508,305043,304787,256,-91.20288086
31/03/2004 18:09,2003,2002,A,London Area Airports,HEATHROW,BIRMINGHAM,198,0,198,0,0,0,
31/03/2004 18:09,2003,2002,A,London Area Airports,HEATHROW,CARDIFF WALES,572,0,572,736,0,736,-22.28260803
31/03/2004 18:09,2003,2002,A,London Area Airports,HEATHROW,DUNDEE,0,0,0,1,0,1,
31/03/2004 18:09,2003,2002,A,London Area Airports,HEATHROW,EAST MIDLANDS,7,0,7,0,0,0,
31/03/2004 18:09,2003,2002,A,London Area Airports,HEATHROW,EDINBURGH,1661897,1661169,728,1603397,1603385,12,3.64850378
31/03/2004 18:09,2003,2002,A,London Area Airports,HEATHROW,EXETER,2,0,2,0,0,0,
31/03/2004 18:09,2003,2002,A,London Area Airports,HEATHROW,FAIRFORD,0,0,0,680,0,680,
31/03/2004 18:09,2003,2002,A,London Area Airports,HEATHROW,FAIROAKS,0,0,0,14,0,14,
31/03/2004 18:09,2003,2002,A,London Area Airports,HEATHROW,FILTON,100,0,100,0,0,0,
31/03/2004 18:09,2003,2002,A,London Area Airports,HEATHROW,GLASGOW,1465222,1465188,34,1448294,1448294,0,1.168823481
31/03/2004 18:09,2003,2002,A,London Area Airports,HEATHROW,GLOUCESTERSHIRE,4,0,4,0,0,0,
31/03/2004 18:09,2003,2002,A,London Area Airports,HEATHROW,ISLE OF MAN,0,0,0,27635,27635,0,
31/03/2004 18:09,2003,2002,A,London Area Airports,HEATHROW,JERSEY,165,0,165,2,0,2,8150
31/03/2004 18:09,2003,2002,A,London Area Airports,HEATHROW,LEEDS BRADFORD,181043,180953,90,181697,181697,0,-0.359939903
31/03/2004 18:09,2003,2002,A,London Area Airports,HEATHROW,LIVERPOOL,0,0,0,64,0,64,
31/03/2004 18:09,2003,2002,A,London Area Airports,HEATHROW,MANCHESTER,1385320,1385069,251,1305072,1304956,116,6.148932934
31/03/2004 18:09,2003,2002,A,London Area Airports,HEATHROW,NEWCASTLE,494685,494656,29,464033,463963,70,6.605564594
31/03/2004 18:09,2003,2002,A,London Area Airports,HEATHROW,OXFORD (KIDLINGTON),1,0,1,0,0,0,
31/03/2004 18:09,2003,2002,A,London Area Airports,HEATHROW,TEESSIDE,145665,145665,0,152929,152929,0,-4.749916553
31/03/2004 18:09,2003,2002,A,London Area Airports,HEATHROW,WATTISHAM,4,0,4,0,0,0,
31/03/2004 18:09,2003,2002,A,London Area Airports,HEATHROW,WICK,25,0,25,0,0,0,
31/03/2004 18:09,2003,2002,A,London Area Airports,LONDON CITY,ABERDEEN,1,0,1,106,104,2,-99.05660248
31/03/2004 18:09,2003,2002,A,London Area Airports,LONDON CITY,BELFAST CITY,43325,43325,0,81902,81902,0,-47.10141373
31/03/2004 18:09,2003,2002,A,London Area Airports,LONDON CITY,BRISTOL,10,0,10,0,0,0,
31/03/2004 18:09,2003,2002,A,London Area Airports,LONDON CITY,CARDIFF WALES,99,99,0,0,0,0,
31/03/2004 18:09,2003,2002,A,London Area Airports,LONDON CITY,DUNDEE,48062,48062,0,45667,45667,0,5.244487286
31/03/2004 18:09,2003,2002,A,London Area Airports,LONDON CITY,EDINBURGH,117658,117491,167,137042,136962,80,-14.14456844
31/03/2004 18:09,2003,2002,A,London Area Airports,LONDON CITY,EXETER,1,0,1,0,0,0,
31/03/2004 18:09,2003,2002,A,London Area Airports,LONDON CITY,GLASGOW,28244,28244,0,1098,1098,0,2472.313232
31/03/2004 18:09,2003,2002,A,London Area Airports,LONDON CITY,GLOUCESTERSHIRE,48,0,48,0,0,0,
31/03/2004 18:09,2003,2002,A,London Area Airports,LONDON CITY,GUERNSEY,0,0,0,56,0,56,
31/03/2004 18:09,2003,2002,A,London Area Airports,LONDON CITY,INVERNESS,0,0,0,49,49,0,
31/03/2004 18:09,2003,2002,A,London Area Airports,LONDON CITY,ISLE OF MAN,29251,29251,0,41725,41725,0,-29.89574623
31/03/2004 18:09,2003,2002,A,London Area Airports,LONDON CITY,JERSEY,47442,47440,2,88094,88094,0,-46.14616394
31/03/2004 18:09,2003,2002,A,London Area Airports,LONDON CITY,LEEDS BRADFORD,1,0,1,0,0,0,
31/03/2004 18:09,2003,2002,A,London Area Airports,LONDON CITY,LIVERPOOL,52,0,52,0,0,0,
31/03/2004 18:09,2003,2002,A,London Area Airports,LONDON CITY,MANCHESTER,97154,97154,0,22652,22652,0,328.8981018
31/03/2004 18:09,2003,2002,A,London Area Airports,LONDON CITY,NEWQUAY,0,0,0,127,0,127,
31/03/2004 18:09,2003,2002,A,London Area Airports,LONDON CITY,NORWICH,0,0,0,32,0,32,
31/03/2004 18:09,2003,2002,A,London Area Airports,LONDON CITY,PLYMOUTH,0,0,0,35,0,35,
31/03/2004 18:09,2003,2002,A,London Area Airports,LONDON CITY,SWANSEA,14733,14733,0,0,0,0,
31/03/2004 18:09,2003,2002,A,London Area Airports,LUTON,ABERDEEN,159089,159089,0,163732,163732,0,-2.835731506
31/03/2004 18:09,2003,2002,A,London Area Airports,LUTON,BEDFORD(THURLEIGH),2,0,2,0,0,0,
31/03/2004 18:09,2003,2002,A,London Area Airports,LUTON,BELFAST INTERNATIONAL,405114,404970,144,407997,407997,0,-0.706622839
31/03/2004 18:09,2003,2002,A,London Area Airports,LUTON,BIGGIN HILL,5,0,5,0,0,0,
31/03/2004 18:09,2003,2002,A,London Area Airports,LUTON,BIRMINGHAM,59,0,59,47,0,47,25.53191566
31/03/2004 18:09,2003,2002,A,London Area Airports,LUTON,BLACKPOOL,88,0,88,28,0,28,214.2857208
31/03/2004 18:09,2003,2002,A,London Area Airports,LUTON,BOURNEMOUTH,6,0,6,0,0,0,
31/03/2004 18:09,2003,2002,A,London Area Airports,LUTON,BRIZE NORTON,0,0,0,1,0,1,
31/03/2004 18:09,2003,2002,A,London Area Airports,LUTON,CAMBRIDGE,0,0,0,1,0,1,
31/03/2004 18:09,2003,2002,A,London Area Airports,LUTON,CARDIFF WALES,1045,0,1045,1626,0,1626,-35.7318573
31/03/2004 18:09,2003,2002,A,London Area Airports,LUTON,EAST MIDLANDS,10,0,10,11,0,11,-9.090909004
31/03/2004 18:09,2003,2002,A,London Area Airports,LUTON,EDINBURGH,485228,484856,372,502140,502011,129,-3.36798501
31/03/2004 18:09,2003,2002,A,London Area Airports,LUTON,FARNBOROUGH,4,0,4,0,0,0,
31/03/2004 18:09,2003,2002,A,London Area Airports,LUTON,GLASGOW,475013,474318,695,509827,509775,52,-6.82859087
31/03/2004 18:09,2003,2002,A,London Area Airports,LUTON,GUERNSEY,6,0,6,14,0,14,-57.1428566
31/03/2004 18:09,2003,2002,A,London Area Airports,LUTON,INVERNESS,112411,112380,31,111775,111743,32,0.569000244
31/03/2004 18:09,2003,2002,A,London Area Airports,LUTON,ISLE OF MAN,39233,39168,65,37107,36878,229,5.72937727
31/03/2004 18:09,2003,2002,A,London Area Airports,LUTON,JERSEY,22109,22107,2,8967,8712,255,146.5596008
31/03/2004 18:09,2003,2002,A,London Area Airports,LUTON,LEEDS BRADFORD,61,0,61,128,0,128,-52.34375
31/03/2004 18:09,2003,2002,A,London Area Airports,LUTON,LIVERPOOL,310,26,284,529,343,186,-41.39886475
31/03/2004 18:09,2003,2002,A,London Area Airports,LUTON,MANCHESTER,1267,0,1267,1117,0,1117,13.42882729
31/03/2004 18:09,2003,2002,A,London Area Airports,LUTON,NEWCASTLE,163,0,163,110,0,110,48.18181992
31/03/2004 18:09,2003,2002,A,London Area Airports,LUTON,NEWQUAY,7,0,7,58,0,58,-87.9310379
31/03/2004 18:09,2003,2002,A,London Area Airports,LUTON,PRESTWICK,42,0,42,0,0,0,
31/03/2004 18:09,2003,2002,A,London Area Airports,LUTON,SOUTHAMPTON,15,0,15,0,0,0,
31/03/2004 18:09,2003,2002,A,London Area Airports,LUTON,SOUTHEND,31,0,31,0,0,0,
31/03/2004 18:09,2003,2002,A,London Area Airports,LUTON,TEESSIDE,141,0,141,0,0,0,
31/03/2004 18:09,2003,2002,A,London Area Airports,LUTON,WICK,0,0,0,117,0,117,
31/03/2004 18:09,2003,2002,A,London Area Airports,SOUTHEND,GUERNSEY,0,0,0,1482,0,1482,
31/03/2004 18:09,2003,2002,A,London Area Airports,SOUTHEND,JERSEY,2340,0,2340,2245,0,2245,4.231626034
31/03/2004 18:09,2003,2002,A,London Area Airports,SOUTHEND,TEESSIDE,0,0,0,30,0,30,
31/03/2004 18:09,2003,2002,A,London Area Airports,STANSTED,ABERDEEN,0,0,0,6,0,6,
31/03/2004 18:09,2003,2002,A,London Area Airports,STANSTED,BELFAST CITY,0,0,0,16,0,16,
31/03/2004 18:09,2003,2002,A,London Area Airports,STANSTED,BELFAST INTERNATIONAL,402430,402362,68,391480,391480,0,2.797077656
31/03/2004 18:09,2003,2002,A,London Area Airports,STANSTED,BIRMINGHAM,0,0,0,47,0,47,
31/03/2004 18:09,2003,2002,A,London Area Airports,STANSTED,BLACKPOOL,69480,69480,0,51,0,51,136135.2969
31/03/2004 18:09,2003,2002,A,London Area Airports,STANSTED,BRISTOL,253,0,253,0,0,0,
31/03/2004 18:09,2003,2002,A,London Area Airports,STANSTED,CARDIFF WALES,246,0,246,2532,0,2532,-90.28436279
31/03/2004 18:09,2003,2002,A,London Area Airports,STANSTED,CITY OF DERRY (EGLINTON),133290,133290,0,134475,134475,0,-0.881204665
31/03/2004 18:09,2003,2002,A,London Area Airports,STANSTED,EDINBURGH,499856,499325,531,513380,513232,148,-2.634305954
31/03/2004 18:09,2003,2002,A,London Area Airports,STANSTED,EXETER,41,0,41,0,0,0,
31/03/2004 18:09,2003,2002,A,London Area Airports,STANSTED,FAIROAKS,0,0,0,188,0,188,
31/03/2004 18:09,2003,2002,A,London Area Airports,STANSTED,GLASGOW,377854,377582,272,334497,334497,0,12.96185017
31/03/2004 18:09,2003,2002,A,London Area Airports,STANSTED,GUERNSEY,42553,42553,0,47749,47749,0,-10.88190365
31/03/2004 18:09,2003,2002,A,London Area Airports,STANSTED,INVERNESS,0,0,0,2255,0,2255,
31/03/2004 18:09,2003,2002,A,London Area Airports,STANSTED,JERSEY,3631,0,3631,4358,0,4358,-16.68196487
31/03/2004 18:09,2003,2002,A,London Area Airports,STANSTED,KINLOSS,0,0,0,69,0,69,
31/03/2004 18:09,2003,2002,A,London Area Airports,STANSTED,LEEDS BRADFORD,132,0,132,35,0,35,277.1428528
31/03/2004 18:09,2003,2002,A,London Area Airports,STANSTED,LIVERPOOL,0,0,0,467,0,467,
31/03/2004 18:09,2003,2002,A,London Area Airports,STANSTED,MANCHESTER,22255,21168,1087,33624,31138,2486,-33.81215668
31/03/2004 18:09,2003,2002,A,London Area Airports,STANSTED,NEWCASTLE,298943,298844,99,221569,220857,712,34.92095184
31/03/2004 18:09,2003,2002,A,London Area Airports,STANSTED,NEWQUAY,130124,130095,29,76477,76477,0,70.14788818
31/03/2004 18:09,2003,2002,A,London Area Airports,STANSTED,PRESTWICK,721082,721041,41,694224,694224,0,3.868780136
31/03/2004 18:09,2003,2002,A,London Area Airports,STANSTED,TEESSIDE,61,0,61,304,0,304,-79.93421173
31/03/2004 18:09,2003,2002,B,Other UK Airports,ABERDEEN,BELFAST CITY,132,132,0,8616,8616,0,-98.46796417
31/03/2004 18:09,2003,2002,B,Other UK Airports,ABERDEEN,BELFAST INTERNATIONAL,3967,3967,0,0,0,0,
31/03/2004 18:09,2003,2002,B,Other UK Airports,ABERDEEN,BIRMINGHAM,62288,62288,0,52324,52324,0,19.04288673
31/03/2004 18:09,2003,2002,B,Other UK Airports,ABERDEEN,BRISTOL,401,401,0,24774,24774,0,-98.38137054
31/03/2004 18:09,2003,2002,B,Other UK Airports,ABERDEEN,CARDIFF WALES,87,87,0,3393,3393,0,-97.43589783
31/03/2004 18:09,2003,2002,B,Other UK Airports,ABERDEEN,COVENTRY,0,0,0,73,0,73,
31/03/2004 18:09,2003,2002,B,Other UK Airports,ABERDEEN,EAST MIDLANDS,14370,14370,0,14221,14217,4,1.047746301
31/03/2004 18:09,2003,2002,B,Other UK Airports,ABERDEEN,EDINBURGH,11,0,11,80,0,80,-86.25
31/03/2004 18:09,2003,2002,B,Other UK Airports,ABERDEEN,FARNBOROUGH,2,0,2,5,0,5,-60
31/03/2004 18:09,2003,2002,B,Other UK Airports,ABERDEEN,GLASGOW,5176,5176,0,3922,3922,0,31.97348213
31/03/2004 18:09,2003,2002,B,Other UK Airports,ABERDEEN,GUERNSEY,177,0,177,0,0,0,
31/03/2004 18:09,2003,2002,B,Other UK Airports,ABERDEEN,HUMBERSIDE,28043,28043,0,28931,28925,6,-3.069371939
31/03/2004 18:09,2003,2002,B,Other UK Airports,ABERDEEN,JERSEY,1596,0,1596,1761,0,1761,-9.36967659
31/03/2004 18:09,2003,2002,B,Other UK Airports,ABERDEEN,KIRKWALL,40465,40465,0,40287,40287,0,0.44182986
31/03/2004 18:09,2003,2002,B,Other UK Airports,ABERDEEN,LEEDS BRADFORD,12271,12271,0,12825,12825,0,-4.31968832
31/03/2004 18:09,2003,2002,B,Other UK Airports,ABERDEEN,LIVERPOOL,41,0,41,0,0,0,
31/03/2004 18:09,2003,2002,B,Other UK Airports,ABERDEEN,MANCHESTER,125291,125283,8,150674,150674,0,-16.84630394
31/03/2004 18:09,2003,2002,B,Other UK Airports,ABERDEEN,NEWCASTLE,19618,19618,0,46254,46254,0,-57.58637238
31/03/2004 18:09,2003,2002,B,Other UK Airports,ABERDEEN,NORTHOLT,17,0,17,0,0,0,
31/03/2004 18:09,2003,2002,B,Other UK Airports,ABERDEEN,NORWICH,60745,60745,0,52244,52202,42,16.2717247
31/03/2004 18:09,2003,2002,B,Other UK Airports,ABERDEEN,PLYMOUTH,3,3,0,1184,1184,0,-99.74662018
31/03/2004 18:09,2003,2002,B,Other UK Airports,ABERDEEN,SCATSTA,126138,0,126138,139370,0,139370,-9.494152069
31/03/2004 18:09,2003,2002,B,Other UK Airports,ABERDEEN,SOUTHAMPTON,18755,18755,0,10021,10021,0,87.15696716
31/03/2004 18:09,2003,2002,B,Other UK Airports,ABERDEEN,STORNOWAY,0,0,0,191,0,191,
31/03/2004 18:09,2003,2002,B,Other UK Airports,ABERDEEN,SUMBURGH,63043,62341,702,75731,71079,4652,-16.75403786
31/03/2004 18:09,2003,2002,B,Other UK Airports,ABERDEEN,TEESSIDE,19573,19573,0,18914,18914,0,3.484191656
31/03/2004 18:09,2003,2002,B,Other UK Airports,ABERDEEN,WICK,6619,6237,382,7342,7342,0,-9.847453117
31/03/2004 18:09,2003,2002,B,Other UK Airports,ALDERNEY,BOURNEMOUTH,7732,7732,0,7260,7260,0,6.501377583
31/03/2004 18:09,2003,2002,B,Other UK Airports,ALDERNEY,GUERNSEY,30850,30850,0,31059,31059,0,-0.672912836
31/03/2004 18:09,2003,2002,B,Other UK Airports,ALDERNEY,JERSEY,9356,9356,0,9136,9136,0,2.408056021
31/03/2004 18:09,2003,2002,B,Other UK Airports,ALDERNEY,SOUTHAMPTON,24154,24154,0,25462,25462,0,-5.137066841
31/03/2004 18:09,2003,2002,B,Other UK Airports,BARRA,BENBECULA,2453,2453,0,2767,2767,0,-11.34803009
31/03/2004 18:09,2003,2002,B,Other UK Airports,BARRA,GLASGOW,5865,5865,0,5547,5547,0,5.732828617
31/03/2004 18:09,2003,2002,B,Other UK Airports,BELFAST CITY,BIRMINGHAM,248071,248071,0,194203,194173,30,27.73798561
31/03/2004 18:09,2003,2002,B,Other UK Airports,BELFAST CITY,BLACKPOOL,13021,12988,33,3531,3512,19,268.7623901
31/03/2004 18:09,2003,2002,B,Other UK Airports,BELFAST CITY,BRISTOL,63933,63933,0,66363,66363,0,-3.661679029
31/03/2004 18:09,2003,2002,B,Other UK Airports,BELFAST CITY,CARDIFF WALES,6167,6167,0,10823,10823,0,-43.01949692
31/03/2004 18:09,2003,2002,B,Other UK Airports,BELFAST CITY,EAST MIDLANDS,0,0,0,78425,78357,68,
31/03/2004 18:09,2003,2002,B,Other UK Airports,BELFAST CITY,EDINBURGH,57751,57623,128,42827,42797,30,34.8471756
31/03/2004 18:09,2003,2002,B,Other UK Airports,BELFAST CITY,EXETER,1282,1282,0,1756,1756,0,-26.99316597
31/03/2004 18:09,2003,2002,B,Other UK Airports,BELFAST CITY,GLASGOW,55494,55494,0,49040,49040,0,13.16068554
31/03/2004 18:09,2003,2002,B,Other UK Airports,BELFAST CITY,ISLE OF MAN,32930,32879,51,39913,39847,66,-17.49555206
31/03/2004 18:09,2003,2002,B,Other UK Airports,BELFAST CITY,JERSEY,8345,8345,0,10363,10363,0,-19.47312546
31/03/2004 18:09,2003,2002,B,Other UK Airports,BELFAST CITY,LEEDS BRADFORD,126042,126042,0,93764,93715,49,34.42472458
31/03/2004 18:09,2003,2002,B,Other UK Airports,BELFAST CITY,MANCHESTER,148458,148458,0,143618,143618,0,3.370051146
31/03/2004 18:09,2003,2002,B,Other UK Airports,BELFAST CITY,NEWCASTLE,88479,88479,0,103372,103372,0,-14.40718937
31/03/2004 18:09,2003,2002,B,Other UK Airports,BELFAST CITY,SHEFFIELD CITY,0,0,0,10409,10409,0,
31/03/2004 18:09,2003,2002,B,Other UK Airports,BELFAST CITY,SOUTHAMPTON,64969,64933,36,20293,20293,0,220.1547394
31/03/2004 18:09,2003,2002,B,Other UK Airports,BELFAST INTERNATIONAL,BIRMINGHAM,127397,126996,401,112689,112473,216,13.05185032
31/03/2004 18:09,2003,2002,B,Other UK Airports,BELFAST INTERNATIONAL,BRISTOL,211879,211791,88,163812,163812,0,29.34278297
31/03/2004 18:09,2003,2002,B,Other UK Airports,BELFAST INTERNATIONAL,CARDIFF WALES,66361,66361,0,10253,10051,202,547.2349854
31/03/2004 18:09,2003,2002,B,Other UK Airports,BELFAST INTERNATIONAL,COVENTRY,202,0,202,0,0,0,
31/03/2004 18:09,2003,2002,B,Other UK Airports,BELFAST INTERNATIONAL,EAST MIDLANDS,146685,146685,0,18970,18941,29,673.2472534
31/03/2004 18:09,2003,2002,B,Other UK Airports,BELFAST INTERNATIONAL,EDINBURGH,269906,269845,61,336981,336891,90,-19.90468216
31/03/2004 18:09,2003,2002,B,Other UK Airports,BELFAST INTERNATIONAL,GLASGOW,321532,321322,210,379706,379558,148,-15.32080078
31/03/2004 18:09,2003,2002,B,Other UK Airports,BELFAST INTERNATIONAL,JERSEY,1509,0,1509,1343,0,1343,12.36038685
31/03/2004 18:09,2003,2002,B,Other UK Airports,BELFAST INTERNATIONAL,LEEDS BRADFORD,12385,12264,121,82,0,82,15003.6582
31/03/2004 18:09,2003,2002,B,Other UK Airports,BELFAST INTERNATIONAL,LIVERPOOL,563042,563042,0,544907,544801,106,3.328090906
31/03/2004 18:09,2003,2002,B,Other UK Airports,BELFAST INTERNATIONAL,MANCHESTER,105477,105164,313,450,0,450,23339.33398
31/03/2004 18:09,2003,2002,B,Other UK Airports,BELFAST INTERNATIONAL,NEWCASTLE,104204,103891,313,0,0,0,
31/03/2004 18:09,2003,2002,B,Other UK Airports,BELFAST INTERNATIONAL,SOUTHAMPTON,35,0,35,0,0,0,
31/03/2004 18:09,2003,2002,B,Other UK Airports,BELFAST INTERNATIONAL,SWANSEA,18,0,18,0,0,0,
31/03/2004 18:09,2003,2002,B,Other UK Airports,BELFAST INTERNATIONAL,TEESSIDE,6408,6408,0,0,0,0,
31/03/2004 18:09,2003,2002,B,Other UK Airports,BENBECULA,GLASGOW,20520,20498,22,19642,19642,0,4.470013142
31/03/2004 18:09,2003,2002,B,Other UK Airports,BENBECULA,STORNOWAY,8965,8965,0,9141,9141,0,-1.925391078
31/03/2004 18:09,2003,2002,B,Other UK Airports,BIGGIN HILL,LEEDS BRADFORD,70,0,70,22,0,22,218.1818237
31/03/2004 18:09,2003,2002,B,Other UK Airports,BIGGIN HILL,NEWCASTLE,0,0,0,80,0,80,
31/03/2004 18:09,2003,2002,B,Other UK Airports,BIGGIN HILL,TEESSIDE,0,0,0,56,0,56,
31/03/2004 18:09,2003,2002,B,Other UK Airports,BIGGIN HILL,WOODFORD,0,0,0,42,0,42,
31/03/2004 18:09,2003,2002,B,Other UK Airports,BIRMINGHAM,BRISTOL,67,0,67,0,0,0,
31/03/2004 18:09,2003,2002,B,Other UK Airports,BIRMINGHAM,EDINBURGH,373402,373037,365,334934,334199,735,11.48524761
31/03/2004 18:09,2003,2002,B,Other UK Airports,BIRMINGHAM,GLASGOW,361351,361000,351,315997,315483,514,14.35266781
31/03/2004 18:09,2003,2002,B,Other UK Airports,BIRMINGHAM,GUERNSEY,48177,48177,0,46914,46914,0,2.69216013
31/03/2004 18:09,2003,2002,B,Other UK Airports,BIRMINGHAM,INVERNESS,1564,1564,0,0,0,0,
31/03/2004 18:09,2003,2002,B,Other UK Airports,BIRMINGHAM,ISLE OF MAN,71287,71287,0,49988,49935,53,42.60822678
31/03/2004 18:09,2003,2002,B,Other UK Airports,BIRMINGHAM,JERSEY,96913,89141,7772,87674,78272,9402,10.53790188
31/03/2004 18:09,2003,2002,B,Other UK Airports,BIRMINGHAM,KINLOSS,218,0,218,244,0,244,-10.65573788
31/03/2004 18:09,2003,2002,B,Other UK Airports,BIRMINGHAM,MANCHESTER,1232,0,1232,77,0,77,1500
31/03/2004 18:09,2003,2002,B,Other UK Airports,BIRMINGHAM,NEWCASTLE,27159,27159,0,30361,30361,0,-10.54642487
31/03/2004 18:09,2003,2002,B,Other UK Airports,BLACKPOOL,CARDIFF WALES,0,0,0,330,0,330,
31/03/2004 18:09,2003,2002,B,Other UK Airports,BLACKPOOL,EXETER,0,0,0,1,0,1,
31/03/2004 18:09,2003,2002,B,Other UK Airports,BLACKPOOL,ISLE OF MAN,11006,11006,0,10935,10765,170,0.649291277
31/03/2004 18:09,2003,2002,B,Other UK Airports,BLACKPOOL,JERSEY,2026,0,2026,623,0,623,225.2006378
31/03/2004 18:09,2003,2002,B,Other UK Airports,BLACKPOOL,SOUTHAMPTON,66,0,66,0,0,0,
31/03/2004 18:09,2003,2002,B,Other UK Airports,BOURNEMOUTH,EDINBURGH,60,0,60,129,0,129,-53.4883728
31/03/2004 18:09,2003,2002,B,Other UK Airports,BOURNEMOUTH,EXETER,0,0,0,7,0,7,
31/03/2004 18:09,2003,2002,B,Other UK Airports,BOURNEMOUTH,GUERNSEY,2198,2198,0,0,0,0,
31/03/2004 18:09,2003,2002,B,Other UK Airports,BOURNEMOUTH,ISLES OF SCILLY (ST.MARYS),526,526,0,0,0,0,
31/03/2004 18:09,2003,2002,B,Other UK Airports,BOURNEMOUTH,JERSEY,10097,5128,4969,9473,1226,8247,6.587142467
31/03/2004 18:09,2003,2002,B,Other UK Airports,BOURNEMOUTH,LEEDS BRADFORD,24,0,24,0,0,0,
31/03/2004 18:09,2003,2002,B,Other UK Airports,BOURNEMOUTH,MANCHESTER,0,0,0,50,0,50,
31/03/2004 18:09,2003,2002,B,Other UK Airports,BOURNEMOUTH,NEWCASTLE,0,0,0,18,18,0,
31/03/2004 18:09,2003,2002,B,Other UK Airports,BOURNEMOUTH,PLOCKTON,865,0,865,0,0,0,
31/03/2004 18:09,2003,2002,B,Other UK Airports,BOURNEMOUTH,PRESTWICK,85006,85006,0,0,0,0,
31/03/2004 18:09,2003,2002,B,Other UK Airports,BRISTOL,CARDIFF WALES,0,0,0,123,0,123,
31/03/2004 18:09,2003,2002,B,Other UK Airports,BRISTOL,EAST MIDLANDS,272,0,272,0,0,0,
31/03/2004 18:09,2003,2002,B,Other UK Airports,BRISTOL,EDINBURGH,324393,324393,0,298416,298416,0,8.704961777
31/03/2004 18:09,2003,2002,B,Other UK Airports,BRISTOL,EXETER,0,0,0,96,0,96,
31/03/2004 18:09,2003,2002,B,Other UK Airports,BRISTOL,GLASGOW,292955,292714,241,265940,265784,156,10.15830612
31/03/2004 18:09,2003,2002,B,Other UK Airports,BRISTOL,GUERNSEY,14074,14074,0,1588,1588,0,786.2720337
31/03/2004 18:09,2003,2002,B,Other UK Airports,BRISTOL,ISLE OF MAN,17029,17029,0,15363,15363,0,10.84423637
31/03/2004 18:09,2003,2002,B,Other UK Airports,BRISTOL,ISLES OF SCILLY (ST.MARYS),4876,4876,0,3667,3667,0,32.96973038
31/03/2004 18:09,2003,2002,B,Other UK Airports,BRISTOL,JERSEY,24398,24398,0,24481,23546,935,-0.339038432
31/03/2004 18:09,2003,2002,B,Other UK Airports,BRISTOL,LEEDS BRADFORD,55,55,0,3060,3060,0,-98.20261383
31/03/2004 18:09,2003,2002,B,Other UK Airports,BRISTOL,MANCHESTER,434,0,434,1393,0,1393,-68.84422302
31/03/2004 18:09,2003,2002,B,Other UK Airports,BRISTOL,NEWCASTLE,111908,111908,0,39955,39955,0,180.0850983
31/03/2004 18:09,2003,2002,B,Other UK Airports,BRISTOL,PLYMOUTH,2584,2584,0,14991,14991,0,-82.76299286
31/03/2004 18:09,2003,2002,B,Other UK Airports,BRIZE NORTON,EDINBURGH,91,0,91,0,0,0,
31/03/2004 18:09,2003,2002,B,Other UK Airports,CAMBRIDGE,DUNDEE,3,0,3,0,0,0,
31/03/2004 18:09,2003,2002,B,Other UK Airports,CAMBRIDGE,TEESSIDE,0,0,0,54,0,54,
31/03/2004 18:09,2003,2002,B,Other UK Airports,CAMPBELTOWN,GLASGOW,8225,8225,0,8142,8142,0,1.019405603
31/03/2004 18:09,2003,2002,B,Other UK Airports,CAMPBELTOWN,ISLAY,11,11,0,0,0,0,
31/03/2004 18:09,2003,2002,B,Other UK Airports,CARDIFF WALES,EAST MIDLANDS,0,0,0,120,0,120,
31/03/2004 18:09,2003,2002,B,Other UK Airports,CARDIFF WALES,EDINBURGH,132310,123464,8846,29063,28922,141,355.2523804
31/03/2004 18:09,2003,2002,B,Other UK Airports,CARDIFF WALES,GLASGOW,53876,53876,0,19047,18979,68,182.8582001
31/03/2004 18:09,2003,2002,B,Other UK Airports,CARDIFF WALES,JERSEY,42246,42231,15,24072,22917,1155,75.49850464
31/03/2004 18:09,2003,2002,B,Other UK Airports,CARDIFF WALES,LEEDS BRADFORD,296,0,296,389,0,389,-23.90745544
31/03/2004 18:09,2003,2002,B,Other UK Airports,CARDIFF WALES,LIVERPOOL,49,0,49,95,0,95,-48.42105103
31/03/2004 18:09,2003,2002,B,Other UK Airports,CARDIFF WALES,MANCHESTER,2615,0,2615,266,0,266,883.0827026
31/03/2004 18:09,2003,2002,B,Other UK Airports,CARDIFF WALES,NEWCASTLE,542,542,0,1780,1689,91,-69.55056
31/03/2004 18:09,2003,2002,B,Other UK Airports,CARDIFF WALES,NORWICH,0,0,0,1926,0,1926,
31/03/2004 18:09,2003,2002,B,Other UK Airports,CARDIFF WALES,PLYMOUTH,70,70,0,0,0,0,
31/03/2004 18:09,2003,2002,B,Other UK Airports,CARDIFF WALES,PRESTWICK,36292,36292,0,0,0,0,
31/03/2004 18:09,2003,2002,B,Other UK Airports,CARDIFF WALES,SWANSEA,783,783,0,0,0,0,
31/03/2004 18:09,2003,2002,B,Other UK Airports,CITY OF DERRY (EGLINTON),EDINBURGH,328,0,328,0,0,0,
31/03/2004 18:09,2003,2002,B,Other UK Airports,CITY OF DERRY (EGLINTON),GLASGOW,15466,15466,0,0,0,0,
31/03/2004 18:09,2003,2002,B,Other UK Airports,CITY OF DERRY (EGLINTON),MANCHESTER,14610,14534,76,0,0,0,
31/03/2004 18:09,2003,2002,B,Other UK Airports,COVENTRY,EDINBURGH,58,0,58,0,0,0,
31/03/2004 18:09,2003,2002,B,Other UK Airports,COVENTRY,TEESSIDE,20,0,20,0,0,0,
31/03/2004 18:09,2003,2002,B,Other UK Airports,COVENTRY,WICK,74,0,74,0,0,0,
31/03/2004 18:09,2003,2002,B,Other UK Airports,DENHAM,TEESSIDE,0,0,0,212,0,212,
31/03/2004 18:09,2003,2002,B,Other UK Airports,DUNDEE,JERSEY,1616,0,1616,1300,0,1300,24.30769157
31/03/2004 18:09,2003,2002,B,Other UK Airports,DUNDEE,MANCHESTER,1381,1381,0,1080,1080,0,27.87037086
31/03/2004 18:09,2003,2002,B,Other UK Airports,DUNKESWELL,JERSEY,5,0,5,0,0,0,
31/03/2004 18:09,2003,2002,B,Other UK Airports,EAST MIDLANDS,EDINBURGH,315550,315482,68,188183,188183,0,67.68251801
31/03/2004 18:09,2003,2002,B,Other UK Airports,EAST MIDLANDS,GLASGOW,267796,267747,49,177314,177279,35,51.02924728
31/03/2004 18:09,2003,2002,B,Other UK Airports,EAST MIDLANDS,GUERNSEY,11344,11344,0,10610,10610,0,6.918001652
31/03/2004 18:09,2003,2002,B,Other UK Airports,EAST MIDLANDS,HUMBERSIDE,0,0,0,159,0,159,
31/03/2004 18:09,2003,2002,B,Other UK Airports,EAST MIDLANDS,ISLE OF MAN,5904,5904,0,1239,1239,0,376.5133057
31/03/2004 18:09,2003,2002,B,Other UK Airports,EAST MIDLANDS,JERSEY,62837,58932,3905,58294,54507,3787,7.793254852
31/03/2004 18:09,2003,2002,B,Other UK Airports,EAST MIDLANDS,WICK,0,0,0,48,0,48,
31/03/2004 18:09,2003,2002,B,Other UK Airports,EDAY,KIRKWALL,464,464,0,446,446,0,4.035874367
31/03/2004 18:09,2003,2002,B,Other UK Airports,EDINBURGH,EXETER,0,0,0,1,0,1,
31/03/2004 18:09,2003,2002,B,Other UK Airports,EDINBURGH,FARNBOROUGH,72,0,72,247,0,247,-70.85020447
31/03/2004 18:09,2003,2002,B,Other UK Airports,EDINBURGH,GLASGOW,330,122,208,657,589,68,-49.77169037
31/03/2004 18:09,2003,2002,B,Other UK Airports,EDINBURGH,GUERNSEY,0,0,0,33,33,0,
31/03/2004 18:09,2003,2002,B,Other UK Airports,EDINBURGH,HAYDOCK PARK,0,0,0,91,0,91,
31/03/2004 18:09,2003,2002,B,Other UK Airports,EDINBURGH,HUMBERSIDE,0,0,0,2784,2784,0,
31/03/2004 18:09,2003,2002,B,Other UK Airports,EDINBURGH,INVERNESS,12701,12626,75,8118,7810,308,56.45479202
31/03/2004 18:09,2003,2002,B,Other UK Airports,EDINBURGH,ISLE OF MAN,12689,12689,0,3760,3760,0,237.4734039
31/03/2004 18:09,2003,2002,B,Other UK Airports,EDINBURGH,JERSEY,20120,18042,2078,13602,12047,1555,47.91942215
31/03/2004 18:09,2003,2002,B,Other UK Airports,EDINBURGH,KIRKWALL,20446,20446,0,28004,27977,27,-26.98900223
31/03/2004 18:09,2003,2002,B,Other UK Airports,EDINBURGH,LEEDS BRADFORD,55127,54998,129,49677,49677,0,10.97087193
31/03/2004 18:09,2003,2002,B,Other UK Airports,EDINBURGH,LIVERPOOL,1,0,1,0,0,0,
31/03/2004 18:09,2003,2002,B,Other UK Airports,EDINBURGH,MANCHESTER,209159,208892,267,190317,190107,210,9.900323868
31/03/2004 18:09,2003,2002,B,Other UK Airports,EDINBURGH,NEWCASTLE,12,0,12,7,0,7,71.42857361
31/03/2004 18:09,2003,2002,B,Other UK Airports,EDINBURGH,NORTHOLT,59,0,59,29,0,29,103.4482727
31/03/2004 18:09,2003,2002,B,Other UK Airports,EDINBURGH,NORWICH,19460,19457,3,22184,22098,86,-12.27912045
31/03/2004 18:09,2003,2002,B,Other UK Airports,EDINBURGH,PLYMOUTH,0,0,0,1836,1836,0,
31/03/2004 18:09,2003,2002,B,Other UK Airports,EDINBURGH,SOUTHAMPTON,98382,98382,0,68326,68326,0,43.98911285
31/03/2004 18:09,2003,2002,B,Other UK Airports,EDINBURGH,STORNOWAY,24267,24267,0,13285,13285,0,82.66465759
31/03/2004 18:09,2003,2002,B,Other UK Airports,EDINBURGH,SUMBURGH,15186,15186,0,16663,16663,0,-8.863949776
31/03/2004 18:09,2003,2002,B,Other UK Airports,EDINBURGH,TEESSIDE,17,0,17,0,0,0,
31/03/2004 18:09,2003,2002,B,Other UK Airports,EDINBURGH,WICK,5831,5831,0,96,22,74,5973.958496
31/03/2004 18:09,2003,2002,B,Other UK Airports,EXETER,GLASGOW,0,0,0,41,41,0,
31/03/2004 18:09,2003,2002,B,Other UK Airports,EXETER,GUERNSEY,30506,30506,0,30328,30328,0,0.586916387
31/03/2004 18:09,2003,2002,B,Other UK Airports,EXETER,ISLES OF SCILLY (ST.MARYS),4089,4089,0,4467,4467,0,-8.462055206
31/03/2004 18:09,2003,2002,B,Other UK Airports,EXETER,JERSEY,43521,43521,0,44361,44361,0,-1.893555164
31/03/2004 18:09,2003,2002,B,Other UK Airports,FAIR ISLE,LERWICK  (TINGWALL),2066,2066,0,2075,2075,0,-0.433734953
31/03/2004 18:09,2003,2002,B,Other UK Airports,FAIR ISLE,SUMBURGH,185,185,0,208,208,0,-11.05769253
31/03/2004 18:09,2003,2002,B,Other UK Airports,FAIRFORD,NORWICH,0,0,0,58,0,58,
31/03/2004 18:09,2003,2002,B,Other UK Airports,FARNBOROUGH,GLASGOW,27,0,27,4,0,4,575
31/03/2004 18:09,2003,2002,B,Other UK Airports,FARNBOROUGH,GUERNSEY,22,0,22,4,0,4,450
31/03/2004 18:09,2003,2002,B,Other UK Airports,FARNBOROUGH,HUMBERSIDE,0,0,0,4,0,4,
31/03/2004 18:09,2003,2002,B,Other UK Airports,FARNBOROUGH,ISLE OF MAN,49,0,49,0,0,0,
31/03/2004 18:09,2003,2002,B,Other UK Airports,FARNBOROUGH,JERSEY,9,0,9,21,0,21,-57.1428566
31/03/2004 18:09,2003,2002,B,Other UK Airports,FARNBOROUGH,NEWCASTLE,8,0,8,0,0,0,
31/03/2004 18:09,2003,2002,B,Other UK Airports,FARNBOROUGH,PRESTWICK,0,0,0,198,0,198,
31/03/2004 18:09,2003,2002,B,Other UK Airports,FARNBOROUGH,SOUTHAMPTON,0,0,0,70,0,70,
31/03/2004 18:09,2003,2002,B,Other UK Airports,FARNBOROUGH,TEESSIDE,6,0,6,7,0,7,-14.28571415
31/03/2004 18:09,2003,2002,B,Other UK Airports,FILTON,GLASGOW,10,0,10,0,0,0,
31/03/2004 18:09,2003,2002,B,Other UK Airports,FILTON,LIVERPOOL,0,0,0,42,0,42,
31/03/2004 18:09,2003,2002,B,Other UK Airports,GLASGOW,INVERNESS,21423,21337,86,27717,27717,0,-22.70808601
31/03/2004 18:09,2003,2002,B,Other UK Airports,GLASGOW,ISLAY,21512,21512,0,20833,20833,0,3.259252071
31/03/2004 18:09,2003,2002,B,Other UK Airports,GLASGOW,ISLE OF MAN,18076,18076,0,23958,23958,0,-24.55129814
31/03/2004 18:09,2003,2002,B,Other UK Airports,GLASGOW,JERSEY,13238,13238,0,13737,13424,313,-3.632525206
31/03/2004 18:09,2003,2002,B,Other UK Airports,GLASGOW,KIRKWALL,5750,5750,0,5363,5363,0,7.216110229
31/03/2004 18:09,2003,2002,B,Other UK Airports,GLASGOW,LEEDS BRADFORD,42247,42085,162,39216,38907,309,7.728988171
31/03/2004 18:09,2003,2002,B,Other UK Airports,GLASGOW,LIVERPOOL,557,0,557,0,0,0,
31/03/2004 18:09,2003,2002,B,Other UK Airports,GLASGOW,MANCHESTER,169246,166439,2807,143698,143101,597,17.77895355
31/03/2004 18:09,2003,2002,B,Other UK Airports,GLASGOW,NEWCASTLE,169,0,169,2,0,2,8350
31/03/2004 18:09,2003,2002,B,Other UK Airports,GLASGOW,NEWQUAY,426,0,426,0,0,0,
31/03/2004 18:09,2003,2002,B,Other UK Airports,GLASGOW,NORTHOLT,9,0,9,0,0,0,
31/03/2004 18:09,2003,2002,B,Other UK Airports,GLASGOW,PLYMOUTH,341,341,0,748,748,0,-54.41176605
31/03/2004 18:09,2003,2002,B,Other UK Airports,GLASGOW,SOUTHAMPTON,77305,77305,0,66187,66167,20,16.7978611
31/03/2004 18:09,2003,2002,B,Other UK Airports,GLASGOW,STORNOWAY,45918,45918,0,47823,47823,0,-3.983438969
31/03/2004 18:09,2003,2002,B,Other UK Airports,GLASGOW,SUMBURGH,15435,15435,0,12411,12327,84,24.36548233
31/03/2004 18:09,2003,2002,B,Other UK Airports,GLASGOW,TIREE,5325,5325,0,5302,5302,0,0.433798581
31/03/2004 18:09,2003,2002,B,Other UK Airports,GUERNSEY,ISLE OF MAN,509,0,509,0,0,0,
31/03/2004 18:09,2003,2002,B,Other UK Airports,GUERNSEY,JERSEY,136260,136260,0,148894,148857,37,-8.4852314
31/03/2004 18:09,2003,2002,B,Other UK Airports,GUERNSEY,LIVERPOOL,0,0,0,3,0,3,
31/03/2004 18:09,2003,2002,B,Other UK Airports,GUERNSEY,MANCHESTER,54288,54288,0,51259,51259,0,5.90920639
31/03/2004 18:09,2003,2002,B,Other UK Airports,GUERNSEY,NORTHOLT,8,0,8,0,0,0,
31/03/2004 18:09,2003,2002,B,Other UK Airports,GUERNSEY,OXFORD (KIDLINGTON),8,0,8,0,0,0,
31/03/2004 18:09,2003,2002,B,Other UK Airports,GUERNSEY,PRIVATE STRIPS/HELIPADS,1,0,1,0,0,0,
31/03/2004 18:09,2003,2002,B,Other UK Airports,GUERNSEY,SOUTHAMPTON,138507,138430,77,116939,116939,0,18.44380379
31/03/2004 18:09,2003,2002,B,Other UK Airports,GUERNSEY,SUMBURGH,88,0,88,0,0,0,
31/03/2004 18:09,2003,2002,B,Other UK Airports,HAWARDEN,INVERNESS,0,0,0,1,0,1,
31/03/2004 18:09,2003,2002,B,Other UK Airports,HUMBERSIDE,JERSEY,3548,0,3548,3445,0,3445,2.989840269
31/03/2004 18:09,2003,2002,B,Other UK Airports,INVERNESS,KIRKWALL,15963,15963,0,14189,14189,0,12.50264263
31/03/2004 18:09,2003,2002,B,Other UK Airports,INVERNESS,MANCHESTER,14445,14445,0,1961,1790,171,636.6139526
31/03/2004 18:09,2003,2002,B,Other UK Airports,INVERNESS,NORTHOLT,0,0,0,39,0,39,
31/03/2004 18:09,2003,2002,B,Other UK Airports,INVERNESS,SOUTH MARSTON,0,0,0,12,0,12,
31/03/2004 18:09,2003,2002,B,Other UK Airports,INVERNESS,STORNOWAY,28375,28375,0,26266,26221,45,8.029391289
31/03/2004 18:09,2003,2002,B,Other UK Airports,INVERNESS,SUMBURGH,118,118,0,1040,1040,0,-88.65384674
31/03/2004 18:09,2003,2002,B,Other UK Airports,ISLE OF MAN,JERSEY,0,0,0,2592,2592,0,
31/03/2004 18:09,2003,2002,B,Other UK Airports,ISLE OF MAN,LEEDS BRADFORD,9868,9868,0,11237,11237,0,-12.18296719
31/03/2004 18:09,2003,2002,B,Other UK Airports,ISLE OF MAN,LIVERPOOL,178636,178175,461,187118,187118,0,-4.532968521
31/03/2004 18:09,2003,2002,B,Other UK Airports,ISLE OF MAN,MANCHESTER,92193,92193,0,94129,94119,10,-2.056751966
31/03/2004 18:09,2003,2002,B,Other UK Airports,ISLE OF MAN,NEWCASTLE,10553,10553,0,9968,9968,0,5.868780136
31/03/2004 18:09,2003,2002,B,Other UK Airports,ISLE OF MAN,PRESTWICK,8072,8072,0,0,0,0,
31/03/2004 18:09,2003,2002,B,Other UK Airports,ISLE OF MAN,SOUTHAMPTON,0,0,0,2623,2623,0,
31/03/2004 18:09,2003,2002,B,Other UK Airports,ISLES OF SCILLY (ST.MARYS),SOUTHAMPTON,1179,1179,0,0,0,0,
31/03/2004 18:09,2003,2002,B,Other UK Airports,JERSEY,LEEDS BRADFORD,29693,27963,1730,32950,31294,1656,-9.884674072
31/03/2004 18:09,2003,2002,B,Other UK Airports,JERSEY,LIVERPOOL,4298,0,4298,4281,0,4281,0.397103488
31/03/2004 18:09,2003,2002,B,Other UK Airports,JERSEY,MANCHESTER,80317,69091,11226,81649,68651,12998,-1.631373286
31/03/2004 18:09,2003,2002,B,Other UK Airports,JERSEY,NEWCASTLE,7391,5908,1483,8481,3668,4813,-12.85225773
31/03/2004 18:09,2003,2002,B,Other UK Airports,JERSEY,NORTHOLT,4,0,4,0,0,0,
31/03/2004 18:09,2003,2002,B,Other UK Airports,JERSEY,NORWICH,3536,0,3536,4074,0,4074,-13.2056942
31/03/2004 18:09,2003,2002,B,Other UK Airports,JERSEY,PLYMOUTH,1253,1241,12,258,258,0,385.658905
31/03/2004 18:09,2003,2002,B,Other UK Airports,JERSEY,PRESTWICK,0,0,0,1275,0,1275,
31/03/2004 18:09,2003,2002,B,Other UK Airports,JERSEY,SHEFFIELD CITY,0,0,0,2953,0,2953,
31/03/2004 18:09,2003,2002,B,Other UK Airports,JERSEY,SOUTHAMPTON,175811,175017,794,140114,138969,1145,25.47711182
31/03/2004 18:09,2003,2002,B,Other UK Airports,JERSEY,SWANSEA,12,12,0,1598,1598,0,-99.24906158
31/03/2004 18:09,2003,2002,B,Other UK Airports,JERSEY,TEESSIDE,4158,4158,0,6334,4872,1462,-34.35427856
31/03/2004 18:09,2003,2002,B,Other UK Airports,KIRKWALL,MANCHESTER,100,0,100,0,0,0,
31/03/2004 18:09,2003,2002,B,Other UK Airports,KIRKWALL,NORTH RONALDSAY,5273,5273,0,4400,4400,0,19.84090996
31/03/2004 18:09,2003,2002,B,Other UK Airports,KIRKWALL,PAPA WESTRAY,3356,3356,0,2783,2783,0,20.58929253
31/03/2004 18:09,2003,2002,B,Other UK Airports,KIRKWALL,SANDAY,2922,2922,0,2483,2483,0,17.68022537
31/03/2004 18:09,2003,2002,B,Other UK Airports,KIRKWALL,STRONSAY,3146,3146,0,2719,2719,0,15.70430279
31/03/2004 18:09,2003,2002,B,Other UK Airports,KIRKWALL,SUMBURGH,6618,6618,0,7449,7252,197,-11.15585995
31/03/2004 18:09,2003,2002,B,Other UK Airports,KIRKWALL,WESTRAY,2866,2866,0,2721,2721,0,5.328923225
31/03/2004 18:09,2003,2002,B,Other UK Airports,KIRKWALL,WICK,9974,9942,32,8355,8355,0,19.37761879
31/03/2004 18:09,2003,2002,B,Other UK Airports,LEEDS BRADFORD,NEWQUAY,399,0,399,310,0,310,28.70967674
31/03/2004 18:09,2003,2002,B,Other UK Airports,LEEDS BRADFORD,SOUTH MARSTON,6,0,6,0,0,0,
31/03/2004 18:09,2003,2002,B,Other UK Airports,LEEDS BRADFORD,SOUTHAMPTON,25311,25121,190,22021,22021,0,14.94028473
31/03/2004 18:09,2003,2002,B,Other UK Airports,LEUCHARS,TEESSIDE,1,0,1,0,0,0,
31/03/2004 18:09,2003,2002,B,Other UK Airports,LIVERPOOL,NEWCASTLE,161,132,29,0,0,0,
31/03/2004 18:09,2003,2002,B,Other UK Airports,LIVERPOOL,SOUTHAMPTON,35,0,35,174,0,174,-79.88505554
31/03/2004 18:09,2003,2002,B,Other UK Airports,LIVERPOOL,WARTON,30,0,30,0,0,0,
31/03/2004 18:09,2003,2002,B,Other UK Airports,MANCHESTER,NEWCASTLE,36,0,36,94,0,94,-61.70212936
31/03/2004 18:09,2003,2002,B,Other UK Airports,MANCHESTER,NORTHOLT,0,0,0,40,0,40,
31/03/2004 18:09,2003,2002,B,Other UK Airports,MANCHESTER,NORWICH,15647,15647,0,14651,14651,0,6.798170567
31/03/2004 18:09,2003,2002,B,Other UK Airports,MANCHESTER,SOUTHAMPTON,63023,62833,190,57610,57521,89,9.39593792
31/03/2004 18:09,2003,2002,B,Other UK Airports,MANCHESTER,SUMBURGH,0,0,0,573,0,573,
31/03/2004 18:09,2003,2002,B,Other UK Airports,MANCHESTER,SWANSEA,4,0,4,0,0,0,
31/03/2004 18:09,2003,2002,B,Other UK Airports,NEWCASTLE,NEWQUAY,356,0,356,360,0,360,-1.111111164
31/03/2004 18:09,2003,2002,B,Other UK Airports,NEWCASTLE,PLYMOUTH,590,590,0,619,619,0,-4.684975624
31/03/2004 18:09,2003,2002,B,Other UK Airports,NEWCASTLE,SOUTHAMPTON,29946,29818,128,29387,29329,58,1.902201653
31/03/2004 18:09,2003,2002,B,Other UK Airports,NORTHOLT,NORWICH,0,0,0,32,0,32,
31/03/2004 18:09,2003,2002,B,Other UK Airports,NORTHOLT,WICK,27,0,27,0,0,0,
31/03/2004 18:09,2003,2002,B,Other UK Airports,NORWICH,SOUTHAMPTON,74,0,74,0,0,0,
31/03/2004 18:09,2003,2002,B,Other UK Airports,NORWICH,WARTON,172,0,172,0,0,0,
31/03/2004 18:09,2003,2002,B,Other UK Airports,PRESTWICK,WOODFORD,0,0,0,58,0,58,
31/03/2004 18:09,2003,2002,B,Other UK Airports,SCATSTA,SUMBURGH,0,0,0,44,0,44,
31/03/2004 18:09,2003,2002,B,Other UK Airports,SOUTHAMPTON,TEESSIDE,80,0,80,0,0,0,
31/03/2004 18:09,2003,2002,B,Other UK Airports,SOUTHAMPTON,WADDINGTON,0,0,0,11,0,11,
31/03/2004 18:09,2003,2002,B,Other UK Airports,SOUTHAMPTON,WARTON,0,0,0,287,0,287,
31/03/2004 18:09,2003,2002,B,Other UK Airports,SUMBURGH,WICK,33,33,0,616,569,47,-94.64286041
