rundate,this_period,last_period,grp_cd,grp_name,apt1_apt_name,apt2_apt_name,total_pax_tp,total_pax_shd_tp,total_pax_cht_tp,total_pax_lp,total_pax_shd_lp,total_pax_cht_lp,total_pax_pc
4/20/2010 13:45,2008,2007,A,London Area Airports,GATWICK,ABERDEEN,147978,147944,34,214946,214946,0,-31.1557312
4/20/2010 13:45,2008,2007,A,London Area Airports,GATWICK,BELFAST CITY (GEORGE BEST),189398,189398,0,200801,200801,0,-5.678756714
4/20/2010 13:45,2008,2007,A,London Area Airports,GATWICK,BELFAST INTERNATIONAL,347377,347377,0,383674,383658,16,-9.460374832
4/20/2010 13:45,2008,2007,A,London Area Airports,GATWICK,BIRMINGHAM,0,0,0,50,0,50,
4/20/2010 13:45,2008,2007,A,London Area Airports,GATWICK,BLACKPOOL,33,0,33,0,0,0,
4/20/2010 13:45,2008,2007,A,London Area Airports,GATWICK,CARDIFF WALES,116,0,116,105,0,105,10.47619057
4/20/2010 13:45,2008,2007,A,London Area Airports,GATWICK,DONCASTER SHEFFIELD,49,0,49,0,0,0,
4/20/2010 13:45,2008,2007,A,London Area Airports,GATWICK,DURHAM TEES VALLEY,58,0,58,1028,0,1028,-94.35797882
4/20/2010 13:45,2008,2007,A,London Area Airports,GATWICK,EAST MIDLANDS INTERNATIONAL,49,0,49,40,0,40,22.5
4/20/2010 13:45,2008,2007,A,London Area Airports,GATWICK,EDINBURGH,704906,704891,15,748309,748230,79,-5.800144196
4/20/2010 13:45,2008,2007,A,London Area Airports,GATWICK,EXETER,0,0,0,9,0,9,
4/20/2010 13:45,2008,2007,A,London Area Airports,GATWICK,GLASGOW,521878,521878,0,570656,570655,1,-8.547706604
4/20/2010 13:45,2008,2007,A,London Area Airports,GATWICK,GUERNSEY,338720,338720,0,342826,342826,0,-1.197692156
4/20/2010 13:45,2008,2007,A,London Area Airports,GATWICK,HUMBERSIDE,41,0,41,45,0,45,-8.888889313
4/20/2010 13:45,2008,2007,A,London Area Airports,GATWICK,INVERNESS,243168,242645,523,221550,221550,0,9.757616997
4/20/2010 13:45,2008,2007,A,London Area Airports,GATWICK,ISLE OF MAN,147409,147324,85,144346,144346,0,2.12198472
4/20/2010 13:45,2008,2007,A,London Area Airports,GATWICK,JERSEY,517899,517899,0,525156,524247,909,-1.381875157
4/20/2010 13:45,2008,2007,A,London Area Airports,GATWICK,KIRKWALL,0,0,0,211,0,211,
4/20/2010 13:45,2008,2007,A,London Area Airports,GATWICK,LEEDS BRADFORD,262,0,262,0,0,0,
4/20/2010 13:45,2008,2007,A,London Area Airports,GATWICK,LIVERPOOL,213,0,213,2399,0,2399,-91.12129974
4/20/2010 13:45,2008,2007,A,London Area Airports,GATWICK,MANCHESTER,344031,343000,1031,414350,413768,582,-16.97091866
4/20/2010 13:45,2008,2007,A,London Area Airports,GATWICK,NEWCASTLE,101400,101212,188,109649,109609,40,-7.523096561
4/20/2010 13:45,2008,2007,A,London Area Airports,GATWICK,NEWQUAY,63435,63435,0,73927,73927,0,-14.192379
4/20/2010 13:45,2008,2007,A,London Area Airports,GATWICK,PLYMOUTH,60546,60546,0,67780,67780,0,-10.67276478
4/20/2010 13:45,2008,2007,A,London Area Airports,GATWICK,SOUTHEND,0,0,0,20,0,20,
4/20/2010 13:45,2008,2007,A,London Area Airports,HEATHROW,ABERDEEN,656034,656034,0,658984,658984,0,-0.447658807
4/20/2010 13:45,2008,2007,A,London Area Airports,HEATHROW,BELFAST CITY (GEORGE BEST),521913,521913,0,626218,626218,0,-16.65633965
4/20/2010 13:45,2008,2007,A,London Area Airports,HEATHROW,BELFAST INTERNATIONAL,258033,258033,0,0,0,0,
4/20/2010 13:45,2008,2007,A,London Area Airports,HEATHROW,DURHAM TEES VALLEY,81407,81407,0,88223,88223,0,-7.725876331
4/20/2010 13:45,2008,2007,A,London Area Airports,HEATHROW,EDINBURGH,1318962,1318962,0,1436598,1436516,82,-8.188511848
4/20/2010 13:45,2008,2007,A,London Area Airports,HEATHROW,GLASGOW,1143533,1143426,107,1207127,1207118,9,-5.268211365
4/20/2010 13:45,2008,2007,A,London Area Airports,HEATHROW,INVERNESS,7899,7899,0,53549,53549,0,-85.24902344
4/20/2010 13:45,2008,2007,A,London Area Airports,HEATHROW,JERSEY,76679,76679,0,77574,77563,11,-1.153737068
4/20/2010 13:45,2008,2007,A,London Area Airports,HEATHROW,LEEDS BRADFORD,126069,126069,0,136952,136952,0,-7.946579933
4/20/2010 13:45,2008,2007,A,London Area Airports,HEATHROW,LIVERPOOL,97,0,97,66,0,66,46.96969604
4/20/2010 13:45,2008,2007,A,London Area Airports,HEATHROW,LUTON,0,0,0,2,0,2,
4/20/2010 13:45,2008,2007,A,London Area Airports,HEATHROW,MANCHESTER,910101,910009,92,973044,972612,432,-6.468669415
4/20/2010 13:45,2008,2007,A,London Area Airports,HEATHROW,NEWCASTLE,462615,462615,0,495366,495366,0,-6.611474991
4/20/2010 13:45,2008,2007,A,London Area Airports,HEATHROW,PRESTWICK,118,0,118,0,0,0,
4/20/2010 13:45,2008,2007,A,London Area Airports,LONDON CITY,BELFAST CITY (GEORGE BEST),6692,6692,0,14482,14482,0,-53.79091263
4/20/2010 13:45,2008,2007,A,London Area Airports,LONDON CITY,DUNDEE,40089,40089,0,48991,48991,0,-18.17068481
4/20/2010 13:45,2008,2007,A,London Area Airports,LONDON CITY,EDINBURGH,371507,371507,0,353874,353874,0,4.982847214
4/20/2010 13:45,2008,2007,A,London Area Airports,LONDON CITY,GLASGOW,112736,112736,0,78079,78079,0,44.38709641
4/20/2010 13:45,2008,2007,A,London Area Airports,LONDON CITY,ISLE OF MAN,29147,29147,0,65343,65343,0,-55.3938446
4/20/2010 13:45,2008,2007,A,London Area Airports,LONDON CITY,JERSEY,12132,12132,0,16476,16476,0,-26.36562347
4/20/2010 13:45,2008,2007,A,London Area Airports,LONDON CITY,LIVERPOOL,0,0,0,12514,12514,0,
4/20/2010 13:45,2008,2007,A,London Area Airports,LONDON CITY,MANCHESTER,89417,89417,0,108562,108537,25,-17.63508415
4/20/2010 13:45,2008,2007,A,London Area Airports,LONDON CITY,NEWCASTLE,0,0,0,685,685,0,
4/20/2010 13:45,2008,2007,A,London Area Airports,LUTON,ABERDEEN,139404,139404,0,149885,149819,66,-6.992694378
4/20/2010 13:45,2008,2007,A,London Area Airports,LUTON,BELFAST CITY (GEORGE BEST),49,0,49,35,0,35,40
4/20/2010 13:45,2008,2007,A,London Area Airports,LUTON,BELFAST INTERNATIONAL,263238,263121,117,360176,360176,0,-26.91406441
4/20/2010 13:45,2008,2007,A,London Area Airports,LUTON,BLACKPOOL,134,0,134,164,0,164,-18.29268265
4/20/2010 13:45,2008,2007,A,London Area Airports,LUTON,BOURNEMOUTH,34,0,34,44,0,44,-22.72727203
4/20/2010 13:45,2008,2007,A,London Area Airports,LUTON,CAMBRIDGE,22,0,22,0,0,0,
4/20/2010 13:45,2008,2007,A,London Area Airports,LUTON,CARDIFF WALES,0,0,0,591,0,591,
4/20/2010 13:45,2008,2007,A,London Area Airports,LUTON,CITY OF DERRY (EGLINTON),5641,5641,0,0,0,0,
4/20/2010 13:45,2008,2007,A,London Area Airports,LUTON,COVENTRY,0,0,0,96,0,96,
4/20/2010 13:45,2008,2007,A,London Area Airports,LUTON,DONCASTER SHEFFIELD,0,0,0,64,0,64,
4/20/2010 13:45,2008,2007,A,London Area Airports,LUTON,DURHAM TEES VALLEY,55,0,55,108,0,108,-49.07407379
4/20/2010 13:45,2008,2007,A,London Area Airports,LUTON,EDINBURGH,359543,359497,46,429107,429087,20,-16.21134186
4/20/2010 13:45,2008,2007,A,London Area Airports,LUTON,EXETER,0,0,0,87,0,87,
4/20/2010 13:45,2008,2007,A,London Area Airports,LUTON,FARNBOROUGH,2,0,2,55,0,55,-96.36363983
4/20/2010 13:45,2008,2007,A,London Area Airports,LUTON,GLASGOW,352448,352429,19,407691,407690,1,-13.55021286
4/20/2010 13:45,2008,2007,A,London Area Airports,LUTON,INVERNESS,102526,102495,31,102251,102185,66,0.268946022
4/20/2010 13:45,2008,2007,A,London Area Airports,LUTON,ISLE OF MAN,38055,38055,0,4181,4181,0,810.1889648
4/20/2010 13:45,2008,2007,A,London Area Airports,LUTON,JERSEY,55221,54698,523,33789,33773,16,63.42892838
4/20/2010 13:45,2008,2007,A,London Area Airports,LUTON,LIVERPOOL,339,0,339,395,0,395,-14.17721558
4/20/2010 13:45,2008,2007,A,London Area Airports,LUTON,MANCHESTER,672,0,672,319,0,319,110.6583099
4/20/2010 13:45,2008,2007,A,London Area Airports,LUTON,NEWCASTLE,491,0,491,131,0,131,274.8091736
4/20/2010 13:45,2008,2007,A,London Area Airports,LUTON,NEWQUAY,196,0,196,0,0,0,
4/20/2010 13:45,2008,2007,A,London Area Airports,LUTON,STORNOWAY,64,0,64,0,0,0,
4/20/2010 13:45,2008,2007,A,London Area Airports,LUTON,WICK,0,0,0,152,0,152,
4/20/2010 13:45,2008,2007,A,London Area Airports,SOUTHEND,BIRMINGHAM,0,0,0,61,0,61,
4/20/2010 13:45,2008,2007,A,London Area Airports,SOUTHEND,BLACKPOOL,0,0,0,87,0,87,
4/20/2010 13:45,2008,2007,A,London Area Airports,SOUTHEND,CARDIFF WALES,143,0,143,0,0,0,
4/20/2010 13:45,2008,2007,A,London Area Airports,SOUTHEND,DURHAM TEES VALLEY,54,0,54,0,0,0,
4/20/2010 13:45,2008,2007,A,London Area Airports,SOUTHEND,JERSEY,2775,2775,0,2747,2747,0,1.019293785
4/20/2010 13:45,2008,2007,A,London Area Airports,SOUTHEND,LEEDS BRADFORD,0,0,0,113,0,113,
4/20/2010 13:45,2008,2007,A,London Area Airports,SOUTHEND,NEWCASTLE,0,0,0,136,0,136,
4/20/2010 13:45,2008,2007,A,London Area Airports,STANSTED,BELFAST CITY (GEORGE BEST),340303,340303,0,138228,138228,0,146.1896362
4/20/2010 13:45,2008,2007,A,London Area Airports,STANSTED,BELFAST INTERNATIONAL,313111,313099,12,372627,372627,0,-15.97200394
4/20/2010 13:45,2008,2007,A,London Area Airports,STANSTED,BLACKPOOL,71,0,71,43327,43269,58,-99.83612823
4/20/2010 13:45,2008,2007,A,London Area Airports,STANSTED,CITY OF DERRY (EGLINTON),146779,146779,0,155488,155488,0,-5.601075172
4/20/2010 13:45,2008,2007,A,London Area Airports,STANSTED,DUNDEE,4,0,4,0,0,0,
4/20/2010 13:45,2008,2007,A,London Area Airports,STANSTED,DURHAM TEES VALLEY,74,0,74,0,0,0,
4/20/2010 13:45,2008,2007,A,London Area Airports,STANSTED,EDINBURGH,401902,401797,105,448745,448599,146,-10.43866825
4/20/2010 13:45,2008,2007,A,London Area Airports,STANSTED,GLASGOW,358634,358634,0,448049,447369,680,-19.95652199
4/20/2010 13:45,2008,2007,A,London Area Airports,STANSTED,GUERNSEY,31496,31496,0,35639,35639,0,-11.62490559
4/20/2010 13:45,2008,2007,A,London Area Airports,STANSTED,HUMBERSIDE,74,0,74,0,0,0,
4/20/2010 13:45,2008,2007,A,London Area Airports,STANSTED,INVERNESS,0,0,0,304,0,304,
4/20/2010 13:45,2008,2007,A,London Area Airports,STANSTED,ISLE OF MAN,0,0,0,56,0,56,
4/20/2010 13:45,2008,2007,A,London Area Airports,STANSTED,JERSEY,1283,0,1283,2654,671,1983,-51.65787506
4/20/2010 13:45,2008,2007,A,London Area Airports,STANSTED,LEEDS BRADFORD,5,0,5,0,0,0,
4/20/2010 13:45,2008,2007,A,London Area Airports,STANSTED,LIVERPOOL,349,0,349,28,0,28,1146.428589
4/20/2010 13:45,2008,2007,A,London Area Airports,STANSTED,MANCHESTER,15275,14977,298,82854,82710,144,-81.56395721
4/20/2010 13:45,2008,2007,A,London Area Airports,STANSTED,NEWCASTLE,200126,199914,212,297882,297769,113,-32.81702042
4/20/2010 13:45,2008,2007,A,London Area Airports,STANSTED,NEWQUAY,126840,126840,0,97096,97096,0,30.63360023
4/20/2010 13:45,2008,2007,A,London Area Airports,STANSTED,PRESTWICK,402729,402729,0,427062,427062,0,-5.697767735
4/20/2010 13:45,2008,2007,A,London Area Airports,STANSTED,SUMBURGH,2108,2108,0,2493,2493,0,-15.44324112
4/20/2010 13:45,2008,2007,B,Other Reporting Airports,ABERDEEN,BELFAST CITY (GEORGE BEST),25365,25365,0,25650,25650,0,-1.111111164
4/20/2010 13:45,2008,2007,B,Other Reporting Airports,ABERDEEN,BIRMINGHAM,146455,146455,0,151484,151484,0,-3.31982255
4/20/2010 13:45,2008,2007,B,Other Reporting Airports,ABERDEEN,BRISTOL,26876,26876,0,26692,26692,0,0.689345121
4/20/2010 13:45,2008,2007,B,Other Reporting Airports,ABERDEEN,DURHAM TEES VALLEY,33161,33161,0,33434,33434,0,-0.816534042
4/20/2010 13:45,2008,2007,B,Other Reporting Airports,ABERDEEN,EAST MIDLANDS INTERNATIONAL,20760,20760,0,18833,18833,0,10.23203945
4/20/2010 13:45,2008,2007,B,Other Reporting Airports,ABERDEEN,EXETER,17623,17623,0,24582,24582,0,-28.30933189
4/20/2010 13:45,2008,2007,B,Other Reporting Airports,ABERDEEN,FARNBOROUGH,1,0,1,74,0,74,-98.64865112
4/20/2010 13:45,2008,2007,B,Other Reporting Airports,ABERDEEN,GLASGOW,134,0,134,0,0,0,
4/20/2010 13:45,2008,2007,B,Other Reporting Airports,ABERDEEN,HUMBERSIDE,33689,33689,0,32478,32478,0,3.728677988
4/20/2010 13:45,2008,2007,B,Other Reporting Airports,ABERDEEN,ISLAY,0,0,0,20,20,0,
4/20/2010 13:45,2008,2007,B,Other Reporting Airports,ABERDEEN,JERSEY,2367,2367,0,1506,0,1506,57.17131424
4/20/2010 13:45,2008,2007,B,Other Reporting Airports,ABERDEEN,KIRKWALL,44363,44177,186,42806,42738,68,3.637340546
4/20/2010 13:45,2008,2007,B,Other Reporting Airports,ABERDEEN,LEEDS BRADFORD,21560,21560,0,26685,26684,1,-19.20554543
4/20/2010 13:45,2008,2007,B,Other Reporting Airports,ABERDEEN,LIVERPOOL,0,0,0,46719,46719,0,
4/20/2010 13:45,2008,2007,B,Other Reporting Airports,ABERDEEN,MANCHESTER,132341,130845,1496,121609,121397,212,8.825004578
4/20/2010 13:45,2008,2007,B,Other Reporting Airports,ABERDEEN,NEWCASTLE,22388,22388,0,21826,21826,0,2.574910641
4/20/2010 13:45,2008,2007,B,Other Reporting Airports,ABERDEEN,NORWICH,65777,65777,0,65612,65573,39,0.251478374
4/20/2010 13:45,2008,2007,B,Other Reporting Airports,ABERDEEN,SCATSTA,130769,0,130769,136972,0,136972,-4.528662682
4/20/2010 13:45,2008,2007,B,Other Reporting Airports,ABERDEEN,SOUTHAMPTON,55480,55480,0,40328,40328,0,37.57191086
4/20/2010 13:45,2008,2007,B,Other Reporting Airports,ABERDEEN,STORNOWAY,7113,7113,0,6750,6750,0,5.377777576
4/20/2010 13:45,2008,2007,B,Other Reporting Airports,ABERDEEN,SUMBURGH,74913,68357,6556,73363,68817,4546,2.112781763
4/20/2010 13:45,2008,2007,B,Other Reporting Airports,ABERDEEN,WICK,16594,16539,55,14948,14793,155,11.01150608
4/20/2010 13:45,2008,2007,B,Other Reporting Airports,ALDERNEY,BOURNEMOUTH,4630,4630,0,6415,6415,0,-27.82540894
4/20/2010 13:45,2008,2007,B,Other Reporting Airports,ALDERNEY,GUERNSEY,41909,41909,0,41560,41560,0,0.839749753
4/20/2010 13:45,2008,2007,B,Other Reporting Airports,ALDERNEY,JERSEY,843,843,0,694,694,0,21.46973991
4/20/2010 13:45,2008,2007,B,Other Reporting Airports,ALDERNEY,SHOREHAM,106,106,0,2076,2076,0,-94.89402771
4/20/2010 13:45,2008,2007,B,Other Reporting Airports,ALDERNEY,SOUTHAMPTON,29651,29651,0,28347,28347,0,4.600133896
4/20/2010 13:45,2008,2007,B,Other Reporting Airports,ANGLESEY (VALLEY),CARDIFF WALES,13471,13471,0,8553,8553,0,57.50029373
4/20/2010 13:45,2008,2007,B,Other Reporting Airports,BARRA,BENBECULA,1656,1656,0,1721,1721,0,-3.776873827
4/20/2010 13:45,2008,2007,B,Other Reporting Airports,BARRA,GLASGOW,9066,9066,0,8706,8706,0,4.135079384
4/20/2010 13:45,2008,2007,B,Other Reporting Airports,BELFAST CITY (GEORGE BEST),BIRMINGHAM,213847,213847,0,227454,227454,0,-5.982308388
4/20/2010 13:45,2008,2007,B,Other Reporting Airports,BELFAST CITY (GEORGE BEST),BLACKPOOL,0,0,0,4,4,0,
4/20/2010 13:45,2008,2007,B,Other Reporting Airports,BELFAST CITY (GEORGE BEST),CARDIFF WALES,40673,40673,0,12417,12227,190,227.5589905
4/20/2010 13:45,2008,2007,B,Other Reporting Airports,BELFAST CITY (GEORGE BEST),DONCASTER SHEFFIELD,31702,31702,0,40904,40904,0,-22.49657822
4/20/2010 13:45,2008,2007,B,Other Reporting Airports,BELFAST CITY (GEORGE BEST),DUNDEE,5902,5902,0,5268,5268,0,12.03492832
4/20/2010 13:45,2008,2007,B,Other Reporting Airports,BELFAST CITY (GEORGE BEST),EAST MIDLANDS INTERNATIONAL,128764,128764,0,11700,11700,0,1000.546997
4/20/2010 13:45,2008,2007,B,Other Reporting Airports,BELFAST CITY (GEORGE BEST),EDINBURGH,126539,126539,0,106090,106090,0,19.27514458
4/20/2010 13:45,2008,2007,B,Other Reporting Airports,BELFAST CITY (GEORGE BEST),EXETER,30196,30196,0,34356,34356,0,-12.10851097
4/20/2010 13:45,2008,2007,B,Other Reporting Airports,BELFAST CITY (GEORGE BEST),GLASGOW,104553,104553,0,99673,99638,35,4.896009922
4/20/2010 13:45,2008,2007,B,Other Reporting Airports,BELFAST CITY (GEORGE BEST),INVERNESS,22618,22618,0,24393,24393,0,-7.276677608
4/20/2010 13:45,2008,2007,B,Other Reporting Airports,BELFAST CITY (GEORGE BEST),ISLE OF MAN,27351,27351,0,27747,27747,0,-1.427181363
4/20/2010 13:45,2008,2007,B,Other Reporting Airports,BELFAST CITY (GEORGE BEST),JERSEY,5192,5192,0,5593,5593,0,-7.169676304
4/20/2010 13:45,2008,2007,B,Other Reporting Airports,BELFAST CITY (GEORGE BEST),LEEDS BRADFORD,76101,76051,50,82644,82644,0,-7.917089939
4/20/2010 13:45,2008,2007,B,Other Reporting Airports,BELFAST CITY (GEORGE BEST),LIVERPOOL,155876,155876,0,26192,26192,0,495.1282959
4/20/2010 13:45,2008,2007,B,Other Reporting Airports,BELFAST CITY (GEORGE BEST),MANCHESTER,235998,235998,0,237403,237403,0,-0.591820657
4/20/2010 13:45,2008,2007,B,Other Reporting Airports,BELFAST CITY (GEORGE BEST),NEWCASTLE,40449,40449,0,37208,37208,0,8.710492134
4/20/2010 13:45,2008,2007,B,Other Reporting Airports,BELFAST CITY (GEORGE BEST),NEWQUAY,2615,2615,0,1571,1571,0,66.45449066
4/20/2010 13:45,2008,2007,B,Other Reporting Airports,BELFAST CITY (GEORGE BEST),PRESTWICK,86330,86330,0,11811,11811,0,630.928772
4/20/2010 13:45,2008,2007,B,Other Reporting Airports,BELFAST CITY (GEORGE BEST),SOUTHAMPTON,86399,86399,0,100239,100239,0,-13.80700111
4/20/2010 13:45,2008,2007,B,Other Reporting Airports,BELFAST INTERNATIONAL,BIGGIN HILL,16,0,16,0,0,0,
4/20/2010 13:45,2008,2007,B,Other Reporting Airports,BELFAST INTERNATIONAL,BIRMINGHAM,155920,155860,60,189826,189826,0,-17.86161995
4/20/2010 13:45,2008,2007,B,Other Reporting Airports,BELFAST INTERNATIONAL,BLACKPOOL,42897,42601,296,54757,54757,0,-21.65933037
4/20/2010 13:45,2008,2007,B,Other Reporting Airports,BELFAST INTERNATIONAL,BRISTOL,211923,211923,0,234322,234322,0,-9.55906868
4/20/2010 13:45,2008,2007,B,Other Reporting Airports,BELFAST INTERNATIONAL,CARDIFF WALES,52283,52142,141,93543,93469,74,-44.10805893
4/20/2010 13:45,2008,2007,B,Other Reporting Airports,BELFAST INTERNATIONAL,DONCASTER SHEFFIELD,0,0,0,57,0,57,
4/20/2010 13:45,2008,2007,B,Other Reporting Airports,BELFAST INTERNATIONAL,EAST MIDLANDS INTERNATIONAL,121562,121562,0,159902,159902,0,-23.9771862
4/20/2010 13:45,2008,2007,B,Other Reporting Airports,BELFAST INTERNATIONAL,EDINBURGH,236927,236884,43,295704,295517,187,-19.8769722
4/20/2010 13:45,2008,2007,B,Other Reporting Airports,BELFAST INTERNATIONAL,GLASGOW,219623,219587,36,293100,293072,28,-25.06891823
4/20/2010 13:45,2008,2007,B,Other Reporting Airports,BELFAST INTERNATIONAL,GUERNSEY,0,0,0,211,0,211,
4/20/2010 13:45,2008,2007,B,Other Reporting Airports,BELFAST INTERNATIONAL,ISLE OF MAN,11634,11634,0,10753,10753,0,8.193062782
4/20/2010 13:45,2008,2007,B,Other Reporting Airports,BELFAST INTERNATIONAL,JERSEY,341,0,341,797,0,797,-57.21455383
4/20/2010 13:45,2008,2007,B,Other Reporting Airports,BELFAST INTERNATIONAL,LEEDS BRADFORD,104765,104765,0,107192,107192,0,-2.264161587
4/20/2010 13:45,2008,2007,B,Other Reporting Airports,BELFAST INTERNATIONAL,LIVERPOOL,394569,394524,45,459910,459910,0,-14.20734501
4/20/2010 13:45,2008,2007,B,Other Reporting Airports,BELFAST INTERNATIONAL,MANCHESTER,156002,155450,552,196006,196006,0,-20.40958023
4/20/2010 13:45,2008,2007,B,Other Reporting Airports,BELFAST INTERNATIONAL,NEWCASTLE,205180,205143,37,224565,224565,0,-8.63224411
4/20/2010 13:45,2008,2007,B,Other Reporting Airports,BELFAST INTERNATIONAL,NORWICH,0,0,0,7,0,7,
4/20/2010 13:45,2008,2007,B,Other Reporting Airports,BENBECULA,GLASGOW,25201,25201,0,24286,24286,0,3.767602682
4/20/2010 13:45,2008,2007,B,Other Reporting Airports,BENBECULA,INVERNESS,18,18,0,1404,1404,0,-98.71794891
4/20/2010 13:45,2008,2007,B,Other Reporting Airports,BENBECULA,STORNOWAY,7330,7330,0,8249,8249,0,-11.14074421
4/20/2010 13:45,2008,2007,B,Other Reporting Airports,BIGGIN HILL,GUERNSEY,35,0,35,0,0,0,
4/20/2010 13:45,2008,2007,B,Other Reporting Airports,BIGGIN HILL,INVERNESS,0,0,0,256,0,256,
4/20/2010 13:45,2008,2007,B,Other Reporting Airports,BIGGIN HILL,ISLE OF MAN,0,0,0,77,0,77,
4/20/2010 13:45,2008,2007,B,Other Reporting Airports,BIGGIN HILL,LEEDS BRADFORD,20,0,20,0,0,0,
4/20/2010 13:45,2008,2007,B,Other Reporting Airports,BIGGIN HILL,MANCHESTER,18,0,18,0,0,0,
4/20/2010 13:45,2008,2007,B,Other Reporting Airports,BIGGIN HILL,WICK,0,0,0,65,0,65,
4/20/2010 13:45,2008,2007,B,Other Reporting Airports,BIRMINGHAM,CARDIFF WALES,38,0,38,0,0,0,
4/20/2010 13:45,2008,2007,B,Other Reporting Airports,BIRMINGHAM,CITY OF DERRY (EGLINTON),12979,12979,0,0,0,0,
4/20/2010 13:45,2008,2007,B,Other Reporting Airports,BIRMINGHAM,DUNDEE,13029,13029,0,9017,9017,0,44.49373245
4/20/2010 13:45,2008,2007,B,Other Reporting Airports,BIRMINGHAM,EDINBURGH,401147,401106,41,435275,435275,0,-7.840560436
4/20/2010 13:45,2008,2007,B,Other Reporting Airports,BIRMINGHAM,GLASGOW,337132,336958,174,346896,346550,346,-2.814676523
4/20/2010 13:45,2008,2007,B,Other Reporting Airports,BIRMINGHAM,GUERNSEY,30388,30320,68,30384,30281,103,0.013164824
4/20/2010 13:45,2008,2007,B,Other Reporting Airports,BIRMINGHAM,INVERNESS,24947,24947,0,15092,15092,0,65.29949951
4/20/2010 13:45,2008,2007,B,Other Reporting Airports,BIRMINGHAM,ISLE OF MAN,49456,49456,0,53165,53165,0,-6.976394176
4/20/2010 13:45,2008,2007,B,Other Reporting Airports,BIRMINGHAM,JERSEY,60329,60329,0,60792,60534,258,-0.761613369
4/20/2010 13:45,2008,2007,B,Other Reporting Airports,BIRMINGHAM,MANCHESTER,78,0,78,0,0,0,
4/20/2010 13:45,2008,2007,B,Other Reporting Airports,BIRMINGHAM,NEWCASTLE,22551,22488,63,24169,24169,0,-6.694526196
4/20/2010 13:45,2008,2007,B,Other Reporting Airports,BIRMINGHAM,NEWQUAY,6829,6829,0,0,0,0,
4/20/2010 13:45,2008,2007,B,Other Reporting Airports,BIRMINGHAM,PRESTWICK,26,0,26,0,0,0,
4/20/2010 13:45,2008,2007,B,Other Reporting Airports,BIRMINGHAM,WICK,216,0,216,0,0,0,
4/20/2010 13:45,2008,2007,B,Other Reporting Airports,BLACKPOOL,CARDIFF WALES,29,0,29,0,0,0,
4/20/2010 13:45,2008,2007,B,Other Reporting Airports,BLACKPOOL,ISLE OF MAN,22560,22560,0,21525,21525,0,4.808362484
4/20/2010 13:45,2008,2007,B,Other Reporting Airports,BLACKPOOL,JERSEY,0,0,0,30,0,30,
4/20/2010 13:45,2008,2007,B,Other Reporting Airports,BLACKPOOL,NEWCASTLE,0,0,0,177,0,177,
4/20/2010 13:45,2008,2007,B,Other Reporting Airports,BLACKPOOL,NORWICH,61,0,61,134,0,134,-54.47761154
4/20/2010 13:45,2008,2007,B,Other Reporting Airports,BLACKPOOL,PLYMOUTH,93,0,93,0,0,0,
4/20/2010 13:45,2008,2007,B,Other Reporting Airports,BLACKPOOL,SOUTH MARSTON,144,0,144,0,0,0,
4/20/2010 13:45,2008,2007,B,Other Reporting Airports,BLACKPOOL,SOUTHAMPTON,117,0,117,30,0,30,290
4/20/2010 13:45,2008,2007,B,Other Reporting Airports,BOURNEMOUTH,BRISTOL,0,0,0,57,0,57,
4/20/2010 13:45,2008,2007,B,Other Reporting Airports,BOURNEMOUTH,EDINBURGH,19317,19317,0,0,0,0,
4/20/2010 13:45,2008,2007,B,Other Reporting Airports,BOURNEMOUTH,GUERNSEY,85,85,0,2072,2072,0,-95.89768219
4/20/2010 13:45,2008,2007,B,Other Reporting Airports,BOURNEMOUTH,INVERNESS,0,0,0,154,0,154,
4/20/2010 13:45,2008,2007,B,Other Reporting Airports,BOURNEMOUTH,ISLE OF MAN,248,0,248,248,0,248,0
4/20/2010 13:45,2008,2007,B,Other Reporting Airports,BOURNEMOUTH,JERSEY,5869,4305,1564,6918,3811,3107,-15.16334248
4/20/2010 13:45,2008,2007,B,Other Reporting Airports,BOURNEMOUTH,MANCHESTER,286,0,286,35,0,35,717.1428833
4/20/2010 13:45,2008,2007,B,Other Reporting Airports,BOURNEMOUTH,NEWCASTLE,286,0,286,0,0,0,
4/20/2010 13:45,2008,2007,B,Other Reporting Airports,BOURNEMOUTH,PRESTWICK,128961,128961,0,94118,94118,0,37.02054977
4/20/2010 13:45,2008,2007,B,Other Reporting Airports,BRISTOL,CARDIFF WALES,0,0,0,19,18,1,
4/20/2010 13:45,2008,2007,B,Other Reporting Airports,BRISTOL,CITY OF DERRY (EGLINTON),31969,31969,0,7190,7190,0,344.6314392
4/20/2010 13:45,2008,2007,B,Other Reporting Airports,BRISTOL,DURHAM TEES VALLEY,28,0,28,37,0,37,-24.32432365
4/20/2010 13:45,2008,2007,B,Other Reporting Airports,BRISTOL,EAST MIDLANDS INTERNATIONAL,2,0,2,0,0,0,
4/20/2010 13:45,2008,2007,B,Other Reporting Airports,BRISTOL,EDINBURGH,249766,249766,0,260591,260591,0,-4.154019356
4/20/2010 13:45,2008,2007,B,Other Reporting Airports,BRISTOL,GLASGOW,220222,220123,99,243065,243065,0,-9.39789772
4/20/2010 13:45,2008,2007,B,Other Reporting Airports,BRISTOL,GUERNSEY,27552,27552,0,30952,30952,0,-10.98475075
4/20/2010 13:45,2008,2007,B,Other Reporting Airports,BRISTOL,HUMBERSIDE,0,0,0,87,0,87,
4/20/2010 13:45,2008,2007,B,Other Reporting Airports,BRISTOL,INVERNESS,73960,73960,0,82123,82123,0,-9.939968109
4/20/2010 13:45,2008,2007,B,Other Reporting Airports,BRISTOL,ISLE OF MAN,208,208,0,10680,10680,0,-98.05243683
4/20/2010 13:45,2008,2007,B,Other Reporting Airports,BRISTOL,ISLES OF SCILLY (ST.MARYS),3914,3914,0,4510,4510,0,-13.2150774
4/20/2010 13:45,2008,2007,B,Other Reporting Airports,BRISTOL,JERSEY,31865,31865,0,39729,39536,193,-19.79410553
4/20/2010 13:45,2008,2007,B,Other Reporting Airports,BRISTOL,LANDS END (ST JUST),0,0,0,27,27,0,
4/20/2010 13:45,2008,2007,B,Other Reporting Airports,BRISTOL,LEEDS BRADFORD,31511,31511,0,36910,36910,0,-14.62747192
4/20/2010 13:45,2008,2007,B,Other Reporting Airports,BRISTOL,MANCHESTER,29342,29196,146,32483,32483,0,-9.669672966
4/20/2010 13:45,2008,2007,B,Other Reporting Airports,BRISTOL,NEWCASTLE,202178,202178,0,246808,246764,44,-18.08288193
4/20/2010 13:45,2008,2007,B,Other Reporting Airports,BRISTOL,NEWQUAY,18813,18813,0,14867,14867,0,26.54200554
4/20/2010 13:45,2008,2007,B,Other Reporting Airports,BRISTOL,NORWICH,0,0,0,450,450,0,
4/20/2010 13:45,2008,2007,B,Other Reporting Airports,BRISTOL,PLYMOUTH,9566,9566,0,6653,6653,0,43.78475952
4/20/2010 13:45,2008,2007,B,Other Reporting Airports,CAMBRIDGE,NEWQUAY,0,0,0,80,0,80,
4/20/2010 13:45,2008,2007,B,Other Reporting Airports,CAMBRIDGE,PLYMOUTH,0,0,0,100,0,100,
4/20/2010 13:45,2008,2007,B,Other Reporting Airports,CAMBRIDGE,WARTON,24,0,24,0,0,0,
4/20/2010 13:45,2008,2007,B,Other Reporting Airports,CAMPBELTOWN,GLASGOW,9072,9072,0,8643,8643,0,4.963554382
4/20/2010 13:45,2008,2007,B,Other Reporting Airports,CAMPBELTOWN,ISLAY,0,0,0,69,69,0,
4/20/2010 13:45,2008,2007,B,Other Reporting Airports,CAMPBELTOWN,MANCHESTER,0,0,0,164,0,164,
4/20/2010 13:45,2008,2007,B,Other Reporting Airports,CARDIFF WALES,DURHAM TEES VALLEY,99,0,99,38,0,38,160.5263214
4/20/2010 13:45,2008,2007,B,Other Reporting Airports,CARDIFF WALES,EDINBURGH,162556,162290,266,158142,153053,5089,2.791162491
4/20/2010 13:45,2008,2007,B,Other Reporting Airports,CARDIFF WALES,GLASGOW,83986,83986,0,76948,76915,33,9.146436691
4/20/2010 13:45,2008,2007,B,Other Reporting Airports,CARDIFF WALES,GUERNSEY,0,0,0,190,169,21,
4/20/2010 13:45,2008,2007,B,Other Reporting Airports,CARDIFF WALES,HUMBERSIDE,54,0,54,80,0,80,-32.5
4/20/2010 13:45,2008,2007,B,Other Reporting Airports,CARDIFF WALES,ISLE OF MAN,35,0,35,0,0,0,
4/20/2010 13:45,2008,2007,B,Other Reporting Airports,CARDIFF WALES,JERSEY,23718,23718,0,34544,34544,0,-31.33974075
4/20/2010 13:45,2008,2007,B,Other Reporting Airports,CARDIFF WALES,LIVERPOOL,0,0,0,93,0,93,
4/20/2010 13:45,2008,2007,B,Other Reporting Airports,CARDIFF WALES,MANCHESTER,248,248,0,6719,6719,0,-96.30897522
4/20/2010 13:45,2008,2007,B,Other Reporting Airports,CARDIFF WALES,NEWCASTLE,31516,31516,0,16110,16110,0,95.63004303
4/20/2010 13:45,2008,2007,B,Other Reporting Airports,CARDIFF WALES,NEWQUAY,1060,1060,0,4345,4345,0,-75.60414124
4/20/2010 13:45,2008,2007,B,Other Reporting Airports,CARDIFF WALES,NORWICH,62,0,62,92,0,92,-32.60869598
4/20/2010 13:45,2008,2007,B,Other Reporting Airports,CARDIFF WALES,WATTISHAM,85,0,85,0,0,0,
4/20/2010 13:45,2008,2007,B,Other Reporting Airports,CITY OF DERRY (EGLINTON),EAST MIDLANDS INTERNATIONAL,53532,53532,0,68504,68504,0,-21.85565758
4/20/2010 13:45,2008,2007,B,Other Reporting Airports,CITY OF DERRY (EGLINTON),GLASGOW,9428,9428,0,11949,11949,0,-21.09799957
4/20/2010 13:45,2008,2007,B,Other Reporting Airports,CITY OF DERRY (EGLINTON),LIVERPOOL,79122,79106,16,81699,81699,0,-3.154261351
4/20/2010 13:45,2008,2007,B,Other Reporting Airports,CITY OF DERRY (EGLINTON),PRESTWICK,64001,64001,0,58563,58563,0,9.285726547
4/20/2010 13:45,2008,2007,B,Other Reporting Airports,COVENTRY,DURHAM TEES VALLEY,62,0,62,0,0,0,
4/20/2010 13:45,2008,2007,B,Other Reporting Airports,COVENTRY,GUERNSEY,62,0,62,79,0,79,-21.51898766
4/20/2010 13:45,2008,2007,B,Other Reporting Airports,COVENTRY,INVERNESS,15,0,15,0,0,0,
4/20/2010 13:45,2008,2007,B,Other Reporting Airports,COVENTRY,JERSEY,49143,49048,95,58954,58954,0,-16.64178848
4/20/2010 13:45,2008,2007,B,Other Reporting Airports,COVENTRY,NEWCASTLE,60,0,60,96,0,96,-37.5
4/20/2010 13:45,2008,2007,B,Other Reporting Airports,DONCASTER SHEFFIELD,EDINBURGH,92,0,92,73,0,73,26.02739716
4/20/2010 13:45,2008,2007,B,Other Reporting Airports,DONCASTER SHEFFIELD,JERSEY,17352,17352,0,63411,63411,0,-72.63566589
4/20/2010 13:45,2008,2007,B,Other Reporting Airports,DONCASTER SHEFFIELD,NORWICH,0,0,0,70,0,70,
4/20/2010 13:45,2008,2007,B,Other Reporting Airports,DONCASTER SHEFFIELD,PLYMOUTH,59,0,59,178,0,178,-66.85393524
4/20/2010 13:45,2008,2007,B,Other Reporting Airports,DONCASTER SHEFFIELD,SOUTHAMPTON,0,0,0,69,0,69,
4/20/2010 13:45,2008,2007,B,Other Reporting Airports,DUNDEE,GUERNSEY,0,0,0,1750,0,1750,
4/20/2010 13:45,2008,2007,B,Other Reporting Airports,DUNDEE,JERSEY,1842,0,1842,79,0,79,2231.645508
4/20/2010 13:45,2008,2007,B,Other Reporting Airports,DUNKESWELL,JERSEY,1680,0,1680,1,0,1,167900
4/20/2010 13:45,2008,2007,B,Other Reporting Airports,DURHAM TEES VALLEY,EXETER,0,0,0,70,0,70,
4/20/2010 13:45,2008,2007,B,Other Reporting Airports,DURHAM TEES VALLEY,FARNBOROUGH,29,0,29,65,0,65,-55.38461685
4/20/2010 13:45,2008,2007,B,Other Reporting Airports,DURHAM TEES VALLEY,GLASGOW,0,0,0,329,0,329,
4/20/2010 13:45,2008,2007,B,Other Reporting Airports,DURHAM TEES VALLEY,JERSEY,4642,4642,0,3320,3320,0,39.81927872
4/20/2010 13:45,2008,2007,B,Other Reporting Airports,DURHAM TEES VALLEY,LEEDS BRADFORD,0,0,0,169,0,169,
4/20/2010 13:45,2008,2007,B,Other Reporting Airports,DURHAM TEES VALLEY,LIVERPOOL,55,0,55,17,0,17,223.5294189
4/20/2010 13:45,2008,2007,B,Other Reporting Airports,DURHAM TEES VALLEY,MANCHESTER,70,0,70,0,0,0,
4/20/2010 13:45,2008,2007,B,Other Reporting Airports,DURHAM TEES VALLEY,NEWQUAY,76,0,76,0,0,0,
4/20/2010 13:45,2008,2007,B,Other Reporting Airports,DURHAM TEES VALLEY,SOUTHAMPTON,100,0,100,57,0,57,75.43859863
4/20/2010 13:45,2008,2007,B,Other Reporting Airports,DUXFORD,JERSEY,0,0,0,42,0,42,
4/20/2010 13:45,2008,2007,B,Other Reporting Airports,EAST MIDLANDS INTERNATIONAL,EDINBURGH,164051,164051,0,170280,170280,0,-3.658092499
4/20/2010 13:45,2008,2007,B,Other Reporting Airports,EAST MIDLANDS INTERNATIONAL,GLASGOW,150916,150768,148,172863,172816,47,-12.6961813
4/20/2010 13:45,2008,2007,B,Other Reporting Airports,EAST MIDLANDS INTERNATIONAL,INVERNESS,40185,40185,0,34129,34129,0,17.74444008
4/20/2010 13:45,2008,2007,B,Other Reporting Airports,EAST MIDLANDS INTERNATIONAL,ISLE OF MAN,5574,5574,0,0,0,0,
4/20/2010 13:45,2008,2007,B,Other Reporting Airports,EAST MIDLANDS INTERNATIONAL,JERSEY,56577,56390,187,58453,58281,172,-3.209416151
4/20/2010 13:45,2008,2007,B,Other Reporting Airports,EAST MIDLANDS INTERNATIONAL,SOUTHAMPTON,0,0,0,98,0,98,
4/20/2010 13:45,2008,2007,B,Other Reporting Airports,EAST MIDLANDS INTERNATIONAL,STORNOWAY,63,0,63,0,0,0,
4/20/2010 13:45,2008,2007,B,Other Reporting Airports,EAST MIDLANDS INTERNATIONAL,WARTON,25,0,25,0,0,0,
4/20/2010 13:45,2008,2007,B,Other Reporting Airports,EDAY,KIRKWALL,603,603,0,454,454,0,32.81938171
4/20/2010 13:45,2008,2007,B,Other Reporting Airports,EDINBURGH,EXETER,68043,68043,0,67739,67672,67,0.448781341
4/20/2010 13:45,2008,2007,B,Other Reporting Airports,EDINBURGH,FARNBOROUGH,35,0,35,0,0,0,
4/20/2010 13:45,2008,2007,B,Other Reporting Airports,EDINBURGH,INVERNESS,7510,7510,0,10513,10513,0,-28.56463432
4/20/2010 13:45,2008,2007,B,Other Reporting Airports,EDINBURGH,ISLE OF MAN,13048,13048,0,11909,11737,172,9.564194679
4/20/2010 13:45,2008,2007,B,Other Reporting Airports,EDINBURGH,JERSEY,28740,28740,0,31055,31055,0,-7.454516411
4/20/2010 13:45,2008,2007,B,Other Reporting Airports,EDINBURGH,KIRKWALL,35656,35656,0,29229,29229,0,21.98843575
4/20/2010 13:45,2008,2007,B,Other Reporting Airports,EDINBURGH,LEEDS BRADFORD,36473,36473,0,51313,51313,0,-28.92054558
4/20/2010 13:45,2008,2007,B,Other Reporting Airports,EDINBURGH,MANCHESTER,228551,228525,26,237836,237836,0,-3.903950691
4/20/2010 13:45,2008,2007,B,Other Reporting Airports,EDINBURGH,NEWCASTLE,67,0,67,0,0,0,
4/20/2010 13:45,2008,2007,B,Other Reporting Airports,EDINBURGH,NEWQUAY,17921,17862,59,20353,20353,0,-11.94909859
4/20/2010 13:45,2008,2007,B,Other Reporting Airports,EDINBURGH,NORWICH,58612,58612,0,57314,57277,37,2.264717102
4/20/2010 13:45,2008,2007,B,Other Reporting Airports,EDINBURGH,SOUTHAMPTON,205057,205057,0,208074,208074,0,-1.449964881
4/20/2010 13:45,2008,2007,B,Other Reporting Airports,EDINBURGH,STORNOWAY,28320,28320,0,25249,25249,0,12.16285801
4/20/2010 13:45,2008,2007,B,Other Reporting Airports,EDINBURGH,SUMBURGH,30801,30801,0,26749,26749,0,15.1482296
4/20/2010 13:45,2008,2007,B,Other Reporting Airports,EDINBURGH,WICK,7336,7255,81,6066,5976,90,20.93636703
4/20/2010 13:45,2008,2007,B,Other Reporting Airports,EXETER,GLASGOW,39424,39424,0,56303,56303,0,-29.97886467
4/20/2010 13:45,2008,2007,B,Other Reporting Airports,EXETER,GUERNSEY,26621,26621,0,26478,26478,0,0.540071011
4/20/2010 13:45,2008,2007,B,Other Reporting Airports,EXETER,INVERNESS,5824,5824,0,0,0,0,
4/20/2010 13:45,2008,2007,B,Other Reporting Airports,EXETER,ISLES OF SCILLY (ST.MARYS),4154,4154,0,4014,4014,0,3.48779273
4/20/2010 13:45,2008,2007,B,Other Reporting Airports,EXETER,JERSEY,34317,34317,0,33135,33135,0,3.567224979
4/20/2010 13:45,2008,2007,B,Other Reporting Airports,EXETER,LEEDS BRADFORD,22703,22703,0,23790,23790,0,-4.569146633
4/20/2010 13:45,2008,2007,B,Other Reporting Airports,EXETER,MANCHESTER,52470,52470,0,53942,53942,0,-2.728856802
4/20/2010 13:45,2008,2007,B,Other Reporting Airports,EXETER,NEWCASTLE,48216,48216,0,56150,56150,0,-14.1300087
4/20/2010 13:45,2008,2007,B,Other Reporting Airports,EXETER,NORWICH,10876,10876,0,29719,29719,0,-63.40388489
4/20/2010 13:45,2008,2007,B,Other Reporting Airports,FAIR ISLE,KIRKWALL,0,0,0,43,43,0,
4/20/2010 13:45,2008,2007,B,Other Reporting Airports,FAIR ISLE,LERWICK (TINGWALL),2591,2591,0,2728,2728,0,-5.021994114
4/20/2010 13:45,2008,2007,B,Other Reporting Airports,FAIR ISLE,SUMBURGH,211,211,0,139,139,0,51.7985611
4/20/2010 13:45,2008,2007,B,Other Reporting Airports,FARNBOROUGH,GLASGOW,0,0,0,43,0,43,
4/20/2010 13:45,2008,2007,B,Other Reporting Airports,FARNBOROUGH,HUMBERSIDE,35,0,35,52,0,52,-32.69230652
4/20/2010 13:45,2008,2007,B,Other Reporting Airports,FARNBOROUGH,ISLE OF MAN,0,0,0,34,0,34,
4/20/2010 13:45,2008,2007,B,Other Reporting Airports,FARNBOROUGH,LIVERPOOL,168,0,168,0,0,0,
4/20/2010 13:45,2008,2007,B,Other Reporting Airports,FARNBOROUGH,MANCHESTER,269,0,269,61,0,61,340.9836121
4/20/2010 13:45,2008,2007,B,Other Reporting Airports,FARNBOROUGH,NEWCASTLE,62,0,62,41,0,41,51.21951294
4/20/2010 13:45,2008,2007,B,Other Reporting Airports,FILTON,LIVERPOOL,28,0,28,0,0,0,
4/20/2010 13:45,2008,2007,B,Other Reporting Airports,FOULA,LERWICK (TINGWALL),1380,1380,0,1407,1407,0,-1.918976545
4/20/2010 13:45,2008,2007,B,Other Reporting Airports,GLASGOW,GUERNSEY,0,0,0,36,0,36,
4/20/2010 13:45,2008,2007,B,Other Reporting Airports,GLASGOW,INVERNESS,70,0,70,84,0,84,-16.66666603
4/20/2010 13:45,2008,2007,B,Other Reporting Airports,GLASGOW,ISLAY,29338,29338,0,28443,28443,0,3.146644115
4/20/2010 13:45,2008,2007,B,Other Reporting Airports,GLASGOW,ISLE OF MAN,16685,16685,0,18455,18455,0,-9.590896606
4/20/2010 13:45,2008,2007,B,Other Reporting Airports,GLASGOW,JERSEY,5639,5639,0,6348,6191,157,-11.16887188
4/20/2010 13:45,2008,2007,B,Other Reporting Airports,GLASGOW,KIRKWALL,15055,15055,0,15466,15466,0,-2.657442093
4/20/2010 13:45,2008,2007,B,Other Reporting Airports,GLASGOW,LEEDS BRADFORD,30438,30438,0,38690,38590,100,-21.32850838
4/20/2010 13:45,2008,2007,B,Other Reporting Airports,GLASGOW,LIVERPOOL,94,0,94,0,0,0,
4/20/2010 13:45,2008,2007,B,Other Reporting Airports,GLASGOW,MANCHESTER,151842,150797,1045,167160,166886,274,-9.163675308
4/20/2010 13:45,2008,2007,B,Other Reporting Airports,GLASGOW,NEWQUAY,1636,1636,0,0,0,0,
4/20/2010 13:45,2008,2007,B,Other Reporting Airports,GLASGOW,NORWICH,5423,5423,0,25872,25872,0,-79.03911591
4/20/2010 13:45,2008,2007,B,Other Reporting Airports,GLASGOW,PLYMOUTH,17176,17176,0,0,0,0,
4/20/2010 13:45,2008,2007,B,Other Reporting Airports,GLASGOW,SCATSTA,52,0,52,0,0,0,
4/20/2010 13:45,2008,2007,B,Other Reporting Airports,GLASGOW,SOUTHAMPTON,161558,161264,294,166454,166454,0,-2.941353083
4/20/2010 13:45,2008,2007,B,Other Reporting Airports,GLASGOW,STORNOWAY,58144,58144,0,53790,53790,0,8.094441414
4/20/2010 13:45,2008,2007,B,Other Reporting Airports,GLASGOW,SUMBURGH,17227,17227,0,16489,16489,0,4.475710869
4/20/2010 13:45,2008,2007,B,Other Reporting Airports,GLASGOW,TIREE,7894,7894,0,7417,7417,0,6.431171417
4/20/2010 13:45,2008,2007,B,Other Reporting Airports,GLOUCESTERSHIRE,ISLE OF MAN,16460,16460,0,4610,4610,0,257.0498962
4/20/2010 13:45,2008,2007,B,Other Reporting Airports,GLOUCESTERSHIRE,JERSEY,2602,2602,0,590,590,0,341.0169373
4/20/2010 13:45,2008,2007,B,Other Reporting Airports,GUERNSEY,ISLE OF MAN,2111,2111,0,3196,3196,0,-33.94868469
4/20/2010 13:45,2008,2007,B,Other Reporting Airports,GUERNSEY,JERSEY,159246,159195,51,138091,137956,135,15.31960773
4/20/2010 13:45,2008,2007,B,Other Reporting Airports,GUERNSEY,MANCHESTER,78073,77982,91,76663,76663,0,1.839218378
4/20/2010 13:45,2008,2007,B,Other Reporting Airports,GUERNSEY,NORWICH,2772,2772,0,6774,6774,0,-59.07883072
4/20/2010 13:45,2008,2007,B,Other Reporting Airports,GUERNSEY,SOUTHAMPTON,141494,141494,0,125943,125943,0,12.34764957
4/20/2010 13:45,2008,2007,B,Other Reporting Airports,HUMBERSIDE,INVERNESS,0,0,0,100,0,100,
4/20/2010 13:45,2008,2007,B,Other Reporting Airports,HUMBERSIDE,ISLE OF MAN,0,0,0,182,0,182,
4/20/2010 13:45,2008,2007,B,Other Reporting Airports,HUMBERSIDE,JERSEY,1764,0,1764,1387,0,1387,27.18096542
4/20/2010 13:45,2008,2007,B,Other Reporting Airports,HUMBERSIDE,KENT INTERNATIONAL,0,0,0,2,0,2,
4/20/2010 13:45,2008,2007,B,Other Reporting Airports,HUMBERSIDE,MANCHESTER,187,0,187,0,0,0,
4/20/2010 13:45,2008,2007,B,Other Reporting Airports,HUMBERSIDE,NORWICH,169,0,169,43,0,43,293.0232544
4/20/2010 13:45,2008,2007,B,Other Reporting Airports,HUMBERSIDE,PLYMOUTH,140,0,140,97,0,97,44.32989502
4/20/2010 13:45,2008,2007,B,Other Reporting Airports,INVERNESS,ISLAY,29,0,29,0,0,0,
4/20/2010 13:45,2008,2007,B,Other Reporting Airports,INVERNESS,ISLE OF MAN,131,0,131,13,0,13,907.6923218
4/20/2010 13:45,2008,2007,B,Other Reporting Airports,INVERNESS,JERSEY,922,0,922,0,0,0,
4/20/2010 13:45,2008,2007,B,Other Reporting Airports,INVERNESS,KIRKWALL,25085,25085,0,25867,25867,0,-3.023156881
4/20/2010 13:45,2008,2007,B,Other Reporting Airports,INVERNESS,LEEDS BRADFORD,815,815,0,2352,2231,121,-65.34864044
4/20/2010 13:45,2008,2007,B,Other Reporting Airports,INVERNESS,LIVERPOOL,0,0,0,43760,43760,0,
4/20/2010 13:45,2008,2007,B,Other Reporting Airports,INVERNESS,MANCHESTER,42940,42890,50,16719,16719,0,156.8335419
4/20/2010 13:45,2008,2007,B,Other Reporting Airports,INVERNESS,NEWCASTLE,0,0,0,36,0,36,
4/20/2010 13:45,2008,2007,B,Other Reporting Airports,INVERNESS,PRESTWICK,162,0,162,0,0,0,
4/20/2010 13:45,2008,2007,B,Other Reporting Airports,INVERNESS,SCATSTA,111,0,111,0,0,0,
4/20/2010 13:45,2008,2007,B,Other Reporting Airports,INVERNESS,SOUTH MARSTON,0,0,0,12,0,12,
4/20/2010 13:45,2008,2007,B,Other Reporting Airports,INVERNESS,SOUTHAMPTON,14862,14862,0,3330,3330,0,346.3063049
4/20/2010 13:45,2008,2007,B,Other Reporting Airports,INVERNESS,STORNOWAY,35636,35636,0,36403,36403,0,-2.106969118
4/20/2010 13:45,2008,2007,B,Other Reporting Airports,INVERNESS,SUMBURGH,158,158,0,80,80,0,97.5
4/20/2010 13:45,2008,2007,B,Other Reporting Airports,ISLE OF MAN,JERSEY,8479,8479,0,5252,5252,0,61.44326019
4/20/2010 13:45,2008,2007,B,Other Reporting Airports,ISLE OF MAN,LEEDS BRADFORD,12808,12808,0,10674,10674,0,19.99250603
4/20/2010 13:45,2008,2007,B,Other Reporting Airports,ISLE OF MAN,LIVERPOOL,133869,133869,0,141924,141924,0,-5.675572872
4/20/2010 13:45,2008,2007,B,Other Reporting Airports,ISLE OF MAN,MANCHESTER,159362,159362,0,148703,148703,0,7.16797924
4/20/2010 13:45,2008,2007,B,Other Reporting Airports,ISLE OF MAN,NEWCASTLE,6115,6115,0,6876,6876,0,-11.06748104
4/20/2010 13:45,2008,2007,B,Other Reporting Airports,ISLE OF MAN,NEWQUAY,1200,1200,0,0,0,0,
4/20/2010 13:45,2008,2007,B,Other Reporting Airports,ISLE OF MAN,SOUTHAMPTON,14393,14393,0,18337,18337,0,-21.50842476
4/20/2010 13:45,2008,2007,B,Other Reporting Airports,ISLES OF SCILLY (ST.MARYS),NEWQUAY,16690,16690,0,16586,16586,0,0.627034843
4/20/2010 13:45,2008,2007,B,Other Reporting Airports,ISLES OF SCILLY (ST.MARYS),SOUTHAMPTON,3373,3373,0,3110,3110,0,8.456591606
4/20/2010 13:45,2008,2007,B,Other Reporting Airports,JERSEY,KENT INTERNATIONAL,1435,0,1435,0,0,0,
4/20/2010 13:45,2008,2007,B,Other Reporting Airports,JERSEY,LEEDS BRADFORD,14904,14904,0,1646,0,1646,805.4677734
4/20/2010 13:45,2008,2007,B,Other Reporting Airports,JERSEY,LIVERPOOL,54241,54241,0,2724,2724,0,1891.226196
4/20/2010 13:45,2008,2007,B,Other Reporting Airports,JERSEY,MANCHESTER,102862,102777,85,117666,115131,2535,-12.58137417
4/20/2010 13:45,2008,2007,B,Other Reporting Airports,JERSEY,NEWCASTLE,13192,13192,0,4537,4464,73,190.7648163
4/20/2010 13:45,2008,2007,B,Other Reporting Airports,JERSEY,NEWQUAY,403,173,230,0,0,0,
4/20/2010 13:45,2008,2007,B,Other Reporting Airports,JERSEY,NORWICH,14600,14600,0,17048,17039,9,-14.35945606
4/20/2010 13:45,2008,2007,B,Other Reporting Airports,JERSEY,PLYMOUTH,14774,14774,0,17035,17035,0,-13.27267361
4/20/2010 13:45,2008,2007,B,Other Reporting Airports,JERSEY,SOUTHAMPTON,139313,139313,0,141714,141600,114,-1.694257498
4/20/2010 13:45,2008,2007,B,Other Reporting Airports,KENT INTERNATIONAL,MANCHESTER,37,0,37,0,0,0,
4/20/2010 13:45,2008,2007,B,Other Reporting Airports,KENT INTERNATIONAL,PRESTWICK,0,0,0,69,0,69,
4/20/2010 13:45,2008,2007,B,Other Reporting Airports,KIRKWALL,NORTH RONALDSAY,6791,6791,0,6807,6807,0,-0.235052153
4/20/2010 13:45,2008,2007,B,Other Reporting Airports,KIRKWALL,PAPA WESTRAY,3795,3795,0,4113,4113,0,-7.731582642
4/20/2010 13:45,2008,2007,B,Other Reporting Airports,KIRKWALL,SANDAY,2911,2911,0,3188,3188,0,-8.688833237
4/20/2010 13:45,2008,2007,B,Other Reporting Airports,KIRKWALL,STRONSAY,2964,2964,0,2976,2976,0,-0.403225809
4/20/2010 13:45,2008,2007,B,Other Reporting Airports,KIRKWALL,SUMBURGH,8709,8709,0,8998,8998,0,-3.211824894
4/20/2010 13:45,2008,2007,B,Other Reporting Airports,KIRKWALL,WESTRAY,3340,3340,0,3551,3551,0,-5.941987991
4/20/2010 13:45,2008,2007,B,Other Reporting Airports,KIRKWALL,WICK,0,0,0,2190,2190,0,
4/20/2010 13:45,2008,2007,B,Other Reporting Airports,LEEDS BRADFORD,NEWQUAY,4842,4838,4,30718,30718,0,-84.23725128
4/20/2010 13:45,2008,2007,B,Other Reporting Airports,LEEDS BRADFORD,PLYMOUTH,1609,1609,0,2888,2888,0,-44.28670502
4/20/2010 13:45,2008,2007,B,Other Reporting Airports,LEEDS BRADFORD,SOUTHAMPTON,86128,86128,0,85842,85811,31,0.333170235
4/20/2010 13:45,2008,2007,B,Other Reporting Airports,LEEDS BRADFORD,WICK,15,0,15,72,0,72,-79.16666412
4/20/2010 13:45,2008,2007,B,Other Reporting Airports,LERWICK (TINGWALL),OUT SKERRIES,625,625,0,694,694,0,-9.942362785
4/20/2010 13:45,2008,2007,B,Other Reporting Airports,LERWICK (TINGWALL),PAPA STOUR,135,135,0,155,155,0,-12.9032259
4/20/2010 13:45,2008,2007,B,Other Reporting Airports,LIVERPOOL,MANCHESTER,208,0,208,0,0,0,
4/20/2010 13:45,2008,2007,B,Other Reporting Airports,LIVERPOOL,SOUTHAMPTON,60,0,60,14270,14132,138,-99.57953644
4/20/2010 13:45,2008,2007,B,Other Reporting Airports,LYDD,NEWQUAY,0,0,0,86,0,86,
4/20/2010 13:45,2008,2007,B,Other Reporting Airports,MANCHESTER,NEWCASTLE,364,0,364,185,0,185,96.75675964
4/20/2010 13:45,2008,2007,B,Other Reporting Airports,MANCHESTER,NEWQUAY,42855,42855,0,58566,58566,0,-26.82614517
4/20/2010 13:45,2008,2007,B,Other Reporting Airports,MANCHESTER,NORWICH,42846,42846,0,47043,47043,0,-8.921625137
4/20/2010 13:45,2008,2007,B,Other Reporting Airports,MANCHESTER,PLYMOUTH,33002,33002,0,36835,36835,0,-10.40586376
4/20/2010 13:45,2008,2007,B,Other Reporting Airports,MANCHESTER,SOUTHAMPTON,156187,155883,304,161457,161108,349,-3.26402688
4/20/2010 13:45,2008,2007,B,Other Reporting Airports,MANCHESTER,WICK,32,0,32,0,0,0,
4/20/2010 13:45,2008,2007,B,Other Reporting Airports,NEWCASTLE,NEWQUAY,118,60,58,0,0,0,
4/20/2010 13:45,2008,2007,B,Other Reporting Airports,NEWCASTLE,PLYMOUTH,13348,13348,0,0,0,0,
4/20/2010 13:45,2008,2007,B,Other Reporting Airports,NEWCASTLE,SOUTHAMPTON,117305,117041,264,119527,119527,0,-1.858994246
4/20/2010 13:45,2008,2007,B,Other Reporting Airports,NEWQUAY,PLYMOUTH,189,189,0,4740,4740,0,-96.01265717
4/20/2010 13:45,2008,2007,B,Other Reporting Airports,NEWQUAY,SOUTHAMPTON,28,0,28,0,0,0,
4/20/2010 13:45,2008,2007,B,Other Reporting Airports,NORWICH,PLYMOUTH,0,0,0,309,0,309,
4/20/2010 13:45,2008,2007,B,Other Reporting Airports,OBAN (NORTH CONNEL),TIREE,440,440,0,0,0,0,
4/20/2010 13:45,2008,2007,B,Other Reporting Airports,SCATSTA,WOODVALE,0,0,0,48,0,48,
4/20/2010 13:45,2008,2007,B,Other Reporting Airports,SOUTH MARSTON,WICK,71,0,71,79,0,79,-10.12658215
