rundate,this_period,last_period,grp_cd,grp_name,apt1_apt_name,apt2_apt_name,total_pax_tp,total_pax_shd_tp,total_pax_cht_tp,total_pax_lp,total_pax_shd_lp,total_pax_cht_lp,total_pax_pc
10/15/2008 9:05,1991,1990,A,London Area Airports,GATWICK,ABERDEEN,154046,154046,0,128772,128672,100,19.62693787
10/15/2008 9:05,1991,1990,A,London Area Airports,GATWICK,ALDERNEY,2,0,2,0,0,0,
10/15/2008 9:05,1991,1990,A,London Area Airports,GATWICK,ANGLESEY (VALLEY),238,0,238,0,0,0,
10/15/2008 9:05,1991,1990,A,London Area Airports,GATWICK,BELFAST INTERNATIONAL,20121,19993,128,88966,88840,126,-77.38349152
10/15/2008 9:05,1991,1990,A,London Area Airports,GATWICK,BIGGIN HILL,0,0,0,9,0,9,
10/15/2008 9:05,1991,1990,A,London Area Airports,GATWICK,BIRMINGHAM,3243,2962,281,19732,19732,0,-83.56476593
10/15/2008 9:05,1991,1990,A,London Area Airports,GATWICK,BRISTOL,0,0,0,9,0,9,
10/15/2008 9:05,1991,1990,A,London Area Airports,GATWICK,COAL ASTON,0,0,0,47,47,0,
10/15/2008 9:05,1991,1990,A,London Area Airports,GATWICK,CULDROSE,0,0,0,60,30,30,
10/15/2008 9:05,1991,1990,A,London Area Airports,GATWICK,DURHAM TEES VALLEY,2282,2282,0,0,0,0,
10/15/2008 9:05,1991,1990,A,London Area Airports,GATWICK,EAST MIDLANDS INTERNATIONAL,206,0,206,2,0,2,10200
10/15/2008 9:05,1991,1990,A,London Area Airports,GATWICK,EDINBURGH,181032,180828,204,273839,273764,75,-33.89108276
10/15/2008 9:05,1991,1990,A,London Area Airports,GATWICK,EXETER,10,10,0,0,0,0,
10/15/2008 9:05,1991,1990,A,London Area Airports,GATWICK,GLASGOW,169378,169025,353,197082,196973,109,-14.05709267
10/15/2008 9:05,1991,1990,A,London Area Airports,GATWICK,GUERNSEY,88691,85348,3343,103630,103233,397,-14.4157095
10/15/2008 9:05,1991,1990,A,London Area Airports,GATWICK,HAVERFORD WEST,0,0,0,190,0,190,
10/15/2008 9:05,1991,1990,A,London Area Airports,GATWICK,HEATHROW,0,0,0,161,0,161,
10/15/2008 9:05,1991,1990,A,London Area Airports,GATWICK,INVERNESS,200,200,0,60041,60041,0,-99.66689301
10/15/2008 9:05,1991,1990,A,London Area Airports,GATWICK,JERSEY,140353,139744,609,213814,212012,1802,-34.35743332
10/15/2008 9:05,1991,1990,A,London Area Airports,GATWICK,KENT INTERNATIONAL,0,0,0,476,0,476,
10/15/2008 9:05,1991,1990,A,London Area Airports,GATWICK,LASHAM,0,0,0,10,0,10,
10/15/2008 9:05,1991,1990,A,London Area Airports,GATWICK,LEEDS BRADFORD,0,0,0,13255,13243,12,
10/15/2008 9:05,1991,1990,A,London Area Airports,GATWICK,LERWICK (TINGWALL),0,0,0,42,42,0,
10/15/2008 9:05,1991,1990,A,London Area Airports,GATWICK,LEUCHARS,0,0,0,46,0,46,
10/15/2008 9:05,1991,1990,A,London Area Airports,GATWICK,LIVERPOOL,0,0,0,1,0,1,
10/15/2008 9:05,1991,1990,A,London Area Airports,GATWICK,LONDON CITY,0,0,0,22,0,22,
10/15/2008 9:05,1991,1990,A,London Area Airports,GATWICK,LUTON,94,0,94,50,0,50,88
10/15/2008 9:05,1991,1990,A,London Area Airports,GATWICK,LYDD,0,0,0,7,0,7,
10/15/2008 9:05,1991,1990,A,London Area Airports,GATWICK,MANCHESTER,165627,164599,1028,155910,153814,2096,6.232441902
10/15/2008 9:05,1991,1990,A,London Area Airports,GATWICK,NEWCASTLE,81044,81043,1,90717,90716,1,-10.66283035
10/15/2008 9:05,1991,1990,A,London Area Airports,GATWICK,NEWQUAY,80,0,80,0,0,0,
10/15/2008 9:05,1991,1990,A,London Area Airports,GATWICK,PLYMOUTH,2494,2494,0,24022,24022,0,-89.61785126
10/15/2008 9:05,1991,1990,A,London Area Airports,GATWICK,PRESTWICK,27,0,27,108,0,108,-75
10/15/2008 9:05,1991,1990,A,London Area Airports,GATWICK,SOUTHEND,0,0,0,6,0,6,
10/15/2008 9:05,1991,1990,A,London Area Airports,GATWICK,STANSTED,0,0,0,3,0,3,
10/15/2008 9:05,1991,1990,A,London Area Airports,HEATHROW,ABERDEEN,437792,437728,64,464649,464629,20,-5.780061722
10/15/2008 9:05,1991,1990,A,London Area Airports,HEATHROW,BELFAST INTERNATIONAL,1159552,1159552,0,1116606,1113692,2914,3.846119404
10/15/2008 9:05,1991,1990,A,London Area Airports,HEATHROW,BIRMINGHAM,79664,79314,350,117082,117065,17,-31.95879745
10/15/2008 9:05,1991,1990,A,London Area Airports,HEATHROW,CARDIFF WALES,300,0,300,189,189,0,58.73015976
10/15/2008 9:05,1991,1990,A,London Area Airports,HEATHROW,CARLISLE,116,0,116,0,0,0,
10/15/2008 9:05,1991,1990,A,London Area Airports,HEATHROW,DURHAM TEES VALLEY,173551,173477,74,196722,196661,61,-11.77855015
10/15/2008 9:05,1991,1990,A,London Area Airports,HEATHROW,EAST MIDLANDS INTERNATIONAL,66227,65900,327,88812,88534,278,-25.43012238
10/15/2008 9:05,1991,1990,A,London Area Airports,HEATHROW,EDINBURGH,1277689,1277610,79,1394271,1394199,72,-8.361502647
10/15/2008 9:05,1991,1990,A,London Area Airports,HEATHROW,EXETER,98,0,98,100,0,100,-2
10/15/2008 9:05,1991,1990,A,London Area Airports,HEATHROW,GLASGOW,1277221,1277117,104,1416159,1416122,37,-9.810903549
10/15/2008 9:05,1991,1990,A,London Area Airports,HEATHROW,GUERNSEY,98783,98783,0,131800,131800,0,-25.05083466
10/15/2008 9:05,1991,1990,A,London Area Airports,HEATHROW,HEATHROW,0,0,0,96,45,51,
10/15/2008 9:05,1991,1990,A,London Area Airports,HEATHROW,HUMBERSIDE,0,0,0,24415,24378,37,
10/15/2008 9:05,1991,1990,A,London Area Airports,HEATHROW,INVERNESS,147697,147697,0,133206,133206,0,10.87863922
10/15/2008 9:05,1991,1990,A,London Area Airports,HEATHROW,ISLE OF MAN,104948,104948,0,122960,122903,57,-14.64866638
10/15/2008 9:05,1991,1990,A,London Area Airports,HEATHROW,JERSEY,303601,303479,122,288327,288237,90,5.297457218
10/15/2008 9:05,1991,1990,A,London Area Airports,HEATHROW,KENT INTERNATIONAL,595,0,595,0,0,0,
10/15/2008 9:05,1991,1990,A,London Area Airports,HEATHROW,LEEDS BRADFORD,191528,191102,426,225341,225083,258,-15.00525856
10/15/2008 9:05,1991,1990,A,London Area Airports,HEATHROW,LIVERPOOL,80117,80117,0,112076,112039,37,-28.51547241
10/15/2008 9:05,1991,1990,A,London Area Airports,HEATHROW,LONDON CITY,0,0,0,17,17,0,
10/15/2008 9:05,1991,1990,A,London Area Airports,HEATHROW,LUTON,0,0,0,305,231,74,
10/15/2008 9:05,1991,1990,A,London Area Airports,HEATHROW,MANCHESTER,887615,885933,1682,1036500,1036396,104,-14.36420631
10/15/2008 9:05,1991,1990,A,London Area Airports,HEATHROW,NEWCASTLE,353448,353448,0,388923,388923,0,-9.121342659
10/15/2008 9:05,1991,1990,A,London Area Airports,HEATHROW,NEWQUAY,31514,31386,128,41200,41200,0,-23.5097084
10/15/2008 9:05,1991,1990,A,London Area Airports,HEATHROW,NORWICH,0,0,0,68,68,0,
10/15/2008 9:05,1991,1990,A,London Area Airports,HEATHROW,PLYMOUTH,39521,39521,0,37149,37149,0,6.38509798
10/15/2008 9:05,1991,1990,A,London Area Airports,HEATHROW,PRESTWICK,69,69,0,0,0,0,
10/15/2008 9:05,1991,1990,A,London Area Airports,HEATHROW,STANSTED,0,0,0,68,0,68,
10/15/2008 9:05,1991,1990,A,London Area Airports,LONDON CITY,BLACKPOOL,88,0,88,77,0,77,14.28571415
10/15/2008 9:05,1991,1990,A,London Area Airports,LONDON CITY,COVENTRY,90,0,90,0,0,0,
10/15/2008 9:05,1991,1990,A,London Area Airports,LONDON CITY,DURHAM TEES VALLEY,183,0,183,0,0,0,
10/15/2008 9:05,1991,1990,A,London Area Airports,LONDON CITY,GUERNSEY,16,16,0,0,0,0,
10/15/2008 9:05,1991,1990,A,London Area Airports,LONDON CITY,INVERNESS,0,0,0,88,0,88,
10/15/2008 9:05,1991,1990,A,London Area Airports,LONDON CITY,JERSEY,7712,4091,3621,7447,7205,242,3.558480024
10/15/2008 9:05,1991,1990,A,London Area Airports,LONDON CITY,LIVERPOOL,44,0,44,160,0,160,-72.5
10/15/2008 9:05,1991,1990,A,London Area Airports,LONDON CITY,LYDD,0,0,0,11,11,0,
10/15/2008 9:05,1991,1990,A,London Area Airports,LONDON CITY,MANCHESTER,87,0,87,179,0,179,-51.39664841
10/15/2008 9:05,1991,1990,A,London Area Airports,LONDON CITY,NEWCASTLE,0,0,0,82,0,82,
10/15/2008 9:05,1991,1990,A,London Area Airports,LONDON CITY,NEWQUAY,0,0,0,86,86,0,
10/15/2008 9:05,1991,1990,A,London Area Airports,LONDON CITY,PLYMOUTH,92,92,0,92,92,0,0
10/15/2008 9:05,1991,1990,A,London Area Airports,LUTON,ABERDEEN,142,0,142,118,43,75,20.33898354
10/15/2008 9:05,1991,1990,A,London Area Airports,LUTON,BELFAST CITY (GEORGE BEST),11,0,11,47837,47695,142,-99.977005
10/15/2008 9:05,1991,1990,A,London Area Airports,LUTON,BELFAST INTERNATIONAL,172582,172024,558,139560,139260,300,23.66150665
10/15/2008 9:05,1991,1990,A,London Area Airports,LUTON,BIRMINGHAM,63,0,63,518,0,518,-87.83783722
10/15/2008 9:05,1991,1990,A,London Area Airports,LUTON,BLACKPOOL,0,0,0,22,0,22,
10/15/2008 9:05,1991,1990,A,London Area Airports,LUTON,BRISTOL,1,0,1,98,0,98,-98.97959137
10/15/2008 9:05,1991,1990,A,London Area Airports,LUTON,CAMBRIDGE,1,0,1,0,0,0,
10/15/2008 9:05,1991,1990,A,London Area Airports,LUTON,DURHAM TEES VALLEY,0,0,0,180,0,180,
10/15/2008 9:05,1991,1990,A,London Area Airports,LUTON,EAST MIDLANDS INTERNATIONAL,1,0,1,0,0,0,
10/15/2008 9:05,1991,1990,A,London Area Airports,LUTON,EDINBURGH,785,0,785,372,0,372,111.0215073
10/15/2008 9:05,1991,1990,A,London Area Airports,LUTON,EXETER,2,0,2,56,0,56,-96.42857361
10/15/2008 9:05,1991,1990,A,London Area Airports,LUTON,GLASGOW,21,0,21,713,27,686,-97.05469513
10/15/2008 9:05,1991,1990,A,London Area Airports,LUTON,GUERNSEY,1633,1633,0,2488,2069,419,-34.36495209
10/15/2008 9:05,1991,1990,A,London Area Airports,LUTON,HUMBERSIDE,0,0,0,88,0,88,
10/15/2008 9:05,1991,1990,A,London Area Airports,LUTON,INVERNESS,0,0,0,102,0,102,
10/15/2008 9:05,1991,1990,A,London Area Airports,LUTON,ISLE OF MAN,15308,15241,67,18540,18540,0,-17.43257904
10/15/2008 9:05,1991,1990,A,London Area Airports,LUTON,JERSEY,18142,14738,3404,22915,17658,5257,-20.82915115
10/15/2008 9:05,1991,1990,A,London Area Airports,LUTON,KINLOSS,144,0,144,0,0,0,
10/15/2008 9:05,1991,1990,A,London Area Airports,LUTON,LEEDS BRADFORD,0,0,0,1969,1969,0,
10/15/2008 9:05,1991,1990,A,London Area Airports,LUTON,LEUCHARS,0,0,0,21,0,21,
10/15/2008 9:05,1991,1990,A,London Area Airports,LUTON,LIVERPOOL,1,0,1,27,26,1,-96.29629517
10/15/2008 9:05,1991,1990,A,London Area Airports,LUTON,MANCHESTER,104,0,104,888,54,834,-88.28829193
10/15/2008 9:05,1991,1990,A,London Area Airports,LUTON,NEWCASTLE,7,0,7,47,0,47,-85.10638428
10/15/2008 9:05,1991,1990,A,London Area Airports,LUTON,NEWQUAY,72,0,72,0,0,0,
10/15/2008 9:05,1991,1990,A,London Area Airports,LUTON,PRESTWICK,0,0,0,411,0,411,
10/15/2008 9:05,1991,1990,A,London Area Airports,LUTON,SOUTHAMPTON,0,0,0,1,0,1,
10/15/2008 9:05,1991,1990,A,London Area Airports,LUTON,STANSTED,0,0,0,130,0,130,
10/15/2008 9:05,1991,1990,A,London Area Airports,SOUTHEND,ABERDEEN,69,0,69,0,0,0,
10/15/2008 9:05,1991,1990,A,London Area Airports,SOUTHEND,BELFAST INTERNATIONAL,0,0,0,68,2,66,
10/15/2008 9:05,1991,1990,A,London Area Airports,SOUTHEND,BIRMINGHAM,0,0,0,12,0,12,
10/15/2008 9:05,1991,1990,A,London Area Airports,SOUTHEND,BOURNEMOUTH,29,0,29,78,0,78,-62.82051468
10/15/2008 9:05,1991,1990,A,London Area Airports,SOUTHEND,DURHAM TEES VALLEY,0,0,0,4,0,4,
10/15/2008 9:05,1991,1990,A,London Area Airports,SOUTHEND,EXETER,120,0,120,0,0,0,
10/15/2008 9:05,1991,1990,A,London Area Airports,SOUTHEND,GLASGOW,4,0,4,161,47,114,-97.51552582
10/15/2008 9:05,1991,1990,A,London Area Airports,SOUTHEND,GUERNSEY,0,0,0,553,553,0,
10/15/2008 9:05,1991,1990,A,London Area Airports,SOUTHEND,ISLE OF MAN,0,0,0,8,8,0,
10/15/2008 9:05,1991,1990,A,London Area Airports,SOUTHEND,JERSEY,10575,7,10568,26236,7253,18983,-59.69278717
10/15/2008 9:05,1991,1990,A,London Area Airports,SOUTHEND,LEEDS BRADFORD,0,0,0,14,14,0,
10/15/2008 9:05,1991,1990,A,London Area Airports,SOUTHEND,MANCHESTER,123,0,123,29,0,29,324.1379395
10/15/2008 9:05,1991,1990,A,London Area Airports,SOUTHEND,NEWCASTLE,148,0,148,16,0,16,825
10/15/2008 9:05,1991,1990,A,London Area Airports,SOUTHEND,NEWQUAY,0,0,0,25,0,25,
10/15/2008 9:05,1991,1990,A,London Area Airports,SOUTHEND,PRESTWICK,0,0,0,1,1,0,
10/15/2008 9:05,1991,1990,A,London Area Airports,STANSTED,ABERDEEN,32565,32536,29,202,202,0,16021.28711
10/15/2008 9:05,1991,1990,A,London Area Airports,STANSTED,BELFAST INTERNATIONAL,0,0,0,721,0,721,
10/15/2008 9:05,1991,1990,A,London Area Airports,STANSTED,BIRMINGHAM,452,0,452,155,0,155,191.6128998
10/15/2008 9:05,1991,1990,A,London Area Airports,STANSTED,BRISTOL,2,0,2,0,0,0,
10/15/2008 9:05,1991,1990,A,London Area Airports,STANSTED,CAMBRIDGE,0,0,0,82,0,82,
10/15/2008 9:05,1991,1990,A,London Area Airports,STANSTED,COVENTRY,0,0,0,69,69,0,
10/15/2008 9:05,1991,1990,A,London Area Airports,STANSTED,DUNDEE,0,0,0,41,0,41,
10/15/2008 9:05,1991,1990,A,London Area Airports,STANSTED,EDINBURGH,66939,66866,73,7782,7782,0,760.1773071
10/15/2008 9:05,1991,1990,A,London Area Airports,STANSTED,GLASGOW,77424,77369,55,49797,49689,108,55.47924423
10/15/2008 9:05,1991,1990,A,London Area Airports,STANSTED,GLOUCESTERSHIRE,1,0,1,0,0,0,
10/15/2008 9:05,1991,1990,A,London Area Airports,STANSTED,GUERNSEY,31488,31450,38,25524,25447,77,23.36624336
10/15/2008 9:05,1991,1990,A,London Area Airports,STANSTED,JERSEY,41400,40542,858,49035,46316,2719,-15.57051086
10/15/2008 9:05,1991,1990,A,London Area Airports,STANSTED,LEEDS BRADFORD,142,9,133,92,18,74,54.34782791
10/15/2008 9:05,1991,1990,A,London Area Airports,STANSTED,LIVERPOOL,31,0,31,3,0,3,933.333313
10/15/2008 9:05,1991,1990,A,London Area Airports,STANSTED,MANCHESTER,38,0,38,1624,0,1624,-97.66009521
10/15/2008 9:05,1991,1990,A,London Area Airports,STANSTED,NEWCASTLE,145,26,119,167,0,167,-13.17365265
10/15/2008 9:05,1991,1990,A,London Area Airports,STANSTED,NORWICH,141,141,0,209,209,0,-32.53588486
10/15/2008 9:05,1991,1990,A,London Area Airports,STANSTED,PENZANCE HELIPORT,26,0,26,0,0,0,
10/15/2008 9:05,1991,1990,A,London Area Airports,STANSTED,PRESTWICK,76,0,76,0,0,0,
10/15/2008 9:05,1991,1990,A,London Area Airports,STANSTED,SOUTHAMPTON,22,0,22,28,28,0,-21.4285717
10/15/2008 9:05,1991,1990,A,London Area Airports,STANSTED,SUMBURGH,5,0,5,0,0,0,
10/15/2008 9:05,1991,1990,A,London Area Airports,STANSTED,WOODVALE,28,0,28,0,0,0,
10/15/2008 9:05,1991,1990,B,Other UK Airports,ABERDEEN,BENBECULA,81,0,81,82,0,82,-1.219512224
10/15/2008 9:05,1991,1990,B,Other UK Airports,ABERDEEN,BIRMINGHAM,32680,32626,54,28543,28386,157,14.49392128
10/15/2008 9:05,1991,1990,B,Other UK Airports,ABERDEEN,BOURNEMOUTH,0,0,0,12,0,12,
10/15/2008 9:05,1991,1990,B,Other UK Airports,ABERDEEN,BRISTOL,4536,4436,100,41,0,41,10963.41504
10/15/2008 9:05,1991,1990,B,Other UK Airports,ABERDEEN,CAMPBELTOWN,46,0,46,0,0,0,
10/15/2008 9:05,1991,1990,B,Other UK Airports,ABERDEEN,CITY OF DERRY (EGLINTON),0,0,0,23,0,23,
10/15/2008 9:05,1991,1990,B,Other UK Airports,ABERDEEN,COLTISHALL,0,0,0,15,0,15,
10/15/2008 9:05,1991,1990,B,Other UK Airports,ABERDEEN,DONCASTER,0,0,0,1,1,0,
10/15/2008 9:05,1991,1990,B,Other UK Airports,ABERDEEN,DOUNREAY,0,0,0,95,0,95,
10/15/2008 9:05,1991,1990,B,Other UK Airports,ABERDEEN,DUNDEE,1751,1739,12,289,274,15,505.8823547
10/15/2008 9:05,1991,1990,B,Other UK Airports,ABERDEEN,DURHAM TEES VALLEY,3082,3076,6,926,871,55,232.8293762
10/15/2008 9:05,1991,1990,B,Other UK Airports,ABERDEEN,EAST MIDLANDS INTERNATIONAL,8690,8587,103,13188,11965,1223,-34.10676193
10/15/2008 9:05,1991,1990,B,Other UK Airports,ABERDEEN,EDINBURGH,50653,50468,185,13465,13340,125,276.1827087
10/15/2008 9:05,1991,1990,B,Other UK Airports,ABERDEEN,GLASGOW,40020,39883,137,37918,37694,224,5.543541431
10/15/2008 9:05,1991,1990,B,Other UK Airports,ABERDEEN,HUMBERSIDE,18528,18315,213,20021,19867,154,-7.45717001
10/15/2008 9:05,1991,1990,B,Other UK Airports,ABERDEEN,INVERNESS,1285,1156,129,1460,1410,50,-11.98630142
10/15/2008 9:05,1991,1990,B,Other UK Airports,ABERDEEN,ISLE OF SKYE,8,0,8,0,0,0,
10/15/2008 9:05,1991,1990,B,Other UK Airports,ABERDEEN,JERSEY,3344,1400,1944,2356,171,2185,41.93548203
10/15/2008 9:05,1991,1990,B,Other UK Airports,ABERDEEN,KINLOSS,7,0,7,13,0,13,-46.15384674
10/15/2008 9:05,1991,1990,B,Other UK Airports,ABERDEEN,KIRKWALL,25786,25106,680,26185,25720,465,-1.523773193
10/15/2008 9:05,1991,1990,B,Other UK Airports,ABERDEEN,LEEDS BRADFORD,3745,3745,0,7119,7038,81,-47.39429855
10/15/2008 9:05,1991,1990,B,Other UK Airports,ABERDEEN,LEUCHARS,113,0,113,50,0,50,126
10/15/2008 9:05,1991,1990,B,Other UK Airports,ABERDEEN,MANCHESTER,53147,52998,149,54915,54564,351,-3.219521046
10/15/2008 9:05,1991,1990,B,Other UK Airports,ABERDEEN,NEWCASTLE,21842,21754,88,19052,18860,192,14.64413166
10/15/2008 9:05,1991,1990,B,Other UK Airports,ABERDEEN,NORWICH,80234,80205,29,76335,76293,42,5.107748508
10/15/2008 9:05,1991,1990,B,Other UK Airports,ABERDEEN,PERTH (UK),6,0,6,0,0,0,
10/15/2008 9:05,1991,1990,B,Other UK Airports,ABERDEEN,PETERHEAD,99,0,99,14,0,14,607.1428833
10/15/2008 9:05,1991,1990,B,Other UK Airports,ABERDEEN,PLYMOUTH,0,0,0,6,0,6,
10/15/2008 9:05,1991,1990,B,Other UK Airports,ABERDEEN,PRIVATE STRIPS/HELIPADS,12,0,12,26,0,26,-53.84615326
10/15/2008 9:05,1991,1990,B,Other UK Airports,ABERDEEN,SCATSTA,13751,0,13751,12525,3,12522,9.788423538
10/15/2008 9:05,1991,1990,B,Other UK Airports,ABERDEEN,STORNOWAY,74,55,19,2,0,2,3600
10/15/2008 9:05,1991,1990,B,Other UK Airports,ABERDEEN,SUMBURGH,239660,70827,168833,234661,64730,169931,2.130307198
10/15/2008 9:05,1991,1990,B,Other UK Airports,ABERDEEN,TIREE,24,0,24,0,0,0,
10/15/2008 9:05,1991,1990,B,Other UK Airports,ABERDEEN,UNST,39866,0,39866,36958,33,36925,7.868391037
10/15/2008 9:05,1991,1990,B,Other UK Airports,ABERDEEN,WICK,14765,14765,0,13254,13115,139,11.40033245
10/15/2008 9:05,1991,1990,B,Other UK Airports,ABERDEEN,WOLVERHAMPTON,0,0,0,17,0,17,
10/15/2008 9:05,1991,1990,B,Other UK Airports,ALDERNEY,BOURNEMOUTH,4,4,0,0,0,0,
10/15/2008 9:05,1991,1990,B,Other UK Airports,ALDERNEY,GUERNSEY,2306,2306,0,0,0,0,
10/15/2008 9:05,1991,1990,B,Other UK Airports,ALDERNEY,JERSEY,544,544,0,0,0,0,
10/15/2008 9:05,1991,1990,B,Other UK Airports,ALDERNEY,MANCHESTER,0,0,0,35,0,35,
10/15/2008 9:05,1991,1990,B,Other UK Airports,ALDERNEY,SOUTHAMPTON,1995,1995,0,2,2,0,99650
10/15/2008 9:05,1991,1990,B,Other UK Airports,BARRA,BARRA,0,0,0,9,9,0,
10/15/2008 9:05,1991,1990,B,Other UK Airports,BARROW-IN-FURNESS,BLACKPOOL,7,7,0,0,0,0,
10/15/2008 9:05,1991,1990,B,Other UK Airports,BARROW-IN-FURNESS,MANCHESTER,96,96,0,0,0,0,
10/15/2008 9:05,1991,1990,B,Other UK Airports,BECCLES,NORWICH,20,0,20,4,0,4,400
10/15/2008 9:05,1991,1990,B,Other UK Airports,BELFAST CITY (GEORGE BEST),BELFAST INTERNATIONAL,0,0,0,17,0,17,
10/15/2008 9:05,1991,1990,B,Other UK Airports,BELFAST CITY (GEORGE BEST),BIRMINGHAM,44841,44841,0,34463,34362,101,30.11345482
10/15/2008 9:05,1991,1990,B,Other UK Airports,BELFAST CITY (GEORGE BEST),BLACKPOOL,43651,43582,69,58383,57644,739,-25.23337364
10/15/2008 9:05,1991,1990,B,Other UK Airports,BELFAST CITY (GEORGE BEST),BRISTOL,18771,18771,0,11845,11752,93,58.47192764
10/15/2008 9:05,1991,1990,B,Other UK Airports,BELFAST CITY (GEORGE BEST),CARDIFF WALES,7995,7995,0,0,0,0,
10/15/2008 9:05,1991,1990,B,Other UK Airports,BELFAST CITY (GEORGE BEST),CARLISLE,2,0,2,0,0,0,
10/15/2008 9:05,1991,1990,B,Other UK Airports,BELFAST CITY (GEORGE BEST),COVENTRY,38,0,38,0,0,0,
10/15/2008 9:05,1991,1990,B,Other UK Airports,BELFAST CITY (GEORGE BEST),DURHAM TEES VALLEY,0,0,0,803,803,0,
10/15/2008 9:05,1991,1990,B,Other UK Airports,BELFAST CITY (GEORGE BEST),EAST MIDLANDS INTERNATIONAL,0,0,0,1,0,1,
10/15/2008 9:05,1991,1990,B,Other UK Airports,BELFAST CITY (GEORGE BEST),EDINBURGH,66921,66895,26,66608,66576,32,0.469913512
10/15/2008 9:05,1991,1990,B,Other UK Airports,BELFAST CITY (GEORGE BEST),EXETER,11594,11594,0,9860,9860,0,17.58620644
10/15/2008 9:05,1991,1990,B,Other UK Airports,BELFAST CITY (GEORGE BEST),GLASGOW,74319,74255,64,77918,77904,14,-4.618958473
10/15/2008 9:05,1991,1990,B,Other UK Airports,BELFAST CITY (GEORGE BEST),GUERNSEY,145,105,40,555,338,217,-73.87387085
10/15/2008 9:05,1991,1990,B,Other UK Airports,BELFAST CITY (GEORGE BEST),ISLE OF MAN,25118,25004,114,16324,15658,666,53.8716011
10/15/2008 9:05,1991,1990,B,Other UK Airports,BELFAST CITY (GEORGE BEST),JERSEY,7937,7937,0,22508,19392,3116,-64.73698425
10/15/2008 9:05,1991,1990,B,Other UK Airports,BELFAST CITY (GEORGE BEST),LEEDS BRADFORD,29615,29615,0,28908,28775,133,2.445689678
10/15/2008 9:05,1991,1990,B,Other UK Airports,BELFAST CITY (GEORGE BEST),LIVERPOOL,79232,79196,36,64175,64129,46,23.46240807
10/15/2008 9:05,1991,1990,B,Other UK Airports,BELFAST CITY (GEORGE BEST),MANCHESTER,92034,92034,0,85560,85559,1,7.566619873
10/15/2008 9:05,1991,1990,B,Other UK Airports,BELFAST CITY (GEORGE BEST),NEWCASTLE,24583,24583,0,13473,13412,61,82.46121979
10/15/2008 9:05,1991,1990,B,Other UK Airports,BELFAST CITY (GEORGE BEST),SOUTHAMPTON,8655,8655,0,2461,2461,0,251.6863098
10/15/2008 9:05,1991,1990,B,Other UK Airports,BELFAST CITY (GEORGE BEST),WICK,0,0,0,28,0,28,
10/15/2008 9:05,1991,1990,B,Other UK Airports,BELFAST INTERNATIONAL,BELFAST INTERNATIONAL,1,0,1,42,0,42,-97.61904907
10/15/2008 9:05,1991,1990,B,Other UK Airports,BELFAST INTERNATIONAL,BIRMINGHAM,89112,88210,902,129811,129352,459,-31.35250473
10/15/2008 9:05,1991,1990,B,Other UK Airports,BELFAST INTERNATIONAL,BLACKPOOL,39,0,39,9,0,9,333.3333435
10/15/2008 9:05,1991,1990,B,Other UK Airports,BELFAST INTERNATIONAL,BOURNEMOUTH,84,0,84,0,0,0,
10/15/2008 9:05,1991,1990,B,Other UK Airports,BELFAST INTERNATIONAL,BRISTOL,1740,1690,50,8557,8494,63,-79.66577148
10/15/2008 9:05,1991,1990,B,Other UK Airports,BELFAST INTERNATIONAL,CARDIFF WALES,1620,1492,128,8641,8617,24,-81.25216675
10/15/2008 9:05,1991,1990,B,Other UK Airports,BELFAST INTERNATIONAL,COVENTRY,67,0,67,2,0,2,3250
10/15/2008 9:05,1991,1990,B,Other UK Airports,BELFAST INTERNATIONAL,DURHAM TEES VALLEY,78,36,42,184,120,64,-57.60869598
10/15/2008 9:05,1991,1990,B,Other UK Airports,BELFAST INTERNATIONAL,EAST MIDLANDS INTERNATIONAL,62228,61542,686,69061,68773,288,-9.894151688
10/15/2008 9:05,1991,1990,B,Other UK Airports,BELFAST INTERNATIONAL,EDINBURGH,213,200,13,488,78,410,-56.35245895
10/15/2008 9:05,1991,1990,B,Other UK Airports,BELFAST INTERNATIONAL,EXETER,51,51,0,0,0,0,
10/15/2008 9:05,1991,1990,B,Other UK Airports,BELFAST INTERNATIONAL,GLASGOW,56431,55868,563,50107,49637,470,12.62099075
10/15/2008 9:05,1991,1990,B,Other UK Airports,BELFAST INTERNATIONAL,GUERNSEY,0,0,0,1055,1055,0,
10/15/2008 9:05,1991,1990,B,Other UK Airports,BELFAST INTERNATIONAL,HUMBERSIDE,0,0,0,54,0,54,
10/15/2008 9:05,1991,1990,B,Other UK Airports,BELFAST INTERNATIONAL,ISLE OF MAN,93,69,24,308,85,223,-69.80519104
10/15/2008 9:05,1991,1990,B,Other UK Airports,BELFAST INTERNATIONAL,JERSEY,21166,21083,83,24133,23758,375,-12.29436874
10/15/2008 9:05,1991,1990,B,Other UK Airports,BELFAST INTERNATIONAL,LEEDS BRADFORD,52020,51928,92,75014,74856,158,-30.65294456
10/15/2008 9:05,1991,1990,B,Other UK Airports,BELFAST INTERNATIONAL,LIVERPOOL,1109,142,967,682,194,488,62.60997009
10/15/2008 9:05,1991,1990,B,Other UK Airports,BELFAST INTERNATIONAL,MANCHESTER,130838,130397,441,127956,127519,437,2.25233674
10/15/2008 9:05,1991,1990,B,Other UK Airports,BELFAST INTERNATIONAL,NEWCASTLE,9993,9737,256,16388,16354,34,-39.02245712
10/15/2008 9:05,1991,1990,B,Other UK Airports,BELFAST INTERNATIONAL,NEWQUAY,0,0,0,64,0,64,
10/15/2008 9:05,1991,1990,B,Other UK Airports,BELFAST INTERNATIONAL,PRESTWICK,51,0,51,120,38,82,-57.5
10/15/2008 9:05,1991,1990,B,Other UK Airports,BELFAST INTERNATIONAL,SOUTHAMPTON,0,0,0,24,0,24,
10/15/2008 9:05,1991,1990,B,Other UK Airports,BEMBRIDGE,JERSEY,620,0,620,324,0,324,91.3580246
10/15/2008 9:05,1991,1990,B,Other UK Airports,BENBECULA,BLACKPOOL,23,0,23,0,0,0,
10/15/2008 9:05,1991,1990,B,Other UK Airports,BENBECULA,GLASGOW,19055,19055,0,20031,20031,0,-4.872447491
10/15/2008 9:05,1991,1990,B,Other UK Airports,BENBECULA,GLENROTHES,0,0,0,55,55,0,
10/15/2008 9:05,1991,1990,B,Other UK Airports,BENBECULA,INVERNESS,0,0,0,32,15,17,
10/15/2008 9:05,1991,1990,B,Other UK Airports,BENBECULA,ST KILDA,380,0,380,390,0,390,-2.56410265
10/15/2008 9:05,1991,1990,B,Other UK Airports,BENBECULA,STORNOWAY,9447,9431,16,9783,9706,77,-3.434529305
10/15/2008 9:05,1991,1990,B,Other UK Airports,BENBECULA,TIREE,0,0,0,35,35,0,
10/15/2008 9:05,1991,1990,B,Other UK Airports,BIGGIN HILL,DURHAM TEES VALLEY,0,0,0,3,0,3,
10/15/2008 9:05,1991,1990,B,Other UK Airports,BIGGIN HILL,EDINBURGH,0,0,0,24,0,24,
10/15/2008 9:05,1991,1990,B,Other UK Airports,BIGGIN HILL,JERSEY,0,0,0,36,0,36,
10/15/2008 9:05,1991,1990,B,Other UK Airports,BIGGIN HILL,MANCHESTER,0,0,0,18,0,18,
10/15/2008 9:05,1991,1990,B,Other UK Airports,BIGGIN HILL,SOUTHAMPTON,0,0,0,17,0,17,
10/15/2008 9:05,1991,1990,B,Other UK Airports,BIRMINGHAM,BIRMINGHAM,60,0,60,0,0,0,
10/15/2008 9:05,1991,1990,B,Other UK Airports,BIRMINGHAM,BRISTOL,0,0,0,298,0,298,
10/15/2008 9:05,1991,1990,B,Other UK Airports,BIRMINGHAM,CARDIFF WALES,0,0,0,2,0,2,
10/15/2008 9:05,1991,1990,B,Other UK Airports,BIRMINGHAM,DUNDEE,66,0,66,22,0,22,200
10/15/2008 9:05,1991,1990,B,Other UK Airports,BIRMINGHAM,EAST MIDLANDS INTERNATIONAL,727,727,0,2763,2740,23,-73.6880188
10/15/2008 9:05,1991,1990,B,Other UK Airports,BIRMINGHAM,EDINBURGH,148322,147591,731,139071,138810,261,6.651998043
10/15/2008 9:05,1991,1990,B,Other UK Airports,BIRMINGHAM,EXETER,0,0,0,58,0,58,
10/15/2008 9:05,1991,1990,B,Other UK Airports,BIRMINGHAM,GLASGOW,138663,138405,258,165255,164702,553,-16.09149551
10/15/2008 9:05,1991,1990,B,Other UK Airports,BIRMINGHAM,GUERNSEY,33776,33776,0,20093,19895,198,68.0983429
10/15/2008 9:05,1991,1990,B,Other UK Airports,BIRMINGHAM,ISLE OF MAN,31854,31854,0,31933,31933,0,-0.247392982
10/15/2008 9:05,1991,1990,B,Other UK Airports,BIRMINGHAM,JERSEY,76350,65466,10884,105026,83288,21738,-27.30371475
10/15/2008 9:05,1991,1990,B,Other UK Airports,BIRMINGHAM,LIVERPOOL,54,0,54,68,22,46,-20.58823586
10/15/2008 9:05,1991,1990,B,Other UK Airports,BIRMINGHAM,MANCHESTER,570,0,570,200,11,189,185
10/15/2008 9:05,1991,1990,B,Other UK Airports,BIRMINGHAM,NEWCASTLE,12043,12037,6,17972,16264,1708,-32.99020767
10/15/2008 9:05,1991,1990,B,Other UK Airports,BIRMINGHAM,NORWICH,145,0,145,0,0,0,
10/15/2008 9:05,1991,1990,B,Other UK Airports,BIRMINGHAM,PRESTWICK,2,0,2,57,0,57,-96.4912262
10/15/2008 9:05,1991,1990,B,Other UK Airports,BIRMINGHAM,SOUTHAMPTON,0,0,0,1405,1405,0,
10/15/2008 9:05,1991,1990,B,Other UK Airports,BIRMINGHAM,SUMBURGH,20,20,0,0,0,0,
10/15/2008 9:05,1991,1990,B,Other UK Airports,BIRMINGHAM,WICK,44,0,44,0,0,0,
10/15/2008 9:05,1991,1990,B,Other UK Airports,BLACKBUSHE,JERSEY,0,0,0,103,0,103,
10/15/2008 9:05,1991,1990,B,Other UK Airports,BLACKPOOL,BRISTOL,0,0,0,17,0,17,
10/15/2008 9:05,1991,1990,B,Other UK Airports,BLACKPOOL,EDINBURGH,0,0,0,32,0,32,
10/15/2008 9:05,1991,1990,B,Other UK Airports,BLACKPOOL,EXETER,0,0,0,17,17,0,
10/15/2008 9:05,1991,1990,B,Other UK Airports,BLACKPOOL,ISLE OF MAN,41256,41212,44,19619,19607,12,110.2859497
10/15/2008 9:05,1991,1990,B,Other UK Airports,BLACKPOOL,JERSEY,3381,3248,133,2747,2747,0,23.07972336
10/15/2008 9:05,1991,1990,B,Other UK Airports,BLACKPOOL,LEUCHARS,0,0,0,48,22,26,
10/15/2008 9:05,1991,1990,B,Other UK Airports,BLACKPOOL,MANCHESTER,298,26,272,379,0,379,-21.37203217
10/15/2008 9:05,1991,1990,B,Other UK Airports,BLACKPOOL,SCATSTA,0,0,0,32,32,0,
10/15/2008 9:05,1991,1990,B,Other UK Airports,BOURNEMOUTH,DUNDEE,0,0,0,20,0,20,
10/15/2008 9:05,1991,1990,B,Other UK Airports,BOURNEMOUTH,EDINBURGH,35,0,35,0,0,0,
10/15/2008 9:05,1991,1990,B,Other UK Airports,BOURNEMOUTH,EXETER,0,0,0,33,33,0,
10/15/2008 9:05,1991,1990,B,Other UK Airports,BOURNEMOUTH,GLASGOW,37,0,37,0,0,0,
10/15/2008 9:05,1991,1990,B,Other UK Airports,BOURNEMOUTH,GUERNSEY,20225,19177,1048,39521,38532,989,-48.82467651
10/15/2008 9:05,1991,1990,B,Other UK Airports,BOURNEMOUTH,JERSEY,36540,34685,1855,28879,27676,1203,26.5279274
10/15/2008 9:05,1991,1990,B,Other UK Airports,BOURNEMOUTH,KENT INTERNATIONAL,0,0,0,33,0,33,
10/15/2008 9:05,1991,1990,B,Other UK Airports,BOURNEMOUTH,LEEDS BRADFORD,94,0,94,14,0,14,571.4285889
10/15/2008 9:05,1991,1990,B,Other UK Airports,BOURNEMOUTH,MANCHESTER,0,0,0,1113,1035,78,
10/15/2008 9:05,1991,1990,B,Other UK Airports,BOURNEMOUTH,SOUTHAMPTON,6,0,6,88,0,88,-93.1818161
10/15/2008 9:05,1991,1990,B,Other UK Airports,BRISTOL,CARDIFF WALES,140,0,140,17,0,17,723.5294189
10/15/2008 9:05,1991,1990,B,Other UK Airports,BRISTOL,DURHAM TEES VALLEY,0,0,0,271,0,271,
10/15/2008 9:05,1991,1990,B,Other UK Airports,BRISTOL,EAST MIDLANDS INTERNATIONAL,46,0,46,30,0,30,53.33333206
10/15/2008 9:05,1991,1990,B,Other UK Airports,BRISTOL,EDINBURGH,25304,25285,19,1405,1381,24,1700.99646
10/15/2008 9:05,1991,1990,B,Other UK Airports,BRISTOL,EXETER,277,277,0,83,45,38,233.7349396
10/15/2008 9:05,1991,1990,B,Other UK Airports,BRISTOL,GLASGOW,29095,29053,42,8255,8171,84,252.453064
10/15/2008 9:05,1991,1990,B,Other UK Airports,BRISTOL,GUERNSEY,19116,19059,57,10597,10448,149,80.39067841
10/15/2008 9:05,1991,1990,B,Other UK Airports,BRISTOL,HUMBERSIDE,82,0,82,0,0,0,
10/15/2008 9:05,1991,1990,B,Other UK Airports,BRISTOL,ISLES OF SCILLY (ST.MARYS),0,0,0,671,671,0,
10/15/2008 9:05,1991,1990,B,Other UK Airports,BRISTOL,JERSEY,31048,26939,4109,23320,20414,2906,33.13893509
10/15/2008 9:05,1991,1990,B,Other UK Airports,BRISTOL,LEEDS BRADFORD,0,0,0,72,72,0,
10/15/2008 9:05,1991,1990,B,Other UK Airports,BRISTOL,LIVERPOOL,21,0,21,0,0,0,
10/15/2008 9:05,1991,1990,B,Other UK Airports,BRISTOL,MANCHESTER,6028,5998,30,7915,7714,201,-23.84080887
10/15/2008 9:05,1991,1990,B,Other UK Airports,BRISTOL,NEWCASTLE,380,48,332,0,0,0,
10/15/2008 9:05,1991,1990,B,Other UK Airports,BRISTOL,NORWICH,13,0,13,0,0,0,
10/15/2008 9:05,1991,1990,B,Other UK Airports,BRISTOL,PENZANCE HELIPORT,6,0,6,0,0,0,
10/15/2008 9:05,1991,1990,B,Other UK Airports,BRISTOL,PERTH (UK),0,0,0,47,0,47,
10/15/2008 9:05,1991,1990,B,Other UK Airports,BRISTOL,PLYMOUTH,2720,2719,1,117,105,12,2224.786377
10/15/2008 9:05,1991,1990,B,Other UK Airports,BRISTOL,PRIVATE STRIPS/HELIPADS,5,0,5,4,0,4,25
10/15/2008 9:05,1991,1990,B,Other UK Airports,CAMBRIDGE,GUERNSEY,0,0,0,1685,1645,40,
10/15/2008 9:05,1991,1990,B,Other UK Airports,CAMBRIDGE,JERSEY,3683,3683,0,4948,4948,0,-25.56588554
10/15/2008 9:05,1991,1990,B,Other UK Airports,CAMBRIDGE,MANCHESTER,6944,6849,95,8242,8242,0,-15.74860477
10/15/2008 9:05,1991,1990,B,Other UK Airports,CAMBRIDGE,NORWICH,0,0,0,6,6,0,
10/15/2008 9:05,1991,1990,B,Other UK Airports,CAMBRIDGE,PRIVATE STRIPS/HELIPADS,0,0,0,18,18,0,
10/15/2008 9:05,1991,1990,B,Other UK Airports,CAMPBELTOWN,GLASGOW,10041,10041,0,10896,10896,0,-7.846916199
10/15/2008 9:05,1991,1990,B,Other UK Airports,CAMPBELTOWN,KIRKWALL,92,0,92,0,0,0,
10/15/2008 9:05,1991,1990,B,Other UK Airports,CARDIFF WALES,EDINBURGH,5836,0,5836,188,0,188,3004.255371
10/15/2008 9:05,1991,1990,B,Other UK Airports,CARDIFF WALES,GLASGOW,9928,9806,122,113,9,104,8685.84082
10/15/2008 9:05,1991,1990,B,Other UK Airports,CARDIFF WALES,GUERNSEY,1540,1540,0,3280,3280,0,-53.04878235
10/15/2008 9:05,1991,1990,B,Other UK Airports,CARDIFF WALES,ISLE OF MAN,1514,1514,0,199,13,186,660.8040161
10/15/2008 9:05,1991,1990,B,Other UK Airports,CARDIFF WALES,JERSEY,20401,14879,5522,13675,8306,5369,49.18464279
10/15/2008 9:05,1991,1990,B,Other UK Airports,CARDIFF WALES,LEEDS BRADFORD,0,0,0,6210,6210,0,
10/15/2008 9:05,1991,1990,B,Other UK Airports,CARDIFF WALES,LIVERPOOL,1860,1855,5,4925,4443,482,-62.23350143
10/15/2008 9:05,1991,1990,B,Other UK Airports,CARDIFF WALES,MANCHESTER,622,21,601,503,26,477,23.65805244
10/15/2008 9:05,1991,1990,B,Other UK Airports,CARDIFF WALES,NEWCASTLE,183,0,183,647,0,647,-71.71561432
10/15/2008 9:05,1991,1990,B,Other UK Airports,CARDIFF WALES,PRIVATE STRIPS/HELIPADS,1,0,1,0,0,0,
10/15/2008 9:05,1991,1990,B,Other UK Airports,CARLISLE,DURHAM TEES VALLEY,0,0,0,5,0,5,
10/15/2008 9:05,1991,1990,B,Other UK Airports,CARLISLE,MANCHESTER,42,0,42,0,0,0,
10/15/2008 9:05,1991,1990,B,Other UK Airports,CITY OF DERRY (EGLINTON),GLASGOW,13610,13610,0,13142,13142,0,3.561101913
10/15/2008 9:05,1991,1990,B,Other UK Airports,CITY OF DERRY (EGLINTON),MANCHESTER,13030,12762,268,9723,9723,0,34.01213455
10/15/2008 9:05,1991,1990,B,Other UK Airports,CITY OF DERRY (EGLINTON),SOUTHAMPTON,0,0,0,38,38,0,
10/15/2008 9:05,1991,1990,B,Other UK Airports,COVENTRY,GLASGOW,0,0,0,27,27,0,
10/15/2008 9:05,1991,1990,B,Other UK Airports,COVENTRY,JERSEY,74,0,74,72,0,72,2.777777672
10/15/2008 9:05,1991,1990,B,Other UK Airports,COVENTRY,KENT INTERNATIONAL,0,0,0,12,0,12,
10/15/2008 9:05,1991,1990,B,Other UK Airports,COVENTRY,MANCHESTER,0,0,0,2,2,0,
10/15/2008 9:05,1991,1990,B,Other UK Airports,COVENTRY,NEWCASTLE,58,0,58,7,7,0,728.5714111
10/15/2008 9:05,1991,1990,B,Other UK Airports,CRANFIELD,JERSEY,84,0,84,0,0,0,
10/15/2008 9:05,1991,1990,B,Other UK Airports,DONCASTER SHEFFIELD,HUMBERSIDE,0,0,0,35,0,35,
10/15/2008 9:05,1991,1990,B,Other UK Airports,DUNDEE,HUMBERSIDE,50,0,50,0,0,0,
10/15/2008 9:05,1991,1990,B,Other UK Airports,DUNDEE,LIVERPOOL,12,0,12,0,0,0,
10/15/2008 9:05,1991,1990,B,Other UK Airports,DUNDEE,MANCHESTER,14,14,0,794,794,0,-98.23677826
10/15/2008 9:05,1991,1990,B,Other UK Airports,DURHAM TEES VALLEY,DURHAM TEES VALLEY,0,0,0,27,0,27,
10/15/2008 9:05,1991,1990,B,Other UK Airports,DURHAM TEES VALLEY,DUXFORD,0,0,0,12,0,12,
10/15/2008 9:05,1991,1990,B,Other UK Airports,DURHAM TEES VALLEY,EAST MIDLANDS INTERNATIONAL,0,0,0,55,55,0,
10/15/2008 9:05,1991,1990,B,Other UK Airports,DURHAM TEES VALLEY,EDINBURGH,42,0,42,49,0,49,-14.28571415
10/15/2008 9:05,1991,1990,B,Other UK Airports,DURHAM TEES VALLEY,GUERNSEY,0,0,0,77,77,0,
10/15/2008 9:05,1991,1990,B,Other UK Airports,DURHAM TEES VALLEY,HUMBERSIDE,415,349,66,510,510,0,-18.62745094
10/15/2008 9:05,1991,1990,B,Other UK Airports,DURHAM TEES VALLEY,INVERNESS,64,0,64,24,24,0,166.6666718
10/15/2008 9:05,1991,1990,B,Other UK Airports,DURHAM TEES VALLEY,JERSEY,11002,10916,86,13577,11175,2402,-18.96589851
10/15/2008 9:05,1991,1990,B,Other UK Airports,DURHAM TEES VALLEY,LEEDS BRADFORD,2,0,2,133,133,0,-98.49623871
10/15/2008 9:05,1991,1990,B,Other UK Airports,DURHAM TEES VALLEY,LIVERPOOL,141,0,141,0,0,0,
10/15/2008 9:05,1991,1990,B,Other UK Airports,DURHAM TEES VALLEY,MANCHESTER,41,0,41,109,109,0,-62.38532257
10/15/2008 9:05,1991,1990,B,Other UK Airports,DURHAM TEES VALLEY,NEWCASTLE,78,37,41,224,224,0,-65.17857361
10/15/2008 9:05,1991,1990,B,Other UK Airports,DURHAM TEES VALLEY,NORWICH,6521,6521,0,7760,7760,0,-15.96649456
10/15/2008 9:05,1991,1990,B,Other UK Airports,DURHAM TEES VALLEY,PLYMOUTH,172,0,172,0,0,0,
10/15/2008 9:05,1991,1990,B,Other UK Airports,DURHAM TEES VALLEY,PRESTWICK,30,0,30,0,0,0,
10/15/2008 9:05,1991,1990,B,Other UK Airports,DURHAM TEES VALLEY,PRIVATE STRIPS/HELIPADS,0,0,0,165,37,128,
10/15/2008 9:05,1991,1990,B,Other UK Airports,EAST MIDLANDS INTERNATIONAL,EDINBURGH,21046,21039,7,17534,17123,411,20.02965736
10/15/2008 9:05,1991,1990,B,Other UK Airports,EAST MIDLANDS INTERNATIONAL,EXETER,0,0,0,82,0,82,
10/15/2008 9:05,1991,1990,B,Other UK Airports,EAST MIDLANDS INTERNATIONAL,GLASGOW,78051,77914,137,88796,88609,187,-12.10077
10/15/2008 9:05,1991,1990,B,Other UK Airports,EAST MIDLANDS INTERNATIONAL,GUERNSEY,23811,23811,0,25265,25008,257,-5.754997253
10/15/2008 9:05,1991,1990,B,Other UK Airports,EAST MIDLANDS INTERNATIONAL,ISLE OF MAN,61,0,61,0,0,0,
10/15/2008 9:05,1991,1990,B,Other UK Airports,EAST MIDLANDS INTERNATIONAL,JERSEY,71685,67921,3764,82180,77330,4850,-12.77074718
10/15/2008 9:05,1991,1990,B,Other UK Airports,EAST MIDLANDS INTERNATIONAL,LEEDS BRADFORD,0,0,0,26,0,26,
10/15/2008 9:05,1991,1990,B,Other UK Airports,EAST MIDLANDS INTERNATIONAL,LIVERPOOL,0,0,0,26,26,0,
10/15/2008 9:05,1991,1990,B,Other UK Airports,EAST MIDLANDS INTERNATIONAL,MANCHESTER,206,0,206,379,0,379,-45.6464386
10/15/2008 9:05,1991,1990,B,Other UK Airports,EAST MIDLANDS INTERNATIONAL,NEWCASTLE,0,0,0,277,0,277,
10/15/2008 9:05,1991,1990,B,Other UK Airports,EAST MIDLANDS INTERNATIONAL,NEWQUAY,123,0,123,0,0,0,
10/15/2008 9:05,1991,1990,B,Other UK Airports,EAST MIDLANDS INTERNATIONAL,NORWICH,15,0,15,0,0,0,
10/15/2008 9:05,1991,1990,B,Other UK Airports,EAST MIDLANDS INTERNATIONAL,PRESTWICK,0,0,0,502,0,502,
10/15/2008 9:05,1991,1990,B,Other UK Airports,EDAY,KIRKWALL,2279,2279,0,2740,2740,0,-16.82481766
10/15/2008 9:05,1991,1990,B,Other UK Airports,EDINBURGH,EXETER,0,0,0,79,0,79,
10/15/2008 9:05,1991,1990,B,Other UK Airports,EDINBURGH,GLASGOW,245,237,8,136,127,9,80.14705658
10/15/2008 9:05,1991,1990,B,Other UK Airports,EDINBURGH,GLOUCESTERSHIRE,0,0,0,17,0,17,
10/15/2008 9:05,1991,1990,B,Other UK Airports,EDINBURGH,GUERNSEY,2352,2352,0,2159,2159,0,8.939323425
10/15/2008 9:05,1991,1990,B,Other UK Airports,EDINBURGH,HUMBERSIDE,230,230,0,97,97,0,137.1134033
10/15/2008 9:05,1991,1990,B,Other UK Airports,EDINBURGH,INVERNESS,22,22,0,369,16,353,-94.03794098
10/15/2008 9:05,1991,1990,B,Other UK Airports,EDINBURGH,ISLAY,30,0,30,0,0,0,
10/15/2008 9:05,1991,1990,B,Other UK Airports,EDINBURGH,ISLE OF MAN,0,0,0,169,68,101,
10/15/2008 9:05,1991,1990,B,Other UK Airports,EDINBURGH,JERSEY,7500,3188,4312,8545,2829,5716,-12.22937393
10/15/2008 9:05,1991,1990,B,Other UK Airports,EDINBURGH,KINLOSS,0,0,0,60,0,60,
10/15/2008 9:05,1991,1990,B,Other UK Airports,EDINBURGH,KIRKWALL,6072,5259,813,1839,1839,0,230.1794434
10/15/2008 9:05,1991,1990,B,Other UK Airports,EDINBURGH,LEEDS BRADFORD,27134,27072,62,41558,41482,76,-34.70811844
10/15/2008 9:05,1991,1990,B,Other UK Airports,EDINBURGH,LERWICK (TINGWALL),5652,5652,0,8463,8318,145,-33.21517181
10/15/2008 9:05,1991,1990,B,Other UK Airports,EDINBURGH,LIVERPOOL,0,0,0,24,0,24,
10/15/2008 9:05,1991,1990,B,Other UK Airports,EDINBURGH,MANCHESTER,86698,86432,266,98825,98508,317,-12.27118683
10/15/2008 9:05,1991,1990,B,Other UK Airports,EDINBURGH,NEWCASTLE,187,30,157,110,31,79,70
10/15/2008 9:05,1991,1990,B,Other UK Airports,EDINBURGH,NORWICH,10422,10422,0,10169,10169,0,2.487953663
10/15/2008 9:05,1991,1990,B,Other UK Airports,EDINBURGH,PORTSMOUTH (UK),0,0,0,128,0,128,
10/15/2008 9:05,1991,1990,B,Other UK Airports,EDINBURGH,PRESTWICK,49,0,49,0,0,0,
10/15/2008 9:05,1991,1990,B,Other UK Airports,EDINBURGH,SOUTHAMPTON,2117,1943,174,0,0,0,
10/15/2008 9:05,1991,1990,B,Other UK Airports,EDINBURGH,STORNOWAY,21,0,21,168,0,168,-87.5
10/15/2008 9:05,1991,1990,B,Other UK Airports,EDINBURGH,SUMBURGH,1705,1667,38,0,0,0,
10/15/2008 9:05,1991,1990,B,Other UK Airports,EDINBURGH,UNST,1657,1617,40,18,18,0,9105.555664
10/15/2008 9:05,1991,1990,B,Other UK Airports,EDINBURGH,WICK,10525,10436,89,12342,12316,26,-14.72208691
10/15/2008 9:05,1991,1990,B,Other UK Airports,EXETER,GLASGOW,134,0,134,0,0,0,
10/15/2008 9:05,1991,1990,B,Other UK Airports,EXETER,GUERNSEY,23206,23142,64,40726,40714,12,-43.01920319
10/15/2008 9:05,1991,1990,B,Other UK Airports,EXETER,ISLES OF SCILLY (ST.MARYS),1020,1020,0,517,517,0,97.29206848
10/15/2008 9:05,1991,1990,B,Other UK Airports,EXETER,JERSEY,44504,44380,124,48313,48285,28,-7.8840065
10/15/2008 9:05,1991,1990,B,Other UK Airports,EXETER,LIVERPOOL,19,0,19,22,22,0,-13.63636398
10/15/2008 9:05,1991,1990,B,Other UK Airports,EXETER,LYDD,0,0,0,40,0,40,
10/15/2008 9:05,1991,1990,B,Other UK Airports,EXETER,MANCHESTER,7215,7179,36,5095,5094,1,41.60942078
10/15/2008 9:05,1991,1990,B,Other UK Airports,EXETER,NEWCASTLE,450,0,450,0,0,0,
10/15/2008 9:05,1991,1990,B,Other UK Airports,EXETER,NEWQUAY,0,0,0,79,21,58,
10/15/2008 9:05,1991,1990,B,Other UK Airports,EXETER,NORWICH,0,0,0,262,0,262,
10/15/2008 9:05,1991,1990,B,Other UK Airports,EXETER,PLYMOUTH,37,37,0,915,915,0,-95.95628357
10/15/2008 9:05,1991,1990,B,Other UK Airports,EXETER,REDHILL,0,0,0,36,36,0,
10/15/2008 9:05,1991,1990,B,Other UK Airports,EXETER,TOLLERTON NOTTINGHAM,48,0,48,0,0,0,
10/15/2008 9:05,1991,1990,B,Other UK Airports,EXETER,WHITE WALTHAM,0,0,0,46,46,0,
10/15/2008 9:05,1991,1990,B,Other UK Airports,FAIR ISLE,KIRKWALL,154,154,0,254,254,0,-39.37007904
10/15/2008 9:05,1991,1990,B,Other UK Airports,FAIR ISLE,LERWICK (TINGWALL),3,3,0,0,0,0,
10/15/2008 9:05,1991,1990,B,Other UK Airports,FAIR ISLE,SUMBURGH,46,0,46,569,26,543,-91.91564178
10/15/2008 9:05,1991,1990,B,Other UK Airports,FAIROAKS,JERSEY,25,0,25,43,0,43,-41.860466
10/15/2008 9:05,1991,1990,B,Other UK Airports,FETLAR,SUMBURGH,0,0,0,2,0,2,
10/15/2008 9:05,1991,1990,B,Other UK Airports,GLASGOW,GUERNSEY,2517,2117,400,2352,1605,747,7.015305996
10/15/2008 9:05,1991,1990,B,Other UK Airports,GLASGOW,HATFIELD,150,0,150,0,0,0,
10/15/2008 9:05,1991,1990,B,Other UK Airports,GLASGOW,HUMBERSIDE,6,0,6,66,0,66,-90.90908813
10/15/2008 9:05,1991,1990,B,Other UK Airports,GLASGOW,INVERNESS,11172,10975,197,6731,6599,132,65.97830963
10/15/2008 9:05,1991,1990,B,Other UK Airports,GLASGOW,ISLAY,20740,20622,118,20711,20684,27,0.140022203
10/15/2008 9:05,1991,1990,B,Other UK Airports,GLASGOW,ISLE OF MAN,19517,19517,0,22449,21699,750,-13.06071568
10/15/2008 9:05,1991,1990,B,Other UK Airports,GLASGOW,JERSEY,40335,31708,8627,46580,20705,25875,-13.40704155
10/15/2008 9:05,1991,1990,B,Other UK Airports,GLASGOW,KIRKWALL,11774,11648,126,7052,7052,0,66.95972443
10/15/2008 9:05,1991,1990,B,Other UK Airports,GLASGOW,LEEDS BRADFORD,25607,25458,149,17364,16068,1296,47.47177887
10/15/2008 9:05,1991,1990,B,Other UK Airports,GLASGOW,LIVERPOOL,4,0,4,852,813,39,-99.53051758
10/15/2008 9:05,1991,1990,B,Other UK Airports,GLASGOW,MANCHESTER,96676,96355,321,113345,112419,926,-14.70642757
10/15/2008 9:05,1991,1990,B,Other UK Airports,GLASGOW,NEWCASTLE,152,150,2,16,16,0,850
10/15/2008 9:05,1991,1990,B,Other UK Airports,GLASGOW,NORWICH,77,51,26,0,0,0,
10/15/2008 9:05,1991,1990,B,Other UK Airports,GLASGOW,PRESTWICK,41,0,41,272,0,272,-84.9264679
10/15/2008 9:05,1991,1990,B,Other UK Airports,GLASGOW,PRIVATE STRIPS/HELIPADS,0,0,0,14,0,14,
10/15/2008 9:05,1991,1990,B,Other UK Airports,GLASGOW,SOUTHAMPTON,6645,6645,0,124,94,30,5258.871094
10/15/2008 9:05,1991,1990,B,Other UK Airports,GLASGOW,STORNOWAY,44078,44078,0,42381,42381,0,4.004152775
10/15/2008 9:05,1991,1990,B,Other UK Airports,GLASGOW,SUMBURGH,12826,12457,369,30786,30695,91,-58.33820724
10/15/2008 9:05,1991,1990,B,Other UK Airports,GLASGOW,TIREE,4945,4945,0,1287,1287,0,284.2268982
10/15/2008 9:05,1991,1990,B,Other UK Airports,GLASGOW,WICK,52,0,52,0,0,0,
10/15/2008 9:05,1991,1990,B,Other UK Airports,GLOUCESTERSHIRE,GUERNSEY,0,0,0,705,0,705,
10/15/2008 9:05,1991,1990,B,Other UK Airports,GLOUCESTERSHIRE,JERSEY,2629,0,2629,2784,0,2784,-5.567528725
10/15/2008 9:05,1991,1990,B,Other UK Airports,GLOUCESTERSHIRE,SOUTHAMPTON,0,0,0,34,0,34,
10/15/2008 9:05,1991,1990,B,Other UK Airports,GUERNSEY,JERSEY,101874,101835,39,121,121,0,84093.39063
10/15/2008 9:05,1991,1990,B,Other UK Airports,GUERNSEY,LEEDS BRADFORD,2376,2376,0,2,2,0,118700
10/15/2008 9:05,1991,1990,B,Other UK Airports,GUERNSEY,MANCHESTER,18125,17895,230,0,0,0,
10/15/2008 9:05,1991,1990,B,Other UK Airports,GUERNSEY,NEWCASTLE,0,0,0,46,46,0,
10/15/2008 9:05,1991,1990,B,Other UK Airports,GUERNSEY,NORWICH,959,959,0,22,22,0,4259.09082
10/15/2008 9:05,1991,1990,B,Other UK Airports,GUERNSEY,PLYMOUTH,2516,2516,0,0,0,0,
10/15/2008 9:05,1991,1990,B,Other UK Airports,GUERNSEY,SOUTHAMPTON,66000,65795,205,74,74,0,89089.1875
10/15/2008 9:05,1991,1990,B,Other UK Airports,HATFIELD,KIRKWALL,0,0,0,3,3,0,
10/15/2008 9:05,1991,1990,B,Other UK Airports,HATFIELD,NEWCASTLE,142,0,142,0,0,0,
10/15/2008 9:05,1991,1990,B,Other UK Airports,HUCKNALL,LIVERPOOL,0,0,0,36,0,36,
10/15/2008 9:05,1991,1990,B,Other UK Airports,HUMBERSIDE,JERSEY,5434,1769,3665,6619,2494,4125,-17.9030056
10/15/2008 9:05,1991,1990,B,Other UK Airports,HUMBERSIDE,KIRKWALL,33,0,33,0,0,0,
10/15/2008 9:05,1991,1990,B,Other UK Airports,HUMBERSIDE,LEEDS BRADFORD,0,0,0,52,0,52,
10/15/2008 9:05,1991,1990,B,Other UK Airports,HUMBERSIDE,NORWICH,2853,2853,0,9466,9466,0,-69.86054993
10/15/2008 9:05,1991,1990,B,Other UK Airports,HUMBERSIDE,SOUTHAMPTON,0,0,0,36,0,36,
10/15/2008 9:05,1991,1990,B,Other UK Airports,INVERNESS,KINLOSS,1,0,1,0,0,0,
10/15/2008 9:05,1991,1990,B,Other UK Airports,INVERNESS,KIRKWALL,10234,10149,85,7963,7471,492,28.51940155
10/15/2008 9:05,1991,1990,B,Other UK Airports,INVERNESS,MANCHESTER,1841,1575,266,878,878,0,109.6810913
10/15/2008 9:05,1991,1990,B,Other UK Airports,INVERNESS,NEWCASTLE,107,0,107,42,27,15,154.7619019
10/15/2008 9:05,1991,1990,B,Other UK Airports,INVERNESS,SCATSTA,61,0,61,0,0,0,
10/15/2008 9:05,1991,1990,B,Other UK Airports,INVERNESS,STORNOWAY,21158,20941,217,22121,22044,77,-4.353329182
10/15/2008 9:05,1991,1990,B,Other UK Airports,INVERNESS,SUMBURGH,1762,1762,0,10782,10692,90,-83.65795135
10/15/2008 9:05,1991,1990,B,Other UK Airports,INVERNESS,UNST,37,0,37,0,0,0,
10/15/2008 9:05,1991,1990,B,Other UK Airports,INVERNESS,WICK,0,0,0,39,39,0,
10/15/2008 9:05,1991,1990,B,Other UK Airports,ISLAY,ISLAY,12,0,12,13,13,0,-7.692307472
10/15/2008 9:05,1991,1990,B,Other UK Airports,ISLAY,LIVERPOOL,49,0,49,0,0,0,
10/15/2008 9:05,1991,1990,B,Other UK Airports,ISLE OF MAN,JERSEY,64,64,0,890,361,529,-92.80899048
10/15/2008 9:05,1991,1990,B,Other UK Airports,ISLE OF MAN,KIRKWALL,0,0,0,20,20,0,
10/15/2008 9:05,1991,1990,B,Other UK Airports,ISLE OF MAN,LEEDS BRADFORD,902,902,0,1655,1354,301,-45.49848938
10/15/2008 9:05,1991,1990,B,Other UK Airports,ISLE OF MAN,LIVERPOOL,105169,105060,109,136041,135542,499,-22.6931591
10/15/2008 9:05,1991,1990,B,Other UK Airports,ISLE OF MAN,MANCHESTER,66428,66311,117,79509,79363,146,-16.45222473
10/15/2008 9:05,1991,1990,B,Other UK Airports,ISLE OF MAN,NEWCASTLE,1259,812,447,1171,1171,0,7.514944553
10/15/2008 9:05,1991,1990,B,Other UK Airports,ISLE OF MAN,PORTSMOUTH (UK),38,0,38,0,0,0,
10/15/2008 9:05,1991,1990,B,Other UK Airports,ISLE OF MAN,PRESTWICK,30,0,30,0,0,0,
10/15/2008 9:05,1991,1990,B,Other UK Airports,ISLE OF MAN,SOUTHAMPTON,60,0,60,48,0,48,25
10/15/2008 9:05,1991,1990,B,Other UK Airports,ISLE OF MAN,WELLESBOURNE MOUNTFORD,31,0,31,0,0,0,
10/15/2008 9:05,1991,1990,B,Other UK Airports,JERSEY,JERSEY,0,0,0,89,89,0,
10/15/2008 9:05,1991,1990,B,Other UK Airports,JERSEY,KENT INTERNATIONAL,1830,0,1830,2174,0,2174,-15.82336712
10/15/2008 9:05,1991,1990,B,Other UK Airports,JERSEY,LEEDS BRADFORD,19425,19332,93,24929,22257,2672,-22.07870293
10/15/2008 9:05,1991,1990,B,Other UK Airports,JERSEY,LIVERPOOL,10420,10416,4,16973,10581,6392,-38.60837936
10/15/2008 9:05,1991,1990,B,Other UK Airports,JERSEY,LYDD,1324,0,1324,1905,158,1747,-30.49868774
10/15/2008 9:05,1991,1990,B,Other UK Airports,JERSEY,MANCHESTER,118041,103655,14386,122804,107111,15693,-3.878538132
10/15/2008 9:05,1991,1990,B,Other UK Airports,JERSEY,NEWCASTLE,17383,17383,0,16399,16399,0,6.000365734
10/15/2008 9:05,1991,1990,B,Other UK Airports,JERSEY,NORWICH,8124,8124,0,14357,10776,3581,-43.41436386
10/15/2008 9:05,1991,1990,B,Other UK Airports,JERSEY,PLYMOUTH,9213,9213,0,17501,17409,92,-47.35729218
10/15/2008 9:05,1991,1990,B,Other UK Airports,JERSEY,SHOBDON,0,0,0,91,0,91,
10/15/2008 9:05,1991,1990,B,Other UK Airports,JERSEY,SHOREHAM,1332,0,1332,0,0,0,
10/15/2008 9:05,1991,1990,B,Other UK Airports,JERSEY,SOUTHAMPTON,183719,182553,1166,243555,242161,1394,-24.56775665
10/15/2008 9:05,1991,1990,B,Other UK Airports,JERSEY,SWANSEA,0,0,0,95,0,95,
10/15/2008 9:05,1991,1990,B,Other UK Airports,JERSEY,WOODFORD,0,0,0,44,0,44,
10/15/2008 9:05,1991,1990,B,Other UK Airports,KENT INTERNATIONAL,LYDD,0,0,0,81,0,81,
10/15/2008 9:05,1991,1990,B,Other UK Airports,KIRKWALL,NEWCASTLE,34,0,34,0,0,0,
10/15/2008 9:05,1991,1990,B,Other UK Airports,KIRKWALL,NORTH RONALDSAY,2520,2520,0,2905,2905,0,-13.2530117
10/15/2008 9:05,1991,1990,B,Other UK Airports,KIRKWALL,PAPA WESTRAY,3005,3005,0,2647,2647,0,13.52474499
10/15/2008 9:05,1991,1990,B,Other UK Airports,KIRKWALL,SANDAY,5495,5495,0,6103,6103,0,-9.962313652
10/15/2008 9:05,1991,1990,B,Other UK Airports,KIRKWALL,SCATSTA,54,0,54,0,0,0,
10/15/2008 9:05,1991,1990,B,Other UK Airports,KIRKWALL,STORNOWAY,45,0,45,82,19,63,-45.12195206
10/15/2008 9:05,1991,1990,B,Other UK Airports,KIRKWALL,STRONSAY,4276,4276,0,5354,5354,0,-20.13447952
10/15/2008 9:05,1991,1990,B,Other UK Airports,KIRKWALL,SUMBURGH,9949,9906,43,11375,11365,10,-12.53626347
10/15/2008 9:05,1991,1990,B,Other UK Airports,KIRKWALL,UNST,0,0,0,19,0,19,
10/15/2008 9:05,1991,1990,B,Other UK Airports,KIRKWALL,WESTRAY,5626,5626,0,6642,6533,109,-15.29659748
10/15/2008 9:05,1991,1990,B,Other UK Airports,KIRKWALL,WICK,17238,17238,0,17518,17498,20,-1.598356009
10/15/2008 9:05,1991,1990,B,Other UK Airports,KIRKWALL,WYTON,0,0,0,2,2,0,
10/15/2008 9:05,1991,1990,B,Other UK Airports,LEEDS BRADFORD,LEEDS BRADFORD,103,0,103,11,11,0,836.3636475
10/15/2008 9:05,1991,1990,B,Other UK Airports,LEEDS BRADFORD,MANCHESTER,0,0,0,75,75,0,
10/15/2008 9:05,1991,1990,B,Other UK Airports,LEEDS BRADFORD,METRO LONDON HELIPORT,0,0,0,11,0,11,
10/15/2008 9:05,1991,1990,B,Other UK Airports,LEEDS BRADFORD,NEWCASTLE,66,0,66,25,16,9,164
10/15/2008 9:05,1991,1990,B,Other UK Airports,LEEDS BRADFORD,NORWICH,5611,5611,0,5385,5385,0,4.196843147
10/15/2008 9:05,1991,1990,B,Other UK Airports,LEEDS BRADFORD,PRESTWICK,0,0,0,2,2,0,
10/15/2008 9:05,1991,1990,B,Other UK Airports,LEEDS BRADFORD,PRIVATE STRIPS/HELIPADS,0,0,0,9,9,0,
10/15/2008 9:05,1991,1990,B,Other UK Airports,LEEDS BRADFORD,SOUTHAMPTON,0,0,0,4012,4012,0,
10/15/2008 9:05,1991,1990,B,Other UK Airports,LEUCHARS,NEWCASTLE,0,0,0,36,0,36,
10/15/2008 9:05,1991,1990,B,Other UK Airports,LIVERPOOL,MANCHESTER,153,0,153,196,0,196,-21.93877602
10/15/2008 9:05,1991,1990,B,Other UK Airports,LIVERPOOL,NEWCASTLE,4,0,4,0,0,0,
10/15/2008 9:05,1991,1990,B,Other UK Airports,LIVERPOOL,NORTHOLT,0,0,0,3,0,3,
10/15/2008 9:05,1991,1990,B,Other UK Airports,LIVERPOOL,PLYMOUTH,46,0,46,0,0,0,
10/15/2008 9:05,1991,1990,B,Other UK Airports,LIVERPOOL,PRESTWICK,36,0,36,0,0,0,
10/15/2008 9:05,1991,1990,B,Other UK Airports,LIVERPOOL,SANDOWN,55,0,55,0,0,0,
10/15/2008 9:05,1991,1990,B,Other UK Airports,LYDD,SHOREHAM,91,0,91,0,0,0,
10/15/2008 9:05,1991,1990,B,Other UK Airports,MANCHESTER,NEWCASTLE,16489,16374,115,13858,13430,428,18.98542404
10/15/2008 9:05,1991,1990,B,Other UK Airports,MANCHESTER,NORWICH,247,0,247,0,0,0,
10/15/2008 9:05,1991,1990,B,Other UK Airports,MANCHESTER,PLYMOUTH,0,0,0,38,0,38,
10/15/2008 9:05,1991,1990,B,Other UK Airports,MANCHESTER,PRESTWICK,27,27,0,70,0,70,-61.42856979
10/15/2008 9:05,1991,1990,B,Other UK Airports,MANCHESTER,SOUTHAMPTON,251,0,251,836,0,836,-69.97607422
10/15/2008 9:05,1991,1990,B,Other UK Airports,MANCHESTER,SUMBURGH,35936,35936,0,37183,37110,73,-3.353683233
10/15/2008 9:05,1991,1990,B,Other UK Airports,NEWCASTLE,NORWICH,0,0,0,5,0,5,
10/15/2008 9:05,1991,1990,B,Other UK Airports,NEWCASTLE,PLYMOUTH,0,0,0,131,0,131,
10/15/2008 9:05,1991,1990,B,Other UK Airports,NEWCASTLE,SOUTHAMPTON,0,0,0,91,0,91,
10/15/2008 9:05,1991,1990,B,Other UK Airports,NORWICH,PRIVATE STRIPS/HELIPADS,15,0,15,3,0,3,400
10/15/2008 9:05,1991,1990,B,Other UK Airports,NORWICH,SOUTHAMPTON,7,0,7,40,40,0,-82.5
10/15/2008 9:05,1991,1990,B,Other UK Airports,PLYMOUTH,SOUTHAMPTON,0,0,0,46,0,46,
10/15/2008 9:05,1991,1990,B,Other UK Airports,PRESTWICK,STORNOWAY,22,0,22,41,0,41,-46.341465
10/15/2008 9:05,1991,1990,B,Other UK Airports,PRIVATE STRIPS/HELIPADS,SOUTHAMPTON,13,0,13,51,51,0,-74.50980377
10/15/2008 9:05,1991,1990,B,Other UK Airports,PRIVATE STRIPS/HELIPADS,SUMBURGH,1,0,1,52,0,52,-98.07691956
10/15/2008 9:05,1991,1990,B,Other UK Airports,SCATSTA,STORNOWAY,30,0,30,0,0,0,
10/15/2008 9:05,1991,1990,B,Other UK Airports,STORNOWAY,SUMBURGH,29,0,29,63,0,63,-53.96825409
10/15/2008 9:05,1991,1990,B,Other UK Airports,STRONSAY,WICK,0,0,0,1,1,0,
10/15/2008 9:05,1991,1990,B,Other UK Airports,SUMBURGH,UNST,1249,0,1249,3195,17,3178,-60.90766907
10/15/2008 9:05,1991,1990,B,Other UK Airports,SUMBURGH,WELLESBOURNE MOUNTFORD,0,0,0,16,0,16,
10/15/2008 9:05,1991,1990,B,Other UK Airports,SUMBURGH,WICK,0,0,0,2599,2482,117,
