rundate,this_period,last_period,grp_name,apt1_apt_name,apt2_apt_name,total_pax_tp,total_pax_shd_tp,total_pax_cht_tp,total_pax_lp,total_pax_shd_lp,total_pax_cht_lp,total_pax_pc
15/04/05 14:21,2004,2003,London Area Airports,GATWICK,ABERDEEN,240021,240021,0,254669,254669,0,-5.751779556
15/04/05 14:21,2004,2003,London Area Airports,GATWICK,BELFAST CITY,210012,210012,0,239864,239796,68,-12.44538593
15/04/05 14:21,2004,2003,London Area Airports,GATWICK,BELFAST INTERNATIONAL,313521,313042,479,219460,219460,0,42.86020279
15/04/05 14:21,2004,2003,London Area Airports,GATWICK,BRISTOL,157,0,157,0,0,0,
15/04/05 14:21,2004,2003,London Area Airports,GATWICK,CARDIFF WALES,439,0,439,75,0,75,485.3333435
15/04/05 14:21,2004,2003,London Area Airports,GATWICK,EDINBURGH,739075,738759,316,771050,770486,564,-4.146942616
15/04/05 14:21,2004,2003,London Area Airports,GATWICK,GLASGOW,396536,396532,4,387840,387151,689,2.242161751
15/04/05 14:21,2004,2003,London Area Airports,GATWICK,GUERNSEY,333694,328240,5454,326893,326893,0,2.080497265
15/04/05 14:21,2004,2003,London Area Airports,GATWICK,INVERNESS,247828,247828,0,224472,224426,46,10.40486145
15/04/05 14:21,2004,2003,London Area Airports,GATWICK,ISLE OF MAN,129269,129269,0,121587,121587,0,6.318109512
15/04/05 14:21,2004,2003,London Area Airports,GATWICK,JERSEY,531234,531217,17,545313,544833,480,-2.581820011
15/04/05 14:21,2004,2003,London Area Airports,GATWICK,LEEDS BRADFORD,0,0,0,8392,8384,8,
15/04/05 14:21,2004,2003,London Area Airports,GATWICK,MANCHESTER,420456,419612,844,442020,437963,4057,-4.878512383
15/04/05 14:21,2004,2003,London Area Airports,GATWICK,NEWCASTLE,247074,246900,174,256387,256387,0,-3.632399559
15/04/05 14:21,2004,2003,London Area Airports,GATWICK,NEWQUAY,46910,46910,0,48349,48349,0,-2.976276636
15/04/05 14:21,2004,2003,London Area Airports,GATWICK,NOTTINGHAM EAST MIDLANDS INT'L,78,0,78,147,0,147,-46.93877411
15/04/05 14:21,2004,2003,London Area Airports,GATWICK,PLYMOUTH,60922,60922,0,57445,57445,0,6.052746296
15/04/05 14:21,2004,2003,London Area Airports,GATWICK,WICK,37,0,37,0,0,0,
15/04/05 14:21,2004,2003,London Area Airports,HEATHROW,ABERDEEN,623555,623555,0,507290,507290,0,22.91884232
15/04/05 14:21,2004,2003,London Area Airports,HEATHROW,BELFAST CITY,770055,770055,0,784822,784822,0,-1.8815732
15/04/05 14:21,2004,2003,London Area Airports,HEATHROW,BELFAST INTERNATIONAL,0,0,0,26835,26327,508,
15/04/05 14:21,2004,2003,London Area Airports,HEATHROW,BIRMINGHAM,0,0,0,198,0,198,
15/04/05 14:21,2004,2003,London Area Airports,HEATHROW,CARDIFF WALES,0,0,0,572,0,572,
15/04/05 14:21,2004,2003,London Area Airports,HEATHROW,DUNDEE,6,0,6,0,0,0,
15/04/05 14:21,2004,2003,London Area Airports,HEATHROW,DURHAM TEES VALLEY,144446,144446,0,145665,145665,0,-0.836851656
15/04/05 14:21,2004,2003,London Area Airports,HEATHROW,EDINBURGH,1696300,1696300,0,1661780,1661052,728,2.077290535
15/04/05 14:21,2004,2003,London Area Airports,HEATHROW,EXETER,75,0,75,2,0,2,3650
15/04/05 14:21,2004,2003,London Area Airports,HEATHROW,FAIRFORD,1360,0,1360,0,0,0,
15/04/05 14:21,2004,2003,London Area Airports,HEATHROW,FARNBOROUGH,5,0,5,0,0,0,
15/04/05 14:21,2004,2003,London Area Airports,HEATHROW,FILTON,0,0,0,100,0,100,
15/04/05 14:21,2004,2003,London Area Airports,HEATHROW,GLASGOW,1535570,1535570,0,1465222,1465188,34,4.801183701
15/04/05 14:21,2004,2003,London Area Airports,HEATHROW,GLOUCESTERSHIRE,0,0,0,4,0,4,
15/04/05 14:21,2004,2003,London Area Airports,HEATHROW,INVERNESS,46945,46945,0,0,0,0,
15/04/05 14:21,2004,2003,London Area Airports,HEATHROW,JERSEY,0,0,0,165,0,165,
15/04/05 14:21,2004,2003,London Area Airports,HEATHROW,LEEDS BRADFORD,184729,184729,0,181105,181015,90,2.001049042
15/04/05 14:21,2004,2003,London Area Airports,HEATHROW,MANCHESTER,1401546,1401546,0,1385220,1385007,213,1.17858541
15/04/05 14:21,2004,2003,London Area Airports,HEATHROW,NEWCASTLE,520361,520361,0,494685,494656,29,5.190373898
15/04/05 14:21,2004,2003,London Area Airports,HEATHROW,NOTTINGHAM EAST MIDLANDS INT'L,0,0,0,7,0,7,
15/04/05 14:21,2004,2003,London Area Airports,HEATHROW,OXFORD (KIDLINGTON),0,0,0,1,0,1,
15/04/05 14:21,2004,2003,London Area Airports,HEATHROW,PRESTWICK,7,0,7,0,0,0,
15/04/05 14:21,2004,2003,London Area Airports,HEATHROW,WATTISHAM,0,0,0,4,0,4,
15/04/05 14:21,2004,2003,London Area Airports,HEATHROW,WICK,2,0,2,25,0,25,-92
15/04/05 14:21,2004,2003,London Area Airports,LONDON CITY,ABERDEEN,0,0,0,1,0,1,
15/04/05 14:21,2004,2003,London Area Airports,LONDON CITY,BELFAST CITY,33940,33940,0,43325,43325,0,-21.6618576
15/04/05 14:21,2004,2003,London Area Airports,LONDON CITY,BRISTOL,0,0,0,10,0,10,
15/04/05 14:21,2004,2003,London Area Airports,LONDON CITY,CARDIFF WALES,0,0,0,99,99,0,
15/04/05 14:21,2004,2003,London Area Airports,LONDON CITY,DUNDEE,49575,49575,0,48062,48062,0,3.148017168
15/04/05 14:21,2004,2003,London Area Airports,LONDON CITY,DURHAM TEES VALLEY,6,0,6,0,0,0,
15/04/05 14:21,2004,2003,London Area Airports,LONDON CITY,EDINBURGH,192283,192258,25,117658,117491,167,63.42535019
15/04/05 14:21,2004,2003,London Area Airports,LONDON CITY,EXETER,0,0,0,1,0,1,
15/04/05 14:21,2004,2003,London Area Airports,LONDON CITY,GLASGOW,2,0,2,28244,28244,0,-99.99291992
15/04/05 14:21,2004,2003,London Area Airports,LONDON CITY,GLOUCESTERSHIRE,0,0,0,48,0,48,
15/04/05 14:21,2004,2003,London Area Airports,LONDON CITY,GUERNSEY,3,0,3,0,0,0,
15/04/05 14:21,2004,2003,London Area Airports,LONDON CITY,ISLE OF MAN,16828,16828,0,29251,29251,0,-42.47034454
15/04/05 14:21,2004,2003,London Area Airports,LONDON CITY,JERSEY,42030,42030,0,47442,47440,2,-11.40761375
15/04/05 14:21,2004,2003,London Area Airports,LONDON CITY,LEEDS BRADFORD,4454,4454,0,1,0,1,445300
15/04/05 14:21,2004,2003,London Area Airports,LONDON CITY,LIVERPOOL,68275,68275,0,52,0,52,131198.0781
15/04/05 14:21,2004,2003,London Area Airports,LONDON CITY,MANCHESTER,133669,133669,0,97154,97154,0,37.58465958
15/04/05 14:21,2004,2003,London Area Airports,LONDON CITY,NEWCASTLE,5,0,5,0,0,0,
15/04/05 14:21,2004,2003,London Area Airports,LONDON CITY,SWANSEA,8407,8407,0,14733,14733,0,-42.93762207
15/04/05 14:21,2004,2003,London Area Airports,LUTON,ABERDEEN,155992,155978,14,159089,159089,0,-1.946709037
15/04/05 14:21,2004,2003,London Area Airports,LUTON,BELFAST CITY,6,0,6,0,0,0,
15/04/05 14:21,2004,2003,London Area Airports,LUTON,BELFAST INTERNATIONAL,402339,402339,0,405114,404970,144,-0.684992373
15/04/05 14:21,2004,2003,London Area Airports,LUTON,BIGGIN HILL,5,0,5,5,0,5,0
15/04/05 14:21,2004,2003,London Area Airports,LUTON,BIRMINGHAM,0,0,0,59,0,59,
15/04/05 14:21,2004,2003,London Area Airports,LUTON,BLACKPOOL,56,0,56,88,0,88,-36.36363602
15/04/05 14:21,2004,2003,London Area Airports,LUTON,BOURNEMOUTH,0,0,0,6,0,6,
15/04/05 14:21,2004,2003,London Area Airports,LUTON,BRIZE NORTON,5,0,5,0,0,0,
15/04/05 14:21,2004,2003,London Area Airports,LUTON,CARDIFF WALES,32,0,32,1045,0,1045,-96.93779755
15/04/05 14:21,2004,2003,London Area Airports,LUTON,DURHAM TEES VALLEY,43,0,43,141,0,141,-69.50354767
15/04/05 14:21,2004,2003,London Area Airports,LUTON,EDINBURGH,453218,453092,126,485228,484856,372,-6.596898556
15/04/05 14:21,2004,2003,London Area Airports,LUTON,EXETER,3,0,3,0,0,0,
15/04/05 14:21,2004,2003,London Area Airports,LUTON,FARNBOROUGH,1,0,1,4,0,4,-75
15/04/05 14:21,2004,2003,London Area Airports,LUTON,GLASGOW,466534,466317,217,474982,474318,664,-1.778593659
15/04/05 14:21,2004,2003,London Area Airports,LUTON,GUERNSEY,0,0,0,6,0,6,
15/04/05 14:21,2004,2003,London Area Airports,LUTON,HUMBERSIDE,5,0,5,0,0,0,
15/04/05 14:21,2004,2003,London Area Airports,LUTON,INVERNESS,115027,115022,5,112297,112266,31,2.4310534
15/04/05 14:21,2004,2003,London Area Airports,LUTON,ISLE OF MAN,34106,34016,90,39233,39168,65,-13.0680809
15/04/05 14:21,2004,2003,London Area Airports,LUTON,JERSEY,4641,4617,24,22109,22107,2,-79.00854492
15/04/05 14:21,2004,2003,London Area Airports,LUTON,LEEDS BRADFORD,56,0,56,61,0,61,-8.196721077
15/04/05 14:21,2004,2003,London Area Airports,LUTON,LIVERPOOL,252,0,252,310,26,284,-18.70967674
15/04/05 14:21,2004,2003,London Area Airports,LUTON,MANCHESTER,311,0,311,1267,0,1267,-75.4538269
15/04/05 14:21,2004,2003,London Area Airports,LUTON,NEWCASTLE,178,0,178,163,0,163,9.202453613
15/04/05 14:21,2004,2003,London Area Airports,LUTON,NEWQUAY,6,0,6,7,0,7,-14.28571415
15/04/05 14:21,2004,2003,London Area Airports,LUTON,NOTTINGHAM EAST MIDLANDS INT'L,0,0,0,10,0,10,
15/04/05 14:21,2004,2003,London Area Airports,LUTON,PRESTWICK,1,0,1,42,0,42,-97.61904907
15/04/05 14:21,2004,2003,London Area Airports,LUTON,SOUTHAMPTON,0,0,0,15,0,15,
15/04/05 14:21,2004,2003,London Area Airports,LUTON,WICK,312,0,312,0,0,0,
15/04/05 14:21,2004,2003,London Area Airports,SOUTHEND,CARDIFF WALES,228,0,228,0,0,0,
15/04/05 14:21,2004,2003,London Area Airports,SOUTHEND,JERSEY,2630,0,2630,2340,0,2340,12.39316273
15/04/05 14:21,2004,2003,London Area Airports,STANSTED,BELFAST INTERNATIONAL,388793,388759,34,402430,402362,68,-3.388663769
15/04/05 14:21,2004,2003,London Area Airports,STANSTED,BLACKPOOL,127687,127687,0,69480,69480,0,83.77518463
15/04/05 14:21,2004,2003,London Area Airports,STANSTED,BRISTOL,0,0,0,253,0,253,
15/04/05 14:21,2004,2003,London Area Airports,STANSTED,CARDIFF WALES,1044,0,1044,246,0,246,324.3902588
15/04/05 14:21,2004,2003,London Area Airports,STANSTED,CITY OF DERRY (EGLINTON),142735,142735,0,133290,133290,0,7.086052895
15/04/05 14:21,2004,2003,London Area Airports,STANSTED,DURHAM TEES VALLEY,260,0,260,61,0,61,326.2295227
15/04/05 14:21,2004,2003,London Area Airports,STANSTED,EDINBURGH,499697,499628,69,499856,499325,531,-0.031809162
15/04/05 14:21,2004,2003,London Area Airports,STANSTED,EXETER,62,0,62,41,0,41,51.21951294
15/04/05 14:21,2004,2003,London Area Airports,STANSTED,GLASGOW,396745,396719,26,377854,377582,272,4.999549866
15/04/05 14:21,2004,2003,London Area Airports,STANSTED,GUERNSEY,59111,59111,0,42553,42553,0,38.91147614
15/04/05 14:21,2004,2003,London Area Airports,STANSTED,INVERNESS,151,0,151,0,0,0,
15/04/05 14:21,2004,2003,London Area Airports,STANSTED,ISLE OF MAN,17197,17026,171,0,0,0,
15/04/05 14:21,2004,2003,London Area Airports,STANSTED,JERSEY,4025,2718,1307,3631,0,3631,10.85100555
15/04/05 14:21,2004,2003,London Area Airports,STANSTED,LEEDS BRADFORD,0,0,0,132,0,132,
15/04/05 14:21,2004,2003,London Area Airports,STANSTED,MANCHESTER,19362,18757,605,22255,21168,1087,-12.99932575
15/04/05 14:21,2004,2003,London Area Airports,STANSTED,NEWCASTLE,319156,319156,0,298943,298844,99,6.761489868
15/04/05 14:21,2004,2003,London Area Airports,STANSTED,NEWQUAY,167445,167445,0,130124,130095,29,28.68110466
15/04/05 14:21,2004,2003,London Area Airports,STANSTED,PRESTWICK,590737,590737,0,721082,721041,41,-18.0763073
15/04/05 14:21,2004,2003,Other UK Airports,ABERDEEN,BELFAST CITY,0,0,0,132,132,0,
15/04/05 14:21,2004,2003,Other UK Airports,ABERDEEN,BELFAST INTERNATIONAL,4446,4446,0,3967,3967,0,12.07461548
15/04/05 14:21,2004,2003,Other UK Airports,ABERDEEN,BIRMINGHAM,58211,58175,36,62288,62288,0,-6.54540205
15/04/05 14:21,2004,2003,Other UK Airports,ABERDEEN,BRISTOL,2317,2317,0,401,401,0,477.805481
15/04/05 14:21,2004,2003,Other UK Airports,ABERDEEN,CARDIFF WALES,3484,3484,0,87,87,0,3904.597656
15/04/05 14:21,2004,2003,Other UK Airports,ABERDEEN,DURHAM TEES VALLEY,20467,20467,0,19573,19573,0,4.567516327
15/04/05 14:21,2004,2003,Other UK Airports,ABERDEEN,EDINBURGH,133,0,133,11,0,11,1109.090942
15/04/05 14:21,2004,2003,Other UK Airports,ABERDEEN,FARNBOROUGH,74,0,74,2,0,2,3600
15/04/05 14:21,2004,2003,Other UK Airports,ABERDEEN,GLASGOW,4111,4106,5,5176,5176,0,-20.57573509
15/04/05 14:21,2004,2003,Other UK Airports,ABERDEEN,GUERNSEY,0,0,0,177,0,177,
15/04/05 14:21,2004,2003,Other UK Airports,ABERDEEN,HUMBERSIDE,26708,26703,5,28043,28043,0,-4.760546207
15/04/05 14:21,2004,2003,Other UK Airports,ABERDEEN,JERSEY,1590,0,1590,1596,0,1596,-0.375939846
15/04/05 14:21,2004,2003,Other UK Airports,ABERDEEN,KIRKWALL,38770,38770,0,40465,40465,0,-4.188805103
15/04/05 14:21,2004,2003,Other UK Airports,ABERDEEN,LEEDS BRADFORD,15898,15898,0,12271,12271,0,29.55749321
15/04/05 14:21,2004,2003,Other UK Airports,ABERDEEN,LIVERPOOL,0,0,0,41,0,41,
15/04/05 14:21,2004,2003,Other UK Airports,ABERDEEN,MANCHESTER,119172,119172,0,125291,125283,8,-4.883830547
15/04/05 14:21,2004,2003,Other UK Airports,ABERDEEN,NEWCASTLE,19928,19928,0,19618,19618,0,1.580181479
15/04/05 14:21,2004,2003,Other UK Airports,ABERDEEN,NEWQUAY,4,0,4,0,0,0,
15/04/05 14:21,2004,2003,Other UK Airports,ABERDEEN,NORTHOLT,13,0,13,17,0,17,-23.52941132
15/04/05 14:21,2004,2003,Other UK Airports,ABERDEEN,NORWICH,59128,59128,0,60745,60745,0,-2.661947489
15/04/05 14:21,2004,2003,Other UK Airports,ABERDEEN,NOTTINGHAM EAST MIDLANDS INT'L,20937,20937,0,14370,14370,0,45.69937515
15/04/05 14:21,2004,2003,Other UK Airports,ABERDEEN,PLYMOUTH,0,0,0,3,3,0,
15/04/05 14:21,2004,2003,Other UK Airports,ABERDEEN,SCATSTA,126486,0,126486,126138,0,126138,0.275888324
15/04/05 14:21,2004,2003,Other UK Airports,ABERDEEN,SOUTHAMPTON,20578,20575,3,18755,18755,0,9.720074654
15/04/05 14:21,2004,2003,Other UK Airports,ABERDEEN,SUMBURGH,61206,60845,361,63043,62341,702,-2.913884163
15/04/05 14:21,2004,2003,Other UK Airports,ABERDEEN,WICK,6226,5992,234,6619,6237,382,-5.937452793
15/04/05 14:21,2004,2003,Other UK Airports,ALDERNEY,BOURNEMOUTH,8278,8278,0,7732,7732,0,7.061562538
15/04/05 14:21,2004,2003,Other UK Airports,ALDERNEY,GUERNSEY,33105,33105,0,30850,30850,0,7.309562206
15/04/05 14:21,2004,2003,Other UK Airports,ALDERNEY,JERSEY,6354,6354,0,9356,9356,0,-32.08636093
15/04/05 14:21,2004,2003,Other UK Airports,ALDERNEY,SHOREHAM,1883,1883,0,0,0,0,
15/04/05 14:21,2004,2003,Other UK Airports,ALDERNEY,SOUTHAMPTON,24709,24709,0,24154,24154,0,2.297755957
15/04/05 14:21,2004,2003,Other UK Airports,BARRA,BENBECULA,2187,2187,0,2453,2453,0,-10.84386444
15/04/05 14:21,2004,2003,Other UK Airports,BARRA,GLASGOW,6597,6597,0,5865,5865,0,12.48081875
15/04/05 14:21,2004,2003,Other UK Airports,BELFAST CITY,BIRMINGHAM,302163,302163,0,248071,248071,0,21.80504799
15/04/05 14:21,2004,2003,Other UK Airports,BELFAST CITY,BLACKPOOL,6669,6669,0,13021,12988,33,-48.78273392
15/04/05 14:21,2004,2003,Other UK Airports,BELFAST CITY,BRISTOL,76586,76586,0,63933,63933,0,19.79103088
15/04/05 14:21,2004,2003,Other UK Airports,BELFAST CITY,CARDIFF WALES,0,0,0,6167,6167,0,
15/04/05 14:21,2004,2003,Other UK Airports,BELFAST CITY,CITY OF DERRY (EGLINTON),1,0,1,0,0,0,
15/04/05 14:21,2004,2003,Other UK Airports,BELFAST CITY,EDINBURGH,92099,92099,0,57751,57623,128,59.47602463
15/04/05 14:21,2004,2003,Other UK Airports,BELFAST CITY,EXETER,29576,29576,0,1282,1282,0,2207.020264
15/04/05 14:21,2004,2003,Other UK Airports,BELFAST CITY,FARNBOROUGH,3,0,3,0,0,0,
15/04/05 14:21,2004,2003,Other UK Airports,BELFAST CITY,GLASGOW,107512,107493,19,55494,55494,0,93.73625946
15/04/05 14:21,2004,2003,Other UK Airports,BELFAST CITY,ISLE OF MAN,31215,31215,0,32930,32879,51,-5.208016872
15/04/05 14:21,2004,2003,Other UK Airports,BELFAST CITY,JERSEY,5874,5874,0,8345,8345,0,-29.61054611
15/04/05 14:21,2004,2003,Other UK Airports,BELFAST CITY,LEEDS BRADFORD,105063,105063,0,126042,126042,0,-16.64445114
15/04/05 14:21,2004,2003,Other UK Airports,BELFAST CITY,MANCHESTER,137121,137121,0,148458,148458,0,-7.63650322
15/04/05 14:21,2004,2003,Other UK Airports,BELFAST CITY,NEWCASTLE,77305,77305,0,88479,88479,0,-12.6289854
15/04/05 14:21,2004,2003,Other UK Airports,BELFAST CITY,NEWQUAY,5,0,5,0,0,0,
15/04/05 14:21,2004,2003,Other UK Airports,BELFAST CITY,SOUTHAMPTON,97643,97643,0,64969,64933,36,50.29167938
15/04/05 14:21,2004,2003,Other UK Airports,BELFAST INTERNATIONAL,BIRMINGHAM,28251,27975,276,127397,126996,401,-77.82444
15/04/05 14:21,2004,2003,Other UK Airports,BELFAST INTERNATIONAL,BOURNEMOUTH,224,0,224,0,0,0,
15/04/05 14:21,2004,2003,Other UK Airports,BELFAST INTERNATIONAL,BRISTOL,231755,231586,169,211879,211791,88,9.380825996
15/04/05 14:21,2004,2003,Other UK Airports,BELFAST INTERNATIONAL,CARDIFF WALES,53527,53432,95,66361,66361,0,-19.33967209
15/04/05 14:21,2004,2003,Other UK Airports,BELFAST INTERNATIONAL,COVENTRY,0,0,0,202,0,202,
15/04/05 14:21,2004,2003,Other UK Airports,BELFAST INTERNATIONAL,DURHAM TEES VALLEY,32000,32000,0,6408,6408,0,399.3757935
15/04/05 14:21,2004,2003,Other UK Airports,BELFAST INTERNATIONAL,EDINBURGH,315011,315011,0,269906,269845,61,16.71137428
15/04/05 14:21,2004,2003,Other UK Airports,BELFAST INTERNATIONAL,GLASGOW,313783,313745,38,321532,321322,210,-2.410024405
15/04/05 14:21,2004,2003,Other UK Airports,BELFAST INTERNATIONAL,JERSEY,1451,0,1451,1509,0,1509,-3.843605042
15/04/05 14:21,2004,2003,Other UK Airports,BELFAST INTERNATIONAL,LEEDS BRADFORD,94412,94304,108,12385,12264,121,662.3092651
15/04/05 14:21,2004,2003,Other UK Airports,BELFAST INTERNATIONAL,LIVERPOOL,551655,551655,0,563042,563042,0,-2.022406816
15/04/05 14:21,2004,2003,Other UK Airports,BELFAST INTERNATIONAL,MANCHESTER,152235,152233,2,105477,105164,313,44.33004379
15/04/05 14:21,2004,2003,Other UK Airports,BELFAST INTERNATIONAL,NEWCASTLE,151333,151333,0,104204,103891,313,45.22763062
15/04/05 14:21,2004,2003,Other UK Airports,BELFAST INTERNATIONAL,NOTTINGHAM EAST MIDLANDS INT'L,172264,172264,0,146685,146685,0,17.43804741
15/04/05 14:21,2004,2003,Other UK Airports,BELFAST INTERNATIONAL,SOUTH MARSTON,10,0,10,0,0,0,
15/04/05 14:21,2004,2003,Other UK Airports,BELFAST INTERNATIONAL,SOUTHAMPTON,119,0,119,35,0,35,240
15/04/05 14:21,2004,2003,Other UK Airports,BELFAST INTERNATIONAL,SWANSEA,0,0,0,18,0,18,
15/04/05 14:21,2004,2003,Other UK Airports,BEMBRIDGE,SOUTHAMPTON,7,0,7,0,0,0,
15/04/05 14:21,2004,2003,Other UK Airports,BENBECULA,GLASGOW,18787,18787,0,20520,20498,22,-8.445419312
15/04/05 14:21,2004,2003,Other UK Airports,BENBECULA,STORNOWAY,8846,8846,0,8965,8965,0,-1.327384233
15/04/05 14:21,2004,2003,Other UK Airports,BIGGIN HILL,CARDIFF WALES,28,0,28,0,0,0,
15/04/05 14:21,2004,2003,Other UK Airports,BIGGIN HILL,LEEDS BRADFORD,0,0,0,70,0,70,
15/04/05 14:21,2004,2003,Other UK Airports,BIRMINGHAM,BRISTOL,0,0,0,67,0,67,
15/04/05 14:21,2004,2003,Other UK Airports,BIRMINGHAM,CITY OF DERRY (EGLINTON),9925,9925,0,0,0,0,
15/04/05 14:21,2004,2003,Other UK Airports,BIRMINGHAM,EDINBURGH,384295,384082,213,373402,373037,365,2.917231321
15/04/05 14:21,2004,2003,Other UK Airports,BIRMINGHAM,GLASGOW,345123,344736,387,361351,361000,351,-4.490924358
15/04/05 14:21,2004,2003,Other UK Airports,BIRMINGHAM,GUERNSEY,52576,52576,0,48177,48177,0,9.130912781
15/04/05 14:21,2004,2003,Other UK Airports,BIRMINGHAM,INVERNESS,12652,12652,0,1564,1564,0,708.951416
15/04/05 14:21,2004,2003,Other UK Airports,BIRMINGHAM,ISLE OF MAN,60895,60895,0,71287,71287,0,-14.57769299
15/04/05 14:21,2004,2003,Other UK Airports,BIRMINGHAM,JERSEY,60329,56891,3438,96913,89141,7772,-37.74932098
15/04/05 14:21,2004,2003,Other UK Airports,BIRMINGHAM,KINLOSS,220,0,220,218,0,218,0.917431176
15/04/05 14:21,2004,2003,Other UK Airports,BIRMINGHAM,MANCHESTER,0,0,0,1232,0,1232,
15/04/05 14:21,2004,2003,Other UK Airports,BIRMINGHAM,NEWCASTLE,24348,24348,0,27159,27159,0,-10.3501606
15/04/05 14:21,2004,2003,Other UK Airports,BLACKPOOL,BOURNEMOUTH,296,0,296,0,0,0,
15/04/05 14:21,2004,2003,Other UK Airports,BLACKPOOL,CARDIFF WALES,716,0,716,0,0,0,
15/04/05 14:21,2004,2003,Other UK Airports,BLACKPOOL,GLASGOW,3,0,3,0,0,0,
15/04/05 14:21,2004,2003,Other UK Airports,BLACKPOOL,ISLE OF MAN,18803,18803,0,11006,11006,0,70.8431778
15/04/05 14:21,2004,2003,Other UK Airports,BLACKPOOL,JERSEY,703,0,703,2026,0,2026,-65.30108643
15/04/05 14:21,2004,2003,Other UK Airports,BLACKPOOL,SOUTHAMPTON,0,0,0,66,0,66,
15/04/05 14:21,2004,2003,Other UK Airports,BOURNEMOUTH,EDINBURGH,0,0,0,60,0,60,
15/04/05 14:21,2004,2003,Other UK Airports,BOURNEMOUTH,GUERNSEY,11288,11288,0,2198,2198,0,413.5577698
15/04/05 14:21,2004,2003,Other UK Airports,BOURNEMOUTH,ISLES OF SCILLY (ST.MARYS),0,0,0,526,526,0,
15/04/05 14:21,2004,2003,Other UK Airports,BOURNEMOUTH,JERSEY,14485,12038,2447,10097,5128,4969,43.45845413
15/04/05 14:21,2004,2003,Other UK Airports,BOURNEMOUTH,LEEDS BRADFORD,0,0,0,24,0,24,
15/04/05 14:21,2004,2003,Other UK Airports,BOURNEMOUTH,LIVERPOOL,227,0,227,0,0,0,
15/04/05 14:21,2004,2003,Other UK Airports,BOURNEMOUTH,PLOCKTON,352,0,352,865,0,865,-59.30635834
15/04/05 14:21,2004,2003,Other UK Airports,BOURNEMOUTH,PRESTWICK,100360,100360,0,85006,85006,0,18.06225395
15/04/05 14:21,2004,2003,Other UK Airports,BRISTOL,EDINBURGH,326066,325919,147,326674,326674,0,-0.186118275
15/04/05 14:21,2004,2003,Other UK Airports,BRISTOL,GLASGOW,308804,307771,1033,293383,293142,241,5.256268978
15/04/05 14:21,2004,2003,Other UK Airports,BRISTOL,GUERNSEY,31925,31925,0,14092,14092,0,126.5469742
15/04/05 14:21,2004,2003,Other UK Airports,BRISTOL,ISLE OF MAN,9272,9272,0,17132,17132,0,-45.87905502
15/04/05 14:21,2004,2003,Other UK Airports,BRISTOL,ISLES OF SCILLY (ST.MARYS),4579,4579,0,4876,4876,0,-6.091058254
15/04/05 14:21,2004,2003,Other UK Airports,BRISTOL,JERSEY,49028,49028,0,24398,24398,0,100.9508972
15/04/05 14:21,2004,2003,Other UK Airports,BRISTOL,LEEDS BRADFORD,0,0,0,55,55,0,
15/04/05 14:21,2004,2003,Other UK Airports,BRISTOL,MANCHESTER,36644,35514,1130,434,0,434,8343.318359
15/04/05 14:21,2004,2003,Other UK Airports,BRISTOL,NEWCASTLE,241928,241785,143,111908,111908,0,116.1847229
15/04/05 14:21,2004,2003,Other UK Airports,BRISTOL,NORWICH,359,0,359,0,0,0,
15/04/05 14:21,2004,2003,Other UK Airports,BRISTOL,NOTTINGHAM EAST MIDLANDS INT'L,116,0,116,272,0,272,-57.35293961
15/04/05 14:21,2004,2003,Other UK Airports,BRISTOL,PLYMOUTH,10413,10413,0,2584,2584,0,302.9798889
15/04/05 14:21,2004,2003,Other UK Airports,BRIZE NORTON,EDINBURGH,13,0,13,0,0,0,
15/04/05 14:21,2004,2003,Other UK Airports,BRIZE NORTON,GLASGOW,11,0,11,0,0,0,
15/04/05 14:21,2004,2003,Other UK Airports,CAMBRIDGE,DUNDEE,0,0,0,3,0,3,
15/04/05 14:21,2004,2003,Other UK Airports,CAMBRIDGE,EDINBURGH,3,0,3,0,0,0,
15/04/05 14:21,2004,2003,Other UK Airports,CAMBRIDGE,GUERNSEY,100,0,100,0,0,0,
15/04/05 14:21,2004,2003,Other UK Airports,CAMPBELTOWN,GLASGOW,8337,8337,0,8225,8225,0,1.361702085
15/04/05 14:21,2004,2003,Other UK Airports,CAMPBELTOWN,ISLAY,45,45,0,11,11,0,309.0909119
15/04/05 14:21,2004,2003,Other UK Airports,CARDIFF WALES,DURHAM TEES VALLEY,4499,0,4499,0,0,0,
15/04/05 14:21,2004,2003,Other UK Airports,CARDIFF WALES,EDINBURGH,151684,150511,1173,132310,123464,8846,14.64288425
15/04/05 14:21,2004,2003,Other UK Airports,CARDIFF WALES,FAIRFORD,65,0,65,0,0,0,
15/04/05 14:21,2004,2003,Other UK Airports,CARDIFF WALES,GLASGOW,58,0,58,53876,53876,0,-99.89234161
15/04/05 14:21,2004,2003,Other UK Airports,CARDIFF WALES,JERSEY,17553,17553,0,42246,42231,15,-58.4505043
15/04/05 14:21,2004,2003,Other UK Airports,CARDIFF WALES,LEEDS BRADFORD,0,0,0,296,0,296,
15/04/05 14:21,2004,2003,Other UK Airports,CARDIFF WALES,LIVERPOOL,2132,1782,350,49,0,49,4251.020508
15/04/05 14:21,2004,2003,Other UK Airports,CARDIFF WALES,MANCHESTER,2360,0,2360,2615,0,2615,-9.751434326
15/04/05 14:21,2004,2003,Other UK Airports,CARDIFF WALES,NEWCASTLE,19007,19007,0,542,542,0,3406.82666
15/04/05 14:21,2004,2003,Other UK Airports,CARDIFF WALES,NORWICH,201,201,0,0,0,0,
15/04/05 14:21,2004,2003,Other UK Airports,CARDIFF WALES,PLYMOUTH,1906,1906,0,70,70,0,2622.857178
15/04/05 14:21,2004,2003,Other UK Airports,CARDIFF WALES,PRESTWICK,50884,50775,109,36292,36292,0,40.20720673
15/04/05 14:21,2004,2003,Other UK Airports,CARDIFF WALES,SWANSEA,379,379,0,783,783,0,-51.5964241
15/04/05 14:21,2004,2003,Other UK Airports,CITY OF DERRY (EGLINTON),EDINBURGH,0,0,0,328,0,328,
15/04/05 14:21,2004,2003,Other UK Airports,CITY OF DERRY (EGLINTON),GLASGOW,14235,14235,0,15466,15466,0,-7.959394932
15/04/05 14:21,2004,2003,Other UK Airports,CITY OF DERRY (EGLINTON),INVERNESS,2,0,2,0,0,0,
15/04/05 14:21,2004,2003,Other UK Airports,CITY OF DERRY (EGLINTON),MANCHESTER,11585,11585,0,14610,14534,76,-20.70499611
15/04/05 14:21,2004,2003,Other UK Airports,COVENTRY,DURHAM TEES VALLEY,0,0,0,20,0,20,
15/04/05 14:21,2004,2003,Other UK Airports,COVENTRY,EDINBURGH,0,0,0,58,0,58,
15/04/05 14:21,2004,2003,Other UK Airports,COVENTRY,JERSEY,63152,63152,0,0,0,0,
15/04/05 14:21,2004,2003,Other UK Airports,COVENTRY,KIRKWALL,82,0,82,0,0,0,
15/04/05 14:21,2004,2003,Other UK Airports,COVENTRY,LEEDS BRADFORD,16,0,16,0,0,0,
15/04/05 14:21,2004,2003,Other UK Airports,COVENTRY,NEWQUAY,15,0,15,0,0,0,
15/04/05 14:21,2004,2003,Other UK Airports,COVENTRY,WICK,0,0,0,74,0,74,
15/04/05 14:21,2004,2003,Other UK Airports,CRANFIELD,EDINBURGH,6,0,6,0,0,0,
15/04/05 14:21,2004,2003,Other UK Airports,DUNDEE,JERSEY,1642,0,1642,1616,0,1616,1.608910918
15/04/05 14:21,2004,2003,Other UK Airports,DUNDEE,MANCHESTER,0,0,0,1381,1381,0,
15/04/05 14:21,2004,2003,Other UK Airports,DUNDEE,SCATSTA,125,0,125,0,0,0,
15/04/05 14:21,2004,2003,Other UK Airports,DUNKESWELL,JERSEY,5,0,5,5,0,5,0
15/04/05 14:21,2004,2003,Other UK Airports,DURHAM TEES VALLEY,EDINBURGH,27,0,27,16,0,16,68.75
15/04/05 14:21,2004,2003,Other UK Airports,DURHAM TEES VALLEY,FARNBOROUGH,17,0,17,6,0,6,183.3333282
15/04/05 14:21,2004,2003,Other UK Airports,DURHAM TEES VALLEY,JERSEY,8305,6722,1583,3836,3797,39,116.501564
15/04/05 14:21,2004,2003,Other UK Airports,DURHAM TEES VALLEY,LEUCHARS,0,0,0,1,0,1,
15/04/05 14:21,2004,2003,Other UK Airports,DURHAM TEES VALLEY,LIVERPOOL,0,0,0,2,0,2,
15/04/05 14:21,2004,2003,Other UK Airports,DURHAM TEES VALLEY,NEWCASTLE,0,0,0,402,0,402,
15/04/05 14:21,2004,2003,Other UK Airports,DURHAM TEES VALLEY,SHEFFIELD CITY,4,0,4,0,0,0,
15/04/05 14:21,2004,2003,Other UK Airports,DURHAM TEES VALLEY,SOUTHAMPTON,66,0,66,77,0,77,-14.28571415
15/04/05 14:21,2004,2003,Other UK Airports,EDAY,KIRKWALL,559,559,0,464,464,0,20.47413826
15/04/05 14:21,2004,2003,Other UK Airports,EDINBURGH,EXETER,35896,35896,0,0,0,0,
15/04/05 14:21,2004,2003,Other UK Airports,EDINBURGH,FARNBOROUGH,67,0,67,72,0,72,-6.944444656
15/04/05 14:21,2004,2003,Other UK Airports,EDINBURGH,GLASGOW,0,0,0,330,122,208,
15/04/05 14:21,2004,2003,Other UK Airports,EDINBURGH,INVERNESS,17109,17106,3,12701,12626,75,34.7059288
15/04/05 14:21,2004,2003,Other UK Airports,EDINBURGH,ISLE OF MAN,12739,12733,6,12689,12689,0,0.394042075
15/04/05 14:21,2004,2003,Other UK Airports,EDINBURGH,JERSEY,13085,11385,1700,20120,18042,2078,-34.96520996
15/04/05 14:21,2004,2003,Other UK Airports,EDINBURGH,KENT INTERNATIONAL,13796,13796,0,0,0,0,
15/04/05 14:21,2004,2003,Other UK Airports,EDINBURGH,KIRKWALL,20697,20697,0,20446,20446,0,1.22762394
15/04/05 14:21,2004,2003,Other UK Airports,EDINBURGH,LEEDS BRADFORD,57422,57422,0,55127,54998,129,4.163114071
15/04/05 14:21,2004,2003,Other UK Airports,EDINBURGH,LIVERPOOL,0,0,0,1,0,1,
15/04/05 14:21,2004,2003,Other UK Airports,EDINBURGH,LYNEHAM,1,0,1,0,0,0,
15/04/05 14:21,2004,2003,Other UK Airports,EDINBURGH,MANCHESTER,221971,221563,408,209159,208892,267,6.125483513
15/04/05 14:21,2004,2003,Other UK Airports,EDINBURGH,NEWCASTLE,0,0,0,12,0,12,
15/04/05 14:21,2004,2003,Other UK Airports,EDINBURGH,NEWQUAY,1,0,1,0,0,0,
15/04/05 14:21,2004,2003,Other UK Airports,EDINBURGH,NORTHOLT,35,0,35,59,0,59,-40.67796707
15/04/05 14:21,2004,2003,Other UK Airports,EDINBURGH,NORWICH,21816,21816,0,19460,19457,3,12.10688591
15/04/05 14:21,2004,2003,Other UK Airports,EDINBURGH,NOTTINGHAM EAST MIDLANDS INT'L,330187,330178,9,314569,314446,123,4.964888573
15/04/05 14:21,2004,2003,Other UK Airports,EDINBURGH,SCATSTA,62,0,62,0,0,0,
15/04/05 14:21,2004,2003,Other UK Airports,EDINBURGH,SOUTHAMPTON,198437,198437,0,98382,98382,0,101.7005157
15/04/05 14:21,2004,2003,Other UK Airports,EDINBURGH,STORNOWAY,31032,31032,0,24267,24267,0,27.87736511
15/04/05 14:21,2004,2003,Other UK Airports,EDINBURGH,SUMBURGH,15802,15802,0,15186,15186,0,4.056367874
15/04/05 14:21,2004,2003,Other UK Airports,EDINBURGH,WICK,6110,5980,130,5831,5831,0,4.784770966
15/04/05 14:21,2004,2003,Other UK Airports,EXETER,GLASGOW,33755,33755,0,0,0,0,
15/04/05 14:21,2004,2003,Other UK Airports,EXETER,GUERNSEY,34700,34700,0,30506,30506,0,13.74811554
15/04/05 14:21,2004,2003,Other UK Airports,EXETER,ISLES OF SCILLY (ST.MARYS),4672,4672,0,4089,4089,0,14.25776482
15/04/05 14:21,2004,2003,Other UK Airports,EXETER,JERSEY,42824,42824,0,43521,43521,0,-1.601525664
15/04/05 14:21,2004,2003,Other UK Airports,EXETER,NEWCASTLE,7495,7495,0,0,0,0,
15/04/05 14:21,2004,2003,Other UK Airports,EXETER,NEWQUAY,16,16,0,0,0,0,
15/04/05 14:21,2004,2003,Other UK Airports,FAIR ISLE,LERWICK  (TINGWALL),2341,2341,0,2066,2066,0,13.31074524
15/04/05 14:21,2004,2003,Other UK Airports,FAIR ISLE,SUMBURGH,159,159,0,185,185,0,-14.05405426
15/04/05 14:21,2004,2003,Other UK Airports,FARNBOROUGH,GLASGOW,39,0,39,27,0,27,44.44444275
15/04/05 14:21,2004,2003,Other UK Airports,FARNBOROUGH,GUERNSEY,36,0,36,22,0,22,63.63636398
15/04/05 14:21,2004,2003,Other UK Airports,FARNBOROUGH,ISLE OF MAN,0,0,0,49,0,49,
15/04/05 14:21,2004,2003,Other UK Airports,FARNBOROUGH,JERSEY,18,0,18,9,0,9,100
15/04/05 14:21,2004,2003,Other UK Airports,FARNBOROUGH,NEWCASTLE,14,0,14,8,0,8,75
15/04/05 14:21,2004,2003,Other UK Airports,FILTON,GLASGOW,0,0,0,10,0,10,
15/04/05 14:21,2004,2003,Other UK Airports,GLASGOW,INVERNESS,6203,6203,0,21423,21337,86,-71.0451355
15/04/05 14:21,2004,2003,Other UK Airports,GLASGOW,ISLAY,21495,21495,0,21512,21512,0,-0.079025663
15/04/05 14:21,2004,2003,Other UK Airports,GLASGOW,ISLE OF MAN,29376,29376,0,18076,18076,0,62.51383209
15/04/05 14:21,2004,2003,Other UK Airports,GLASGOW,JERSEY,9118,9118,0,13238,13238,0,-31.12252617
15/04/05 14:21,2004,2003,Other UK Airports,GLASGOW,KENT INTERNATIONAL,4856,4856,0,0,0,0,
15/04/05 14:21,2004,2003,Other UK Airports,GLASGOW,KIRKWALL,6852,6698,154,5750,5750,0,19.16521645
15/04/05 14:21,2004,2003,Other UK Airports,GLASGOW,LEEDS BRADFORD,44204,44204,0,42247,42085,162,4.63228178
15/04/05 14:21,2004,2003,Other UK Airports,GLASGOW,LIVERPOOL,0,0,0,557,0,557,
15/04/05 14:21,2004,2003,Other UK Airports,GLASGOW,MANCHESTER,182665,182506,159,169246,166439,2807,7.928695679
15/04/05 14:21,2004,2003,Other UK Airports,GLASGOW,NEWCASTLE,6,0,6,169,0,169,-96.44970703
15/04/05 14:21,2004,2003,Other UK Airports,GLASGOW,NEWQUAY,0,0,0,426,0,426,
15/04/05 14:21,2004,2003,Other UK Airports,GLASGOW,NORTHOLT,3,0,3,9,0,9,-66.66666412
15/04/05 14:21,2004,2003,Other UK Airports,GLASGOW,NOTTINGHAM EAST MIDLANDS INT'L,209736,209658,78,266226,266055,171,-21.21881485
15/04/05 14:21,2004,2003,Other UK Airports,GLASGOW,PLYMOUTH,0,0,0,341,341,0,
15/04/05 14:21,2004,2003,Other UK Airports,GLASGOW,SHEFFIELD CITY,4,0,4,0,0,0,
15/04/05 14:21,2004,2003,Other UK Airports,GLASGOW,SOUTHAMPTON,117296,117296,0,77305,77305,0,51.73145294
15/04/05 14:21,2004,2003,Other UK Airports,GLASGOW,STORNOWAY,42031,42031,0,45920,45920,0,-8.46907711
15/04/05 14:21,2004,2003,Other UK Airports,GLASGOW,SUMBURGH,14379,14379,0,15435,15435,0,-6.841593742
15/04/05 14:21,2004,2003,Other UK Airports,GLASGOW,TIREE,5637,5637,0,5325,5325,0,5.859154701
15/04/05 14:21,2004,2003,Other UK Airports,GLASGOW,WICK,36,0,36,0,0,0,
15/04/05 14:21,2004,2003,Other UK Airports,GLOUCESTERSHIRE,JERSEY,65,0,65,0,0,0,
15/04/05 14:21,2004,2003,Other UK Airports,GUERNSEY,ISLE OF MAN,0,0,0,509,0,509,
15/04/05 14:21,2004,2003,Other UK Airports,GUERNSEY,JERSEY,137255,136922,333,136260,136260,0,0.730221629
15/04/05 14:21,2004,2003,Other UK Airports,GUERNSEY,LIVERPOOL,131,0,131,0,0,0,
15/04/05 14:21,2004,2003,Other UK Airports,GUERNSEY,MANCHESTER,62513,62511,2,54288,54288,0,15.15067768
15/04/05 14:21,2004,2003,Other UK Airports,GUERNSEY,NEWQUAY,130,0,130,0,0,0,
15/04/05 14:21,2004,2003,Other UK Airports,GUERNSEY,NORTHOLT,23,0,23,8,0,8,187.5
15/04/05 14:21,2004,2003,Other UK Airports,GUERNSEY,NOTTINGHAM EAST MIDLANDS INT'L,18145,18145,0,11703,11703,0,55.04571533
15/04/05 14:21,2004,2003,Other UK Airports,GUERNSEY,OXFORD (KIDLINGTON),7,0,7,8,0,8,-12.5
15/04/05 14:21,2004,2003,Other UK Airports,GUERNSEY,SHOREHAM,174,174,0,0,0,0,
15/04/05 14:21,2004,2003,Other UK Airports,GUERNSEY,SOUTHAMPTON,128517,128517,0,138507,138430,77,-7.212631702
15/04/05 14:21,2004,2003,Other UK Airports,GUERNSEY,SUMBURGH,0,0,0,88,0,88,
15/04/05 14:21,2004,2003,Other UK Airports,HUMBERSIDE,JERSEY,3209,0,3209,3548,0,3548,-9.554678917
15/04/05 14:21,2004,2003,Other UK Airports,HUMBERSIDE,NEWCASTLE,4,4,0,0,0,0,
15/04/05 14:21,2004,2003,Other UK Airports,HUMBERSIDE,NOTTINGHAM EAST MIDLANDS INT'L,620,6,614,667,0,667,-7.046476841
15/04/05 14:21,2004,2003,Other UK Airports,INVERNESS,KIRKWALL,16394,16394,0,15963,15963,0,2.699993849
15/04/05 14:21,2004,2003,Other UK Airports,INVERNESS,MANCHESTER,15285,15188,97,14454,14454,0,5.749273777
15/04/05 14:21,2004,2003,Other UK Airports,INVERNESS,STORNOWAY,31010,31010,0,28375,28375,0,9.286343575
15/04/05 14:21,2004,2003,Other UK Airports,INVERNESS,SUMBURGH,222,222,0,118,118,0,88.1355896
15/04/05 14:21,2004,2003,Other UK Airports,INVERNESS,WICK,486,0,486,0,0,0,
15/04/05 14:21,2004,2003,Other UK Airports,ISLE OF MAN,JERSEY,26,0,26,0,0,0,
15/04/05 14:21,2004,2003,Other UK Airports,ISLE OF MAN,LEEDS BRADFORD,7914,7914,0,9868,9868,0,-19.80137825
15/04/05 14:21,2004,2003,Other UK Airports,ISLE OF MAN,LIVERPOOL,203939,203939,0,178636,178175,461,14.16455841
15/04/05 14:21,2004,2003,Other UK Airports,ISLE OF MAN,MANCHESTER,106180,106180,0,92193,92193,0,15.17143345
15/04/05 14:21,2004,2003,Other UK Airports,ISLE OF MAN,NEWCASTLE,6126,6126,0,10553,10553,0,-41.95015717
15/04/05 14:21,2004,2003,Other UK Airports,ISLE OF MAN,NOTTINGHAM EAST MIDLANDS INT'L,3047,3047,0,5813,5813,0,-47.583004
15/04/05 14:21,2004,2003,Other UK Airports,ISLE OF MAN,PRESTWICK,287,287,0,8072,8072,0,-96.44449615
15/04/05 14:21,2004,2003,Other UK Airports,ISLES OF SCILLY (ST.MARYS),NEWQUAY,18656,18656,0,0,0,0,
15/04/05 14:21,2004,2003,Other UK Airports,ISLES OF SCILLY (ST.MARYS),SOUTHAMPTON,1838,1838,0,1179,1179,0,55.89482498
15/04/05 14:21,2004,2003,Other UK Airports,JERSEY,KENT INTERNATIONAL,1114,1062,52,0,0,0,
15/04/05 14:21,2004,2003,Other UK Airports,JERSEY,LEEDS BRADFORD,24185,22565,1620,29693,27963,1730,-18.54982567
15/04/05 14:21,2004,2003,Other UK Airports,JERSEY,LIVERPOOL,3437,1450,1987,4298,0,4298,-20.0325737
15/04/05 14:21,2004,2003,Other UK Airports,JERSEY,MANCHESTER,113393,102909,10484,80317,69091,11226,41.1818161
15/04/05 14:21,2004,2003,Other UK Airports,JERSEY,NEWCASTLE,4141,4141,0,7391,5908,1483,-43.97240067
15/04/05 14:21,2004,2003,Other UK Airports,JERSEY,NEWQUAY,5,0,5,0,0,0,
15/04/05 14:21,2004,2003,Other UK Airports,JERSEY,NORTHOLT,0,0,0,4,0,4,
15/04/05 14:21,2004,2003,Other UK Airports,JERSEY,NORWICH,3544,0,3544,3536,0,3536,0.226244345
15/04/05 14:21,2004,2003,Other UK Airports,JERSEY,NOTTINGHAM EAST MIDLANDS INT'L,56628,55358,1270,62651,58710,3941,-9.613574028
15/04/05 14:21,2004,2003,Other UK Airports,JERSEY,PLYMOUTH,10519,10519,0,1253,1241,12,739.505188
15/04/05 14:21,2004,2003,Other UK Airports,JERSEY,SHOREHAM,231,231,0,0,0,0,
15/04/05 14:21,2004,2003,Other UK Airports,JERSEY,SOUTHAMPTON,157850,156743,1107,175811,175017,794,-10.21608448
15/04/05 14:21,2004,2003,Other UK Airports,JERSEY,SWANSEA,0,0,0,12,12,0,
15/04/05 14:21,2004,2003,Other UK Airports,KENT INTERNATIONAL,MANCHESTER,10915,10915,0,0,0,0,
15/04/05 14:21,2004,2003,Other UK Airports,KIRKWALL,MANCHESTER,0,0,0,100,0,100,
15/04/05 14:21,2004,2003,Other UK Airports,KIRKWALL,NORTH RONALDSAY,5386,5386,0,5273,5273,0,2.142992496
15/04/05 14:21,2004,2003,Other UK Airports,KIRKWALL,PAPA WESTRAY,3367,3367,0,3356,3356,0,0.327771157
15/04/05 14:21,2004,2003,Other UK Airports,KIRKWALL,SANDAY,2813,2813,0,2922,2922,0,-3.730321646
15/04/05 14:21,2004,2003,Other UK Airports,KIRKWALL,SCATSTA,48,0,48,0,0,0,
15/04/05 14:21,2004,2003,Other UK Airports,KIRKWALL,STRONSAY,2844,2844,0,3146,3146,0,-9.599491119
15/04/05 14:21,2004,2003,Other UK Airports,KIRKWALL,SUMBURGH,5799,5799,0,6618,6618,0,-12.37533951
15/04/05 14:21,2004,2003,Other UK Airports,KIRKWALL,WESTRAY,2923,2923,0,2866,2866,0,1.98883462
15/04/05 14:21,2004,2003,Other UK Airports,KIRKWALL,WICK,8932,8932,0,9974,9942,32,-10.44716263
15/04/05 14:21,2004,2003,Other UK Airports,LEEDS BRADFORD,NEWQUAY,294,0,294,399,0,399,-26.31579018
15/04/05 14:21,2004,2003,Other UK Airports,LEEDS BRADFORD,SOUTH MARSTON,0,0,0,6,0,6,
15/04/05 14:21,2004,2003,Other UK Airports,LEEDS BRADFORD,SOUTHAMPTON,26807,26724,83,25311,25121,190,5.910473824
15/04/05 14:21,2004,2003,Other UK Airports,LIVERPOOL,MANCHESTER,12,0,12,0,0,0,
15/04/05 14:21,2004,2003,Other UK Airports,LIVERPOOL,NEWCASTLE,45,45,0,161,132,29,-72.04969025
15/04/05 14:21,2004,2003,Other UK Airports,LIVERPOOL,NEWQUAY,125,0,125,0,0,0,
15/04/05 14:21,2004,2003,Other UK Airports,LIVERPOOL,NOTTINGHAM EAST MIDLANDS INT'L,0,0,0,14,0,14,
15/04/05 14:21,2004,2003,Other UK Airports,LIVERPOOL,SOUTHAMPTON,0,0,0,35,0,35,
15/04/05 14:21,2004,2003,Other UK Airports,LIVERPOOL,WARTON,0,0,0,30,0,30,
15/04/05 14:21,2004,2003,Other UK Airports,LYNEHAM,WICK,7,0,7,0,0,0,
15/04/05 14:21,2004,2003,Other UK Airports,MANCHESTER,NEWCASTLE,0,0,0,36,0,36,
15/04/05 14:21,2004,2003,Other UK Airports,MANCHESTER,NORWICH,17170,17170,0,15647,15647,0,9.733495712
15/04/05 14:21,2004,2003,Other UK Airports,MANCHESTER,PLYMOUTH,30019,30019,0,0,0,0,
15/04/05 14:21,2004,2003,Other UK Airports,MANCHESTER,SOUTHAMPTON,94398,94272,126,63023,62833,190,49.78341293
15/04/05 14:21,2004,2003,Other UK Airports,MANCHESTER,SUMBURGH,913,0,913,0,0,0,
15/04/05 14:21,2004,2003,Other UK Airports,MANCHESTER,SWANSEA,0,0,0,4,0,4,
15/04/05 14:21,2004,2003,Other UK Airports,MANCHESTER,WICK,44,0,44,0,0,0,
15/04/05 14:21,2004,2003,Other UK Airports,NEWCASTLE,NEWQUAY,364,0,364,356,0,356,2.247190952
15/04/05 14:21,2004,2003,Other UK Airports,NEWCASTLE,NOTTINGHAM EAST MIDLANDS INT'L,0,0,0,56,0,56,
15/04/05 14:21,2004,2003,Other UK Airports,NEWCASTLE,PLYMOUTH,20312,20312,0,590,590,0,3342.711914
15/04/05 14:21,2004,2003,Other UK Airports,NEWCASTLE,SOUTHAMPTON,39869,39765,104,29946,29818,128,33.13631058
15/04/05 14:21,2004,2003,Other UK Airports,NEWQUAY,PLYMOUTH,111,111,0,0,0,0,
15/04/05 14:21,2004,2003,Other UK Airports,NEWQUAY,SOUTHAMPTON,79,79,0,0,0,0,
15/04/05 14:21,2004,2003,Other UK Airports,NORTHOLT,WICK,41,0,41,27,0,27,51.85185242
15/04/05 14:21,2004,2003,Other UK Airports,NORWICH,SOUTHAMPTON,0,0,0,74,0,74,
15/04/05 14:21,2004,2003,Other UK Airports,NORWICH,WARTON,0,0,0,172,0,172,
15/04/05 14:21,2004,2003,Other UK Airports,SOUTH MARSTON,WICK,28,0,28,0,0,0,
15/04/05 14:21,2004,2003,Other UK Airports,SUMBURGH,WICK,1431,1431,0,33,33,0,4236.36377
