rundate,this_period,last_period,grp_cd,grp_name,apt1_apt_name,apt2_apt_name,total_pax_tp,total_pax_shd_tp,total_pax_cht_tp,total_pax_lp,total_pax_shd_lp,total_pax_cht_lp,total_pax_pc
06/03/2014 16:01,2013,2012,A,London Area Airports,GATWICK,ABERDEEN,173231,173231,0,233921,233466,455,-25.94465637
06/03/2014 16:01,2013,2012,A,London Area Airports,GATWICK,BELFAST CITY (GEORGE BEST),406464,405249,1215,280503,280476,27,44.90540314
06/03/2014 16:01,2013,2012,A,London Area Airports,GATWICK,BELFAST INTERNATIONAL,385696,385222,474,353248,352707,541,9.185614586
06/03/2014 16:01,2013,2012,A,London Area Airports,GATWICK,BLACKPOOL,99,0,99,37,0,37,167.5675659
06/03/2014 16:01,2013,2012,A,London Area Airports,GATWICK,CARDIFF WALES,41,0,41,76,0,76,-46.05263138
06/03/2014 16:01,2013,2012,A,London Area Airports,GATWICK,CITY OF DERRY (EGLINTON),203,0,203,0,0,0,
06/03/2014 16:01,2013,2012,A,London Area Airports,GATWICK,DONCASTER SHEFFIELD,0,0,0,38,0,38,
06/03/2014 16:01,2013,2012,A,London Area Airports,GATWICK,DURHAM TEES VALLEY,73,0,73,0,0,0,
06/03/2014 16:01,2013,2012,A,London Area Airports,GATWICK,EAST MIDLANDS INTERNATIONAL,0,0,0,145,145,0,
06/03/2014 16:01,2013,2012,A,London Area Airports,GATWICK,EDINBURGH,693686,693686,0,696791,696746,45,-0.445614249
06/03/2014 16:01,2013,2012,A,London Area Airports,GATWICK,GLASGOW,606263,606263,0,607417,607163,254,-0.189984798
06/03/2014 16:01,2013,2012,A,London Area Airports,GATWICK,GUERNSEY,345779,345779,0,344782,344782,0,0.289168239
06/03/2014 16:01,2013,2012,A,London Area Airports,GATWICK,HEATHROW,0,0,0,35,0,35,
06/03/2014 16:01,2013,2012,A,London Area Airports,GATWICK,HUMBERSIDE,106,0,106,0,0,0,
06/03/2014 16:01,2013,2012,A,London Area Airports,GATWICK,INVERNESS,219320,219320,0,230442,230224,218,-4.826376915
06/03/2014 16:01,2013,2012,A,London Area Airports,GATWICK,ISLE OF MAN,184173,184173,0,143466,143428,38,28.37397003
06/03/2014 16:01,2013,2012,A,London Area Airports,GATWICK,JERSEY,537414,537353,61,553962,553962,0,-2.987208605
06/03/2014 16:01,2013,2012,A,London Area Airports,GATWICK,LEEDS BRADFORD,58,0,58,177,0,177,-67.23163605
06/03/2014 16:01,2013,2012,A,London Area Airports,GATWICK,LIVERPOOL (JOHN LENNON),185,0,185,369,0,369,-49.86449814
06/03/2014 16:01,2013,2012,A,London Area Airports,GATWICK,MANCHESTER,41321,41164,157,194568,193695,873,-78.76269531
06/03/2014 16:01,2013,2012,A,London Area Airports,GATWICK,NEWCASTLE,81813,81455,358,84319,84278,41,-2.972046614
06/03/2014 16:01,2013,2012,A,London Area Airports,GATWICK,NEWQUAY,92609,92609,0,96181,96181,0,-3.713831186
06/03/2014 16:01,2013,2012,A,London Area Airports,GATWICK,NORWICH,80,0,80,32,0,32,150
06/03/2014 16:01,2013,2012,A,London Area Airports,HEATHROW,ABERDEEN,712184,712184,0,663809,663809,0,7.287487984
06/03/2014 16:01,2013,2012,A,London Area Airports,HEATHROW,BELFAST CITY (GEORGE BEST),671941,671941,0,499215,499215,0,34.59952164
06/03/2014 16:01,2013,2012,A,London Area Airports,HEATHROW,BELFAST INTERNATIONAL,0,0,0,191463,191463,0,
06/03/2014 16:01,2013,2012,A,London Area Airports,HEATHROW,DURHAM TEES VALLEY,45,0,45,0,0,0,
06/03/2014 16:01,2013,2012,A,London Area Airports,HEATHROW,EDINBURGH,1355929,1355926,3,1254993,1254933,60,8.042754173
06/03/2014 16:01,2013,2012,A,London Area Airports,HEATHROW,GLASGOW,869957,869957,0,828531,828277,254,4.99993372
06/03/2014 16:01,2013,2012,A,London Area Airports,HEATHROW,LEEDS BRADFORD,118717,118717,0,5580,5580,0,2027.5448
06/03/2014 16:01,2013,2012,A,London Area Airports,HEATHROW,LIVERPOOL (JOHN LENNON),70,0,70,70,0,70,0
06/03/2014 16:01,2013,2012,A,London Area Airports,HEATHROW,MANCHESTER,797263,797160,103,792831,792592,239,0.559009433
06/03/2014 16:01,2013,2012,A,London Area Airports,HEATHROW,NEWCASTLE,481307,481091,216,489726,489513,213,-1.719124556
06/03/2014 16:01,2013,2012,A,London Area Airports,LONDON CITY,ABERDEEN,73150,73150,0,15793,15793,0,363.1799011
06/03/2014 16:01,2013,2012,A,London Area Airports,LONDON CITY,DUNDEE,26056,26056,0,27872,27872,0,-6.515499592
06/03/2014 16:01,2013,2012,A,London Area Airports,LONDON CITY,EDINBURGH,333859,333859,0,322729,322729,0,3.448714018
06/03/2014 16:01,2013,2012,A,London Area Airports,LONDON CITY,GLASGOW,175373,175373,0,158239,158239,0,10.82792473
06/03/2014 16:01,2013,2012,A,London Area Airports,LONDON CITY,ISLE OF MAN,45149,45149,0,38494,38494,0,17.28840828
06/03/2014 16:01,2013,2012,A,London Area Airports,LONDON CITY,JERSEY,33738,33738,0,27691,27691,0,21.83741951
06/03/2014 16:01,2013,2012,A,London Area Airports,LUTON,ABERDEEN,82787,82787,0,119950,119950,0,-30.98207664
06/03/2014 16:01,2013,2012,A,London Area Airports,LUTON,BELFAST CITY (GEORGE BEST),16,0,16,0,0,0,
06/03/2014 16:01,2013,2012,A,London Area Airports,LUTON,BELFAST INTERNATIONAL,235528,234775,753,230104,229311,793,2.357194901
06/03/2014 16:01,2013,2012,A,London Area Airports,LUTON,CARDIFF WALES,209,0,209,67,0,67,211.9402924
06/03/2014 16:01,2013,2012,A,London Area Airports,LUTON,DONCASTER SHEFFIELD,0,0,0,11,0,11,
06/03/2014 16:01,2013,2012,A,London Area Airports,LUTON,DURHAM TEES VALLEY,119,0,119,89,0,89,33.70786667
06/03/2014 16:01,2013,2012,A,London Area Airports,LUTON,EDINBURGH,273474,273474,0,269797,269797,0,1.362876534
06/03/2014 16:01,2013,2012,A,London Area Airports,LUTON,EXETER,121,0,121,177,0,177,-31.6384182
06/03/2014 16:01,2013,2012,A,London Area Airports,LUTON,FARNBOROUGH,1,0,1,0,0,0,
06/03/2014 16:01,2013,2012,A,London Area Airports,LUTON,GLASGOW,280734,280680,54,276488,276278,210,1.535690546
06/03/2014 16:01,2013,2012,A,London Area Airports,LUTON,HUMBERSIDE,71,0,71,3,0,3,2266.666748
06/03/2014 16:01,2013,2012,A,London Area Airports,LUTON,INVERNESS,91845,91828,17,88841,88841,0,3.381321669
06/03/2014 16:01,2013,2012,A,London Area Airports,LUTON,ISLE OF MAN,9318,9318,0,18974,18974,0,-50.89069366
06/03/2014 16:01,2013,2012,A,London Area Airports,LUTON,JERSEY,8711,8711,0,16425,16425,0,-46.96499252
06/03/2014 16:01,2013,2012,A,London Area Airports,LUTON,LEEDS BRADFORD,121,0,121,63,0,63,92.06349182
06/03/2014 16:01,2013,2012,A,London Area Airports,LUTON,LIVERPOOL (JOHN LENNON),115,0,115,277,0,277,-58.4837532
06/03/2014 16:01,2013,2012,A,London Area Airports,LUTON,MANCHESTER,184,0,184,365,0,365,-49.58904266
06/03/2014 16:01,2013,2012,A,London Area Airports,LUTON,NEWCASTLE,272,0,272,609,0,609,-55.33661652
06/03/2014 16:01,2013,2012,A,London Area Airports,LUTON,NORWICH,0,0,0,57,0,57,
06/03/2014 16:01,2013,2012,A,London Area Airports,LUTON,OXFORD (KIDLINGTON),23,0,23,0,0,0,
06/03/2014 16:01,2013,2012,A,London Area Airports,LUTON,STANSTED,115,0,115,0,0,0,
06/03/2014 16:01,2013,2012,A,London Area Airports,SOUTHEND,BELFAST INTERNATIONAL,85604,85604,0,92502,92502,0,-7.457136154
06/03/2014 16:01,2013,2012,A,London Area Airports,SOUTHEND,EDINBURGH,39063,39063,0,0,0,0,
06/03/2014 16:01,2013,2012,A,London Area Airports,SOUTHEND,JERSEY,52768,52768,0,35169,35169,0,50.04122925
06/03/2014 16:01,2013,2012,A,London Area Airports,SOUTHEND,NEWQUAY,7448,7448,0,0,0,0,
06/03/2014 16:01,2013,2012,A,London Area Airports,STANSTED,BELFAST CITY (GEORGE BEST),806,0,806,47341,47341,0,-98.29746246
06/03/2014 16:01,2013,2012,A,London Area Airports,STANSTED,BELFAST INTERNATIONAL,297076,297016,60,311454,311454,0,-4.616412163
06/03/2014 16:01,2013,2012,A,London Area Airports,STANSTED,BIRMINGHAM,0,0,0,2,0,2,
06/03/2014 16:01,2013,2012,A,London Area Airports,STANSTED,CARDIFF WALES,126,0,126,0,0,0,
06/03/2014 16:01,2013,2012,A,London Area Airports,STANSTED,CITY OF DERRY (EGLINTON),130532,130532,0,134312,134312,0,-2.814342737
06/03/2014 16:01,2013,2012,A,London Area Airports,STANSTED,EDINBURGH,326562,326560,2,346353,346353,0,-5.714112282
06/03/2014 16:01,2013,2012,A,London Area Airports,STANSTED,FARNBOROUGH,0,0,0,2,0,2,
06/03/2014 16:01,2013,2012,A,London Area Airports,STANSTED,GLASGOW,308733,308733,0,331607,331607,0,-6.897924423
06/03/2014 16:01,2013,2012,A,London Area Airports,STANSTED,GUERNSEY,24919,24919,0,28244,28244,0,-11.7724123
06/03/2014 16:01,2013,2012,A,London Area Airports,STANSTED,HUMBERSIDE,99,0,99,0,0,0,
06/03/2014 16:01,2013,2012,A,London Area Airports,STANSTED,INVERNESS,17,0,17,134,0,134,-87.31343079
06/03/2014 16:01,2013,2012,A,London Area Airports,STANSTED,JERSEY,3449,3449,0,6141,6141,0,-43.8365097
06/03/2014 16:01,2013,2012,A,London Area Airports,STANSTED,LEEDS BRADFORD,0,0,0,338,338,0,
06/03/2014 16:01,2013,2012,A,London Area Airports,STANSTED,LIVERPOOL (JOHN LENNON),140,0,140,33,0,33,324.2424316
06/03/2014 16:01,2013,2012,A,London Area Airports,STANSTED,MANCHESTER,643,0,643,269,0,269,139.0334625
06/03/2014 16:01,2013,2012,A,London Area Airports,STANSTED,NEWCASTLE,490,0,490,153,0,153,220.2614441
06/03/2014 16:01,2013,2012,A,London Area Airports,STANSTED,NEWQUAY,0,0,0,2,0,2,
06/03/2014 16:01,2013,2012,A,London Area Airports,STANSTED,NORWICH,68,0,68,39,0,39,74.35897064
06/03/2014 16:01,2013,2012,B,Other Reporting Airports,ABERDEEN,BELFAST CITY (GEORGE BEST),30205,30205,0,21503,21503,0,40.46877289
06/03/2014 16:01,2013,2012,B,Other Reporting Airports,ABERDEEN,BIRMINGHAM,96789,96605,184,87317,87317,0,10.84783077
06/03/2014 16:01,2013,2012,B,Other Reporting Airports,ABERDEEN,BRISTOL,34915,34915,0,32890,32890,0,6.156886578
06/03/2014 16:01,2013,2012,B,Other Reporting Airports,ABERDEEN,CARDIFF WALES,13242,13242,0,14068,14068,0,-5.871481419
06/03/2014 16:01,2013,2012,B,Other Reporting Airports,ABERDEEN,DURHAM TEES VALLEY,32732,32732,0,33419,33342,77,-2.055716753
06/03/2014 16:01,2013,2012,B,Other Reporting Airports,ABERDEEN,EAST MIDLANDS INTERNATIONAL,18411,18411,0,19788,19705,83,-6.958763123
06/03/2014 16:01,2013,2012,B,Other Reporting Airports,ABERDEEN,EXETER,0,0,0,4798,4798,0,
06/03/2014 16:01,2013,2012,B,Other Reporting Airports,ABERDEEN,FARNBOROUGH,13,0,13,0,0,0,
06/03/2014 16:01,2013,2012,B,Other Reporting Airports,ABERDEEN,GLASGOW,132,0,132,145,0,145,-8.965517044
06/03/2014 16:01,2013,2012,B,Other Reporting Airports,ABERDEEN,HUMBERSIDE,34178,34178,0,32173,32173,0,6.231933594
06/03/2014 16:01,2013,2012,B,Other Reporting Airports,ABERDEEN,INVERNESS,151,0,151,37,0,37,308.1080933
06/03/2014 16:01,2013,2012,B,Other Reporting Airports,ABERDEEN,JERSEY,2209,2209,0,2344,2344,0,-5.759385586
06/03/2014 16:01,2013,2012,B,Other Reporting Airports,ABERDEEN,KIRKWALL,48633,48267,366,47178,46958,220,3.084064722
06/03/2014 16:01,2013,2012,B,Other Reporting Airports,ABERDEEN,LEEDS BRADFORD,12349,12349,0,551,486,65,2141.197754
06/03/2014 16:01,2013,2012,B,Other Reporting Airports,ABERDEEN,MANCHESTER,203347,199984,3363,180733,177061,3672,12.5123806
06/03/2014 16:01,2013,2012,B,Other Reporting Airports,ABERDEEN,NEWCASTLE,30759,30759,0,24855,24855,0,23.75377274
06/03/2014 16:01,2013,2012,B,Other Reporting Airports,ABERDEEN,NORWICH,63766,63766,0,64630,64532,98,-1.33684051
06/03/2014 16:01,2013,2012,B,Other Reporting Airports,ABERDEEN,SCATSTA,165736,0,165736,168127,0,168127,-1.422139168
06/03/2014 16:01,2013,2012,B,Other Reporting Airports,ABERDEEN,SOUTHAMPTON,9501,9501,0,16305,16300,5,-41.72953033
06/03/2014 16:01,2013,2012,B,Other Reporting Airports,ABERDEEN,STORNOWAY,5476,5476,0,5555,5555,0,-1.422142267
06/03/2014 16:01,2013,2012,B,Other Reporting Airports,ABERDEEN,SUMBURGH,115283,73166,42117,75203,68340,6863,53.29574585
06/03/2014 16:01,2013,2012,B,Other Reporting Airports,ABERDEEN,WICK JOHN O GROATS,13860,12948,912,14638,13534,1104,-5.314933777
06/03/2014 16:01,2013,2012,B,Other Reporting Airports,ALDERNEY,GUERNSEY,36730,36730,0,38902,38902,0,-5.583260536
06/03/2014 16:01,2013,2012,B,Other Reporting Airports,ALDERNEY,JERSEY,239,239,0,306,306,0,-21.89542389
06/03/2014 16:01,2013,2012,B,Other Reporting Airports,ALDERNEY,SOUTHAMPTON,25927,25927,0,24943,24943,0,3.944994688
06/03/2014 16:01,2013,2012,B,Other Reporting Airports,ANGLESEY (VALLEY),CARDIFF WALES,8540,8540,0,8594,8594,0,-0.62834537
06/03/2014 16:01,2013,2012,B,Other Reporting Airports,ANGLESEY (VALLEY),ISLE OF MAN,46,46,0,320,320,0,-85.625
06/03/2014 16:01,2013,2012,B,Other Reporting Airports,BARRA,BENBECULA,277,277,0,2391,2391,0,-88.41488647
06/03/2014 16:01,2013,2012,B,Other Reporting Airports,BARRA,GLASGOW,9133,9133,0,9023,9023,0,1.219106674
06/03/2014 16:01,2013,2012,B,Other Reporting Airports,BELFAST CITY (GEORGE BEST),BIRMINGHAM,267168,267106,62,308289,308289,0,-13.33845806
06/03/2014 16:01,2013,2012,B,Other Reporting Airports,BELFAST CITY (GEORGE BEST),BLACKPOOL,4833,4833,0,12014,12014,0,-59.77193451
06/03/2014 16:01,2013,2012,B,Other Reporting Airports,BELFAST CITY (GEORGE BEST),BRISTOL,448,0,448,17263,17263,0,-97.40485382
06/03/2014 16:01,2013,2012,B,Other Reporting Airports,BELFAST CITY (GEORGE BEST),CARDIFF WALES,38389,38236,153,38412,38412,0,-0.05987712
06/03/2014 16:01,2013,2012,B,Other Reporting Airports,BELFAST CITY (GEORGE BEST),DUNDEE,0,0,0,8518,8518,0,
06/03/2014 16:01,2013,2012,B,Other Reporting Airports,BELFAST CITY (GEORGE BEST),EAST MIDLANDS INTERNATIONAL,125883,125629,254,164576,164576,0,-23.5107193
06/03/2014 16:01,2013,2012,B,Other Reporting Airports,BELFAST CITY (GEORGE BEST),EDINBURGH,128092,128092,0,124252,124252,0,3.090493441
06/03/2014 16:01,2013,2012,B,Other Reporting Airports,BELFAST CITY (GEORGE BEST),EXETER,11998,11998,0,12492,12492,0,-3.954530954
06/03/2014 16:01,2013,2012,B,Other Reporting Airports,BELFAST CITY (GEORGE BEST),GLASGOW,119280,119280,0,100003,99961,42,19.2764225
06/03/2014 16:01,2013,2012,B,Other Reporting Airports,BELFAST CITY (GEORGE BEST),GLOUCESTERSHIRE,0,0,0,223,223,0,
06/03/2014 16:01,2013,2012,B,Other Reporting Airports,BELFAST CITY (GEORGE BEST),INVERNESS,23253,23253,0,23625,23625,0,-1.5746032
06/03/2014 16:01,2013,2012,B,Other Reporting Airports,BELFAST CITY (GEORGE BEST),ISLE OF MAN,22294,22242,52,15299,15232,67,45.7219429
06/03/2014 16:01,2013,2012,B,Other Reporting Airports,BELFAST CITY (GEORGE BEST),JERSEY,1241,1241,0,1985,1985,0,-37.48110962
06/03/2014 16:01,2013,2012,B,Other Reporting Airports,BELFAST CITY (GEORGE BEST),LEEDS BRADFORD,130904,130648,256,100108,100108,0,30.76277542
06/03/2014 16:01,2013,2012,B,Other Reporting Airports,BELFAST CITY (GEORGE BEST),MANCHESTER,280173,280173,0,279917,279917,0,0.091455683
06/03/2014 16:01,2013,2012,B,Other Reporting Airports,BELFAST CITY (GEORGE BEST),NEWCASTLE,41700,41700,0,39118,39118,0,6.600542068
06/03/2014 16:01,2013,2012,B,Other Reporting Airports,BELFAST CITY (GEORGE BEST),NEWQUAY,2187,2187,0,1758,1758,0,24.40273094
06/03/2014 16:01,2013,2012,B,Other Reporting Airports,BELFAST CITY (GEORGE BEST),SOUTHAMPTON,85603,85396,207,84573,84573,0,1.217882752
06/03/2014 16:01,2013,2012,B,Other Reporting Airports,BELFAST INTERNATIONAL,BIRMINGHAM,158591,158105,486,24892,24683,209,537.116333
06/03/2014 16:01,2013,2012,B,Other Reporting Airports,BELFAST INTERNATIONAL,BLACKPOOL,11849,11849,0,19318,19318,0,-38.66342163
06/03/2014 16:01,2013,2012,B,Other Reporting Airports,BELFAST INTERNATIONAL,BRISTOL,226217,225780,437,217182,217140,42,4.160105228
06/03/2014 16:01,2013,2012,B,Other Reporting Airports,BELFAST INTERNATIONAL,CARDIFF WALES,0,0,0,90,0,90,
06/03/2014 16:01,2013,2012,B,Other Reporting Airports,BELFAST INTERNATIONAL,DONCASTER SHEFFIELD,94,0,94,0,0,0,
06/03/2014 16:01,2013,2012,B,Other Reporting Airports,BELFAST INTERNATIONAL,EAST MIDLANDS INTERNATIONAL,421,0,421,91,0,91,362.6373596
06/03/2014 16:01,2013,2012,B,Other Reporting Airports,BELFAST INTERNATIONAL,EDINBURGH,244726,244718,8,237242,237242,0,3.154584885
06/03/2014 16:01,2013,2012,B,Other Reporting Airports,BELFAST INTERNATIONAL,FARNBOROUGH,0,0,0,48,0,48,
06/03/2014 16:01,2013,2012,B,Other Reporting Airports,BELFAST INTERNATIONAL,GLASGOW,250844,250696,148,266987,266879,108,-6.046361923
06/03/2014 16:01,2013,2012,B,Other Reporting Airports,BELFAST INTERNATIONAL,JERSEY,9193,9193,0,9267,9267,0,-0.798532426
06/03/2014 16:01,2013,2012,B,Other Reporting Airports,BELFAST INTERNATIONAL,LEEDS BRADFORD,22466,22466,0,51535,51535,0,-56.40632629
06/03/2014 16:01,2013,2012,B,Other Reporting Airports,BELFAST INTERNATIONAL,LIVERPOOL (JOHN LENNON),413924,413924,0,447571,447571,0,-7.517689705
06/03/2014 16:01,2013,2012,B,Other Reporting Airports,BELFAST INTERNATIONAL,MANCHESTER,189969,189969,0,149334,149296,38,27.21081543
06/03/2014 16:01,2013,2012,B,Other Reporting Airports,BELFAST INTERNATIONAL,NEWCASTLE,192513,192513,0,193123,193123,0,-0.315860868
06/03/2014 16:01,2013,2012,B,Other Reporting Airports,BENBECULA,GLASGOW,21802,21802,0,19716,19716,0,10.5802393
06/03/2014 16:01,2013,2012,B,Other Reporting Airports,BENBECULA,INVERNESS,670,670,0,0,0,0,
06/03/2014 16:01,2013,2012,B,Other Reporting Airports,BENBECULA,STORNOWAY,7865,7865,0,9723,9723,0,-19.10932922
06/03/2014 16:01,2013,2012,B,Other Reporting Airports,BIGGIN HILL,BLACKPOOL,72,0,72,0,0,0,
06/03/2014 16:01,2013,2012,B,Other Reporting Airports,BIGGIN HILL,LIVERPOOL (JOHN LENNON),80,0,80,0,0,0,
06/03/2014 16:01,2013,2012,B,Other Reporting Airports,BIGGIN HILL,NEWCASTLE,74,0,74,0,0,0,
06/03/2014 16:01,2013,2012,B,Other Reporting Airports,BIRMINGHAM,CARDIFF WALES,19,19,0,5,5,0,280
06/03/2014 16:01,2013,2012,B,Other Reporting Airports,BIRMINGHAM,CITY OF DERRY (EGLINTON),52322,52270,52,55096,55096,0,-5.034848213
06/03/2014 16:01,2013,2012,B,Other Reporting Airports,BIRMINGHAM,DUNDEE,0,0,0,16145,16145,0,
06/03/2014 16:01,2013,2012,B,Other Reporting Airports,BIRMINGHAM,EDINBURGH,284150,283746,404,285911,285911,0,-0.615925908
06/03/2014 16:01,2013,2012,B,Other Reporting Airports,BIRMINGHAM,GLASGOW,203464,203316,148,208123,207857,266,-2.238579988
06/03/2014 16:01,2013,2012,B,Other Reporting Airports,BIRMINGHAM,GUERNSEY,34409,34177,232,27630,27630,0,24.53492546
06/03/2014 16:01,2013,2012,B,Other Reporting Airports,BIRMINGHAM,INVERNESS,34813,34753,60,32987,32987,0,5.535513878
06/03/2014 16:01,2013,2012,B,Other Reporting Airports,BIRMINGHAM,ISLE OF MAN,41676,41676,0,43412,43412,0,-3.998894215
06/03/2014 16:01,2013,2012,B,Other Reporting Airports,BIRMINGHAM,JERSEY,38685,38685,0,47941,47941,0,-19.30706406
06/03/2014 16:01,2013,2012,B,Other Reporting Airports,BIRMINGHAM,NEWCASTLE,8015,8015,0,10393,10393,0,-22.88078499
06/03/2014 16:01,2013,2012,B,Other Reporting Airports,BIRMINGHAM,SOUTHAMPTON,59,0,59,73,73,0,-19.17808151
06/03/2014 16:01,2013,2012,B,Other Reporting Airports,BIRMINGHAM,STORNOWAY,0,0,0,177,0,177,
06/03/2014 16:01,2013,2012,B,Other Reporting Airports,BLACKPOOL,CARDIFF WALES,124,0,124,0,0,0,
06/03/2014 16:01,2013,2012,B,Other Reporting Airports,BLACKPOOL,EAST MIDLANDS INTERNATIONAL,29,0,29,0,0,0,
06/03/2014 16:01,2013,2012,B,Other Reporting Airports,BLACKPOOL,EDINBURGH,0,0,0,48,0,48,
06/03/2014 16:01,2013,2012,B,Other Reporting Airports,BLACKPOOL,INVERNESS,0,0,0,81,0,81,
06/03/2014 16:01,2013,2012,B,Other Reporting Airports,BLACKPOOL,ISLE OF MAN,19536,19536,0,22397,22397,0,-12.77403259
06/03/2014 16:01,2013,2012,B,Other Reporting Airports,BLACKPOOL,JERSEY,0,0,0,6911,6911,0,
06/03/2014 16:01,2013,2012,B,Other Reporting Airports,BLACKPOOL,NORWICH,0,0,0,62,0,62,
06/03/2014 16:01,2013,2012,B,Other Reporting Airports,BLACKPOOL,SOUTH MARSTON,62,0,62,0,0,0,
06/03/2014 16:01,2013,2012,B,Other Reporting Airports,BOURNEMOUTH,DURHAM TEES VALLEY,64,0,64,0,0,0,
06/03/2014 16:01,2013,2012,B,Other Reporting Airports,BOURNEMOUTH,EDINBURGH,50,0,50,185,1,184,-72.97297668
06/03/2014 16:01,2013,2012,B,Other Reporting Airports,BOURNEMOUTH,JERSEY,155,155,0,2898,2898,0,-94.65148163
06/03/2014 16:01,2013,2012,B,Other Reporting Airports,BOURNEMOUTH,LEEDS BRADFORD,0,0,0,64,0,64,
06/03/2014 16:01,2013,2012,B,Other Reporting Airports,BOURNEMOUTH,MANCHESTER,70,0,70,0,0,0,
06/03/2014 16:01,2013,2012,B,Other Reporting Airports,BOURNEMOUTH,NEWCASTLE,40,0,40,63,0,63,-36.50793839
06/03/2014 16:01,2013,2012,B,Other Reporting Airports,BRISTOL,CARDIFF WALES,0,0,0,36,36,0,
06/03/2014 16:01,2013,2012,B,Other Reporting Airports,BRISTOL,EDINBURGH,305235,305235,0,295532,295532,0,3.283231497
06/03/2014 16:01,2013,2012,B,Other Reporting Airports,BRISTOL,FILTON,0,0,0,45,0,45,
06/03/2014 16:01,2013,2012,B,Other Reporting Airports,BRISTOL,GLASGOW,257445,257406,39,239666,239574,92,7.418240547
06/03/2014 16:01,2013,2012,B,Other Reporting Airports,BRISTOL,GUERNSEY,23670,23670,0,6833,6833,0,246.407135
06/03/2014 16:01,2013,2012,B,Other Reporting Airports,BRISTOL,HAWARDEN,8468,0,8468,18,0,18,46944.44531
06/03/2014 16:01,2013,2012,B,Other Reporting Airports,BRISTOL,INVERNESS,81231,81231,0,78072,78072,0,4.046265125
06/03/2014 16:01,2013,2012,B,Other Reporting Airports,BRISTOL,ISLE OF MAN,5179,5179,0,8186,8186,0,-36.73344803
06/03/2014 16:01,2013,2012,B,Other Reporting Airports,BRISTOL,ISLES OF SCILLY (ST.MARYS),0,0,0,2932,2932,0,
06/03/2014 16:01,2013,2012,B,Other Reporting Airports,BRISTOL,JERSEY,39779,39779,0,33817,33817,0,17.63018608
06/03/2014 16:01,2013,2012,B,Other Reporting Airports,BRISTOL,LEEDS BRADFORD,916,916,0,8239,8239,0,-88.88214874
06/03/2014 16:01,2013,2012,B,Other Reporting Airports,BRISTOL,MANCHESTER,78,0,78,85,0,85,-8.235294342
06/03/2014 16:01,2013,2012,B,Other Reporting Airports,BRISTOL,NEWCASTLE,175587,175506,81,171460,171460,0,2.406975269
06/03/2014 16:01,2013,2012,B,Other Reporting Airports,BRISTOL,SOUTHAMPTON,0,0,0,1,1,0,
06/03/2014 16:01,2013,2012,B,Other Reporting Airports,CAMBRIDGE,CARDIFF WALES,73,0,73,0,0,0,
06/03/2014 16:01,2013,2012,B,Other Reporting Airports,CAMBRIDGE,JERSEY,1131,0,1131,1080,0,1080,4.722222328
06/03/2014 16:01,2013,2012,B,Other Reporting Airports,CAMBRIDGE,NEWCASTLE,12,0,12,0,0,0,
06/03/2014 16:01,2013,2012,B,Other Reporting Airports,CAMPBELTOWN,GLASGOW,9251,9251,0,8554,8554,0,8.148234367
06/03/2014 16:01,2013,2012,B,Other Reporting Airports,CAMPBELTOWN,ISLAY,52,52,0,135,135,0,-61.48147964
06/03/2014 16:01,2013,2012,B,Other Reporting Airports,CAMPBELTOWN,PRESTWICK,62,0,62,0,0,0,
06/03/2014 16:01,2013,2012,B,Other Reporting Airports,CARDIFF WALES,DURHAM TEES VALLEY,73,0,73,34,0,34,114.7058792
06/03/2014 16:01,2013,2012,B,Other Reporting Airports,CARDIFF WALES,EAST MIDLANDS INTERNATIONAL,59,0,59,0,0,0,
06/03/2014 16:01,2013,2012,B,Other Reporting Airports,CARDIFF WALES,EDINBURGH,76956,76141,815,77719,77511,208,-0.981741905
06/03/2014 16:01,2013,2012,B,Other Reporting Airports,CARDIFF WALES,FARNBOROUGH,143,0,143,74,0,74,93.24324036
06/03/2014 16:01,2013,2012,B,Other Reporting Airports,CARDIFF WALES,GLASGOW,48217,48089,128,39828,39828,0,21.0630703
06/03/2014 16:01,2013,2012,B,Other Reporting Airports,CARDIFF WALES,HUMBERSIDE,187,0,187,53,0,53,252.8301849
06/03/2014 16:01,2013,2012,B,Other Reporting Airports,CARDIFF WALES,ISLE OF MAN,0,0,0,50,50,0,
06/03/2014 16:01,2013,2012,B,Other Reporting Airports,CARDIFF WALES,JERSEY,10637,10637,0,9097,9097,0,16.92865753
06/03/2014 16:01,2013,2012,B,Other Reporting Airports,CARDIFF WALES,LEEDS BRADFORD,93,0,93,0,0,0,
06/03/2014 16:01,2013,2012,B,Other Reporting Airports,CARDIFF WALES,LIVERPOOL (JOHN LENNON),381,0,381,352,0,352,8.238636017
06/03/2014 16:01,2013,2012,B,Other Reporting Airports,CARDIFF WALES,MANCHESTER,632,0,632,364,0,364,73.62637329
06/03/2014 16:01,2013,2012,B,Other Reporting Airports,CARDIFF WALES,NEWCASTLE,12546,12053,493,14336,14077,259,-12.4860487
06/03/2014 16:01,2013,2012,B,Other Reporting Airports,CARDIFF WALES,NORWICH,232,0,232,122,0,122,90.1639328
06/03/2014 16:01,2013,2012,B,Other Reporting Airports,CARDIFF WALES,SOUTHAMPTON,32,0,32,0,0,0,
06/03/2014 16:01,2013,2012,B,Other Reporting Airports,CITY OF DERRY (EGLINTON),LIVERPOOL (JOHN LENNON),90755,90755,0,93796,93796,0,-3.242142439
06/03/2014 16:01,2013,2012,B,Other Reporting Airports,CITY OF DERRY (EGLINTON),PRESTWICK,69454,69454,0,72752,72752,0,-4.533208847
06/03/2014 16:01,2013,2012,B,Other Reporting Airports,DONCASTER SHEFFIELD,FARNBOROUGH,0,0,0,35,0,35,
06/03/2014 16:01,2013,2012,B,Other Reporting Airports,DONCASTER SHEFFIELD,JERSEY,3405,3405,0,9414,9414,0,-63.83046341
06/03/2014 16:01,2013,2012,B,Other Reporting Airports,DUNDEE,DURHAM TEES VALLEY,0,0,0,71,71,0,
06/03/2014 16:01,2013,2012,B,Other Reporting Airports,DUNDEE,EAST MIDLANDS INTERNATIONAL,0,0,0,17,17,0,
06/03/2014 16:01,2013,2012,B,Other Reporting Airports,DUNDEE,HUMBERSIDE,0,0,0,53,53,0,
06/03/2014 16:01,2013,2012,B,Other Reporting Airports,DUNDEE,JERSEY,1674,0,1674,1761,310,1451,-4.940374851
06/03/2014 16:01,2013,2012,B,Other Reporting Airports,DUNDEE,KIRKWALL,0,0,0,17,17,0,
06/03/2014 16:01,2013,2012,B,Other Reporting Airports,DUNDEE,MANCHESTER,0,0,0,92,0,92,
06/03/2014 16:01,2013,2012,B,Other Reporting Airports,DUNDEE,NEWCASTLE,0,0,0,62,62,0,
06/03/2014 16:01,2013,2012,B,Other Reporting Airports,DUNDEE,SOUTHAMPTON,0,0,0,9,9,0,
06/03/2014 16:01,2013,2012,B,Other Reporting Airports,DUNDEE,SUMBURGH,0,0,0,64,64,0,
06/03/2014 16:01,2013,2012,B,Other Reporting Airports,DURHAM TEES VALLEY,FARNBOROUGH,105,0,105,26,0,26,303.8461609
06/03/2014 16:01,2013,2012,B,Other Reporting Airports,DURHAM TEES VALLEY,JERSEY,1914,1914,0,1764,1700,64,8.503401756
06/03/2014 16:01,2013,2012,B,Other Reporting Airports,DURHAM TEES VALLEY,LIVERPOOL (JOHN LENNON),63,0,63,0,0,0,
06/03/2014 16:01,2013,2012,B,Other Reporting Airports,DURHAM TEES VALLEY,NEWCASTLE,140,0,140,0,0,0,
06/03/2014 16:01,2013,2012,B,Other Reporting Airports,DURHAM TEES VALLEY,SOUTHAMPTON,14,14,0,61,1,60,-77.04917908
06/03/2014 16:01,2013,2012,B,Other Reporting Airports,EAST MIDLANDS INTERNATIONAL,EDINBURGH,86709,86709,0,72656,72656,0,19.3418293
06/03/2014 16:01,2013,2012,B,Other Reporting Airports,EAST MIDLANDS INTERNATIONAL,FARNBOROUGH,36,0,36,0,0,0,
06/03/2014 16:01,2013,2012,B,Other Reporting Airports,EAST MIDLANDS INTERNATIONAL,GLASGOW,85531,85364,167,70677,70645,32,21.01673889
06/03/2014 16:01,2013,2012,B,Other Reporting Airports,EAST MIDLANDS INTERNATIONAL,GUERNSEY,28738,28738,0,28842,28842,0,-0.360585272
06/03/2014 16:01,2013,2012,B,Other Reporting Airports,EAST MIDLANDS INTERNATIONAL,JERSEY,25998,25998,0,46601,46601,0,-44.21149826
06/03/2014 16:01,2013,2012,B,Other Reporting Airports,EAST MIDLANDS INTERNATIONAL,LEEDS BRADFORD,0,0,0,293,293,0,
06/03/2014 16:01,2013,2012,B,Other Reporting Airports,EAST MIDLANDS INTERNATIONAL,NEWCASTLE,0,0,0,40,0,40,
06/03/2014 16:01,2013,2012,B,Other Reporting Airports,EAST MIDLANDS INTERNATIONAL,NEWQUAY,0,0,0,810,810,0,
06/03/2014 16:01,2013,2012,B,Other Reporting Airports,EDAY,KIRKWALL,750,750,0,539,539,0,39.1465683
06/03/2014 16:01,2013,2012,B,Other Reporting Airports,EDINBURGH,EXETER,36523,36523,0,40188,40188,0,-9.119637489
06/03/2014 16:01,2013,2012,B,Other Reporting Airports,EDINBURGH,FARNBOROUGH,39,0,39,0,0,0,
06/03/2014 16:01,2013,2012,B,Other Reporting Airports,EDINBURGH,GLASGOW,0,0,0,187,187,0,
06/03/2014 16:01,2013,2012,B,Other Reporting Airports,EDINBURGH,ISLAY,0,0,0,83,0,83,
06/03/2014 16:01,2013,2012,B,Other Reporting Airports,EDINBURGH,ISLE OF MAN,4152,4152,0,10826,10826,0,-61.64788437
06/03/2014 16:01,2013,2012,B,Other Reporting Airports,EDINBURGH,JERSEY,9187,9187,0,11085,11085,0,-17.12223816
06/03/2014 16:01,2013,2012,B,Other Reporting Airports,EDINBURGH,KIRKWALL,43497,43497,0,39995,39995,0,8.756094933
06/03/2014 16:01,2013,2012,B,Other Reporting Airports,EDINBURGH,LEEDS BRADFORD,0,0,0,2182,2182,0,
06/03/2014 16:01,2013,2012,B,Other Reporting Airports,EDINBURGH,MANCHESTER,118516,118516,0,108278,108278,0,9.455290794
06/03/2014 16:01,2013,2012,B,Other Reporting Airports,EDINBURGH,MANSTON (KENT INT),0,0,0,3446,3446,0,
06/03/2014 16:01,2013,2012,B,Other Reporting Airports,EDINBURGH,NEWQUAY,4481,4481,0,9878,9878,0,-54.63656616
06/03/2014 16:01,2013,2012,B,Other Reporting Airports,EDINBURGH,NORWICH,24668,24668,0,39663,39663,0,-37.80601501
06/03/2014 16:01,2013,2012,B,Other Reporting Airports,EDINBURGH,OXFORD (KIDLINGTON),4061,4061,0,0,0,0,
06/03/2014 16:01,2013,2012,B,Other Reporting Airports,EDINBURGH,SOUTHAMPTON,207566,207566,0,204488,204488,0,1.505222797
06/03/2014 16:01,2013,2012,B,Other Reporting Airports,EDINBURGH,STORNOWAY,19284,19284,0,19900,19900,0,-3.095477343
06/03/2014 16:01,2013,2012,B,Other Reporting Airports,EDINBURGH,SUMBURGH,39876,39830,46,36914,36914,0,8.024055481
06/03/2014 16:01,2013,2012,B,Other Reporting Airports,EDINBURGH,WICK JOHN O GROATS,11362,11334,28,9645,9645,0,17.80196953
06/03/2014 16:01,2013,2012,B,Other Reporting Airports,EXETER,FARNBOROUGH,0,0,0,8,0,8,
06/03/2014 16:01,2013,2012,B,Other Reporting Airports,EXETER,GLASGOW,23771,23771,0,25617,25617,0,-7.206151962
06/03/2014 16:01,2013,2012,B,Other Reporting Airports,EXETER,GUERNSEY,22150,22150,0,22283,22283,0,-0.596867561
06/03/2014 16:01,2013,2012,B,Other Reporting Airports,EXETER,HAWARDEN,25,0,25,0,0,0,
06/03/2014 16:01,2013,2012,B,Other Reporting Airports,EXETER,ISLES OF SCILLY (ST.MARYS),15097,15097,0,2414,2414,0,525.3935547
06/03/2014 16:01,2013,2012,B,Other Reporting Airports,EXETER,JERSEY,33070,33070,0,35430,35430,0,-6.661021709
06/03/2014 16:01,2013,2012,B,Other Reporting Airports,EXETER,LEEDS BRADFORD,0,0,0,7967,7967,0,
06/03/2014 16:01,2013,2012,B,Other Reporting Airports,EXETER,MANCHESTER,84618,84618,0,64049,64048,1,32.11447525
06/03/2014 16:01,2013,2012,B,Other Reporting Airports,EXETER,NEWCASTLE,29945,29945,0,29797,29789,8,0.496694297
06/03/2014 16:01,2013,2012,B,Other Reporting Airports,EXETER,NEWQUAY,10,10,0,0,0,0,
06/03/2014 16:01,2013,2012,B,Other Reporting Airports,EXETER,NORWICH,66,66,0,7080,7080,0,-99.0677948
06/03/2014 16:01,2013,2012,B,Other Reporting Airports,EXETER,SOUTHAMPTON,42,0,42,0,0,0,
06/03/2014 16:01,2013,2012,B,Other Reporting Airports,FAIR ISLE,LERWICK (TINGWALL),2364,2364,0,3060,3060,0,-22.74509811
06/03/2014 16:01,2013,2012,B,Other Reporting Airports,FAIR ISLE,SUMBURGH,109,109,0,103,103,0,5.825242519
06/03/2014 16:01,2013,2012,B,Other Reporting Airports,FARNBOROUGH,INVERNESS,119,0,119,0,0,0,
06/03/2014 16:01,2013,2012,B,Other Reporting Airports,FARNBOROUGH,LEEDS BRADFORD,0,0,0,34,0,34,
06/03/2014 16:01,2013,2012,B,Other Reporting Airports,FARNBOROUGH,LIVERPOOL (JOHN LENNON),299,0,299,422,0,422,-29.14691925
06/03/2014 16:01,2013,2012,B,Other Reporting Airports,FARNBOROUGH,MANCHESTER,290,0,290,491,0,491,-40.93686295
06/03/2014 16:01,2013,2012,B,Other Reporting Airports,FARNBOROUGH,NEWCASTLE,449,0,449,337,0,337,33.23442078
06/03/2014 16:01,2013,2012,B,Other Reporting Airports,FARNBOROUGH,NORWICH,104,0,104,0,0,0,
06/03/2014 16:01,2013,2012,B,Other Reporting Airports,FILTON,MANCHESTER,0,0,0,91,0,91,
06/03/2014 16:01,2013,2012,B,Other Reporting Airports,FOULA,LERWICK (TINGWALL),1211,1211,0,1446,1446,0,-16.25172806
06/03/2014 16:01,2013,2012,B,Other Reporting Airports,GLASGOW,GUERNSEY,793,0,793,0,0,0,
06/03/2014 16:01,2013,2012,B,Other Reporting Airports,GLASGOW,INVERNESS,0,0,0,8,8,0,
06/03/2014 16:01,2013,2012,B,Other Reporting Airports,GLASGOW,ISLAY,25595,25595,0,25081,25081,0,2.049360037
06/03/2014 16:01,2013,2012,B,Other Reporting Airports,GLASGOW,ISLE OF MAN,4011,4011,0,11097,11097,0,-63.85509491
06/03/2014 16:01,2013,2012,B,Other Reporting Airports,GLASGOW,JERSEY,36403,36403,0,28292,28292,0,28.66888237
06/03/2014 16:01,2013,2012,B,Other Reporting Airports,GLASGOW,KIRKWALL,17588,17588,0,15122,15122,0,16.30736732
06/03/2014 16:01,2013,2012,B,Other Reporting Airports,GLASGOW,LEEDS BRADFORD,9992,9978,14,11942,11942,0,-16.32892227
06/03/2014 16:01,2013,2012,B,Other Reporting Airports,GLASGOW,MANCHESTER,52025,51972,53,50042,49918,124,3.96267128
06/03/2014 16:01,2013,2012,B,Other Reporting Airports,GLASGOW,NEWCASTLE,29,0,29,0,0,0,
06/03/2014 16:01,2013,2012,B,Other Reporting Airports,GLASGOW,NEWQUAY,1751,1751,0,3559,3559,0,-50.80078506
06/03/2014 16:01,2013,2012,B,Other Reporting Airports,GLASGOW,NORWICH,0,0,0,4,0,4,
06/03/2014 16:01,2013,2012,B,Other Reporting Airports,GLASGOW,SOUTHAMPTON,182565,182456,109,173576,173477,99,5.178711414
06/03/2014 16:01,2013,2012,B,Other Reporting Airports,GLASGOW,STORNOWAY,57499,57499,0,55556,55556,0,3.497371912
06/03/2014 16:01,2013,2012,B,Other Reporting Airports,GLASGOW,SUMBURGH,20109,20109,0,17964,17964,0,11.94054794
06/03/2014 16:01,2013,2012,B,Other Reporting Airports,GLASGOW,TIREE,7555,7555,0,7864,7864,0,-3.929298162
06/03/2014 16:01,2013,2012,B,Other Reporting Airports,GLOUCESTERSHIRE,ISLE OF MAN,13594,13594,0,14266,14266,0,-4.710500717
06/03/2014 16:01,2013,2012,B,Other Reporting Airports,GLOUCESTERSHIRE,JERSEY,535,535,0,1014,1014,0,-47.23865891
06/03/2014 16:01,2013,2012,B,Other Reporting Airports,GUERNSEY,ISLE OF MAN,0,0,0,22,22,0,
06/03/2014 16:01,2013,2012,B,Other Reporting Airports,GUERNSEY,JERSEY,138624,138624,0,141944,141853,91,-2.338950634
06/03/2014 16:01,2013,2012,B,Other Reporting Airports,GUERNSEY,MANCHESTER,66371,66315,56,63200,63200,0,5.017405033
06/03/2014 16:01,2013,2012,B,Other Reporting Airports,GUERNSEY,NEWCASTLE,304,0,304,0,0,0,
06/03/2014 16:01,2013,2012,B,Other Reporting Airports,GUERNSEY,NEWQUAY,0,0,0,38,0,38,
06/03/2014 16:01,2013,2012,B,Other Reporting Airports,GUERNSEY,NORWICH,1197,1197,0,1612,1612,0,-25.74441719
06/03/2014 16:01,2013,2012,B,Other Reporting Airports,GUERNSEY,SOUTHAMPTON,134440,134375,65,132030,131926,104,1.825342774
06/03/2014 16:01,2013,2012,B,Other Reporting Airports,HAWARDEN,MANCHESTER,7,0,7,24,0,24,-70.83333588
06/03/2014 16:01,2013,2012,B,Other Reporting Airports,HAWARDEN,SOUTHAMPTON,9,0,9,0,0,0,
06/03/2014 16:01,2013,2012,B,Other Reporting Airports,HUMBERSIDE,ISLE OF MAN,30,0,30,0,0,0,
06/03/2014 16:01,2013,2012,B,Other Reporting Airports,HUMBERSIDE,JERSEY,2175,2175,0,2178,1341,837,-0.137741044
06/03/2014 16:01,2013,2012,B,Other Reporting Airports,HUMBERSIDE,LEEDS BRADFORD,0,0,0,27,0,27,
06/03/2014 16:01,2013,2012,B,Other Reporting Airports,HUMBERSIDE,NORWICH,864,784,80,1804,1804,0,-52.10643005
06/03/2014 16:01,2013,2012,B,Other Reporting Airports,HUMBERSIDE,SOUTHAMPTON,64,0,64,75,0,75,-14.66666698
06/03/2014 16:01,2013,2012,B,Other Reporting Airports,INVERNESS,JERSEY,1717,1717,0,1633,1633,0,5.14390707
06/03/2014 16:01,2013,2012,B,Other Reporting Airports,INVERNESS,KIRKWALL,19204,19204,0,16810,16810,0,14.24152279
06/03/2014 16:01,2013,2012,B,Other Reporting Airports,INVERNESS,LEEDS BRADFORD,0,0,0,64,39,25,
06/03/2014 16:01,2013,2012,B,Other Reporting Airports,INVERNESS,MANCHESTER,55790,55624,166,50998,50998,0,9.396447182
06/03/2014 16:01,2013,2012,B,Other Reporting Airports,INVERNESS,NEWCASTLE,15,0,15,7,7,0,114.2857132
06/03/2014 16:01,2013,2012,B,Other Reporting Airports,INVERNESS,NORWICH,0,0,0,33,33,0,
06/03/2014 16:01,2013,2012,B,Other Reporting Airports,INVERNESS,SCATSTA,0,0,0,124,88,36,
06/03/2014 16:01,2013,2012,B,Other Reporting Airports,INVERNESS,SOUTHAMPTON,0,0,0,1827,1827,0,
06/03/2014 16:01,2013,2012,B,Other Reporting Airports,INVERNESS,STORNOWAY,32850,32156,694,36249,36249,0,-9.376810074
06/03/2014 16:01,2013,2012,B,Other Reporting Airports,INVERNESS,SUMBURGH,3263,3263,0,4244,4204,40,-23.11498642
06/03/2014 16:01,2013,2012,B,Other Reporting Airports,ISLE OF MAN,JERSEY,174,174,0,2746,2746,0,-93.66351318
06/03/2014 16:01,2013,2012,B,Other Reporting Airports,ISLE OF MAN,LEEDS BRADFORD,462,462,0,7177,7177,0,-93.56276703
06/03/2014 16:01,2013,2012,B,Other Reporting Airports,ISLE OF MAN,LIVERPOOL (JOHN LENNON),204817,204817,0,174618,174548,70,17.29432297
06/03/2014 16:01,2013,2012,B,Other Reporting Airports,ISLE OF MAN,MANCHESTER,132469,132261,208,125249,125249,0,5.764517307
06/03/2014 16:01,2013,2012,B,Other Reporting Airports,ISLE OF MAN,NEWCASTLE,4809,4809,0,5469,5469,0,-12.06801987
06/03/2014 16:01,2013,2012,B,Other Reporting Airports,ISLE OF MAN,NORWICH,987,987,0,1054,1054,0,-6.356736183
06/03/2014 16:01,2013,2012,B,Other Reporting Airports,ISLE OF MAN,OXFORD (KIDLINGTON),133,133,0,4014,4014,0,-96.68659973
06/03/2014 16:01,2013,2012,B,Other Reporting Airports,ISLE OF MAN,SOUTHAMPTON,1932,1932,0,1885,1885,0,2.493368626
06/03/2014 16:01,2013,2012,B,Other Reporting Airports,ISLES OF SCILLY (ST.MARYS),NEWQUAY,22093,22093,0,14197,14197,0,55.61738205
06/03/2014 16:01,2013,2012,B,Other Reporting Airports,ISLES OF SCILLY (ST.MARYS),SOUTHAMPTON,0,0,0,2973,2973,0,
06/03/2014 16:01,2013,2012,B,Other Reporting Airports,JERSEY,LEEDS BRADFORD,16104,16104,0,20449,20449,0,-21.24798203
06/03/2014 16:01,2013,2012,B,Other Reporting Airports,JERSEY,LIVERPOOL (JOHN LENNON),86442,86442,0,78457,78457,0,10.17754936
06/03/2014 16:01,2013,2012,B,Other Reporting Airports,JERSEY,MANCHESTER,51168,51168,0,57096,57096,0,-10.382514
06/03/2014 16:01,2013,2012,B,Other Reporting Airports,JERSEY,MANSTON (KENT INT),0,0,0,1379,0,1379,
06/03/2014 16:01,2013,2012,B,Other Reporting Airports,JERSEY,NEWCASTLE,17878,17878,0,12362,12066,296,44.6206131
06/03/2014 16:01,2013,2012,B,Other Reporting Airports,JERSEY,NORWICH,2747,2747,0,4968,4968,0,-44.70611954
06/03/2014 16:01,2013,2012,B,Other Reporting Airports,JERSEY,OXFORD (KIDLINGTON),92,92,0,3590,3590,0,-97.43732452
06/03/2014 16:01,2013,2012,B,Other Reporting Airports,JERSEY,SOUTHAMPTON,160314,160314,0,147305,147305,0,8.831336021
06/03/2014 16:01,2013,2012,B,Other Reporting Airports,KIRKWALL,NORTH RONALDSAY,6570,6570,0,5640,5640,0,16.48936081
06/03/2014 16:01,2013,2012,B,Other Reporting Airports,KIRKWALL,PAPA WESTRAY,4190,4190,0,3891,3891,0,7.684400082
06/03/2014 16:01,2013,2012,B,Other Reporting Airports,KIRKWALL,SANDAY,2921,2921,0,2428,2428,0,20.30477715
06/03/2014 16:01,2013,2012,B,Other Reporting Airports,KIRKWALL,STRONSAY,3084,3084,0,2808,2808,0,9.829059601
06/03/2014 16:01,2013,2012,B,Other Reporting Airports,KIRKWALL,SUMBURGH,8739,8739,0,7935,7935,0,10.13232517
06/03/2014 16:01,2013,2012,B,Other Reporting Airports,KIRKWALL,WESTRAY,3365,3365,0,2979,2979,0,12.9573679
06/03/2014 16:01,2013,2012,B,Other Reporting Airports,LANDS END (ST JUST),NEWQUAY,0,0,0,3,3,0,
06/03/2014 16:01,2013,2012,B,Other Reporting Airports,LEEDS BRADFORD,MANCHESTER,0,0,0,86,86,0,
06/03/2014 16:01,2013,2012,B,Other Reporting Airports,LEEDS BRADFORD,NEWQUAY,0,0,0,29,29,0,
06/03/2014 16:01,2013,2012,B,Other Reporting Airports,LEEDS BRADFORD,SOUTH MARSTON,45,0,45,0,0,0,
06/03/2014 16:01,2013,2012,B,Other Reporting Airports,LEEDS BRADFORD,SOUTHAMPTON,59650,59650,0,65048,65010,38,-8.298487663
06/03/2014 16:01,2013,2012,B,Other Reporting Airports,LERWICK (TINGWALL),OUT SKERRIES,180,180,0,366,366,0,-50.81967163
06/03/2014 16:01,2013,2012,B,Other Reporting Airports,LERWICK (TINGWALL),PAPA STOUR,29,29,0,60,60,0,-51.66666794
06/03/2014 16:01,2013,2012,B,Other Reporting Airports,LERWICK (TINGWALL),SUMBURGH,0,0,0,1,1,0,
06/03/2014 16:01,2013,2012,B,Other Reporting Airports,LIVERPOOL (JOHN LENNON),NEWCASTLE,326,0,326,253,0,253,28.85375404
06/03/2014 16:01,2013,2012,B,Other Reporting Airports,LIVERPOOL (JOHN LENNON),NEWQUAY,5848,5848,0,0,0,0,
06/03/2014 16:01,2013,2012,B,Other Reporting Airports,LIVERPOOL (JOHN LENNON),NORWICH,220,0,220,280,0,280,-21.4285717
06/03/2014 16:01,2013,2012,B,Other Reporting Airports,LIVERPOOL (JOHN LENNON),SOUTHAMPTON,233,0,233,134,0,134,73.88059998
06/03/2014 16:01,2013,2012,B,Other Reporting Airports,MANCHESTER,NEWCASTLE,726,0,726,540,0,540,34.44444275
06/03/2014 16:01,2013,2012,B,Other Reporting Airports,MANCHESTER,NEWQUAY,32570,32570,0,31136,31136,0,4.605601311
06/03/2014 16:01,2013,2012,B,Other Reporting Airports,MANCHESTER,NORWICH,30302,30084,218,28778,28499,279,5.295711994
06/03/2014 16:01,2013,2012,B,Other Reporting Airports,MANCHESTER,SOUTHAMPTON,121044,120894,150,114719,114608,111,5.51347208
06/03/2014 16:01,2013,2012,B,Other Reporting Airports,MANCHESTER,STORNOWAY,166,0,166,77,0,77,115.5844193
06/03/2014 16:01,2013,2012,B,Other Reporting Airports,MANSTON (KENT INT),NEWCASTLE,243,0,243,0,0,0,
06/03/2014 16:01,2013,2012,B,Other Reporting Airports,MANSTON (KENT INT),NEWQUAY,0,0,0,70,0,70,
06/03/2014 16:01,2013,2012,B,Other Reporting Airports,NEWCASTLE,NEWQUAY,2384,2384,0,2590,2590,0,-7.953668118
06/03/2014 16:01,2013,2012,B,Other Reporting Airports,NEWCASTLE,NORWICH,298,0,298,215,0,215,38.6046524
06/03/2014 16:01,2013,2012,B,Other Reporting Airports,NEWCASTLE,SOUTHAMPTON,91064,90680,384,87044,86851,193,4.618353844
06/03/2014 16:01,2013,2012,B,Other Reporting Airports,NEWCASTLE,WARTON,0,0,0,40,0,40,
06/03/2014 16:01,2013,2012,B,Other Reporting Airports,NEWQUAY,NORWICH,1907,1907,0,2706,2706,0,-29.52697754
06/03/2014 16:01,2013,2012,B,Other Reporting Airports,NORWICH,SOUTHAMPTON,107,0,107,79,0,79,35.44303894
06/03/2014 16:01,2013,2012,B,Other Reporting Airports,NORWICH,WARTON,6,6,0,0,0,0,
06/03/2014 16:01,2013,2012,B,Other Reporting Airports,SCATSTA,TURWESTON,0,0,0,34,0,34,
06/03/2014 16:01,2013,2012,B,Other Reporting Airports,SCATSTA,WOODVALE,0,0,0,28,0,28,
